zona_o,zona_d,car,foot,public,other,bike,all,geo_code1,geo_code2
1,1,128,25384,0,0,0,25512,1,1
1,2,86,4676,167,0,0,4929,1,2
1,3,0,3429,485,0,0,3914,1,3
1,4,192,1151,233,98,0,1674,1,4
1,5,39,3225,301,67,86,3718,1,5
1,6,152,2629,280,0,0,3061,1,6
1,7,0,19,0,234,0,253,1,7
1,8,0,0,90,0,0,90,1,8
1,9,0,0,101,0,0,101,1,9
1,10,0,0,161,0,0,161,1,10
1,12,43,0,0,0,0,43,1,12
1,13,0,0,12,0,0,12,1,13
1,14,0,30,18,0,0,48,1,14
1,16,111,924,624,122,0,1781,1,16
1,17,0,0,150,0,0,150,1,17
1,18,299,0,460,0,0,759,1,18
1,19,403,22,273,0,0,698,1,19
1,20,22,254,739,83,0,1098,1,20
1,21,59,0,373,0,0,432,1,21
1,22,0,0,433,103,0,536,1,22
1,23,869,0,1016,393,0,2278,1,23
1,24,0,1380,897,37,0,2314,1,24
1,25,0,240,0,0,0,240,1,25
1,26,0,115,331,0,0,446,1,26
1,27,0,0,636,81,0,717,1,27
1,28,0,60,798,26,0,884,1,28
1,29,0,0,138,33,0,171,1,29
1,30,227,43,271,0,0,541,1,30
1,31,0,128,605,0,0,733,1,31
1,32,21,0,383,0,0,404,1,32
1,34,23,0,192,0,0,215,1,34
1,35,0,0,1489,0,0,1489,1,35
1,36,64,0,1163,0,0,1227,1,36
1,37,0,0,667,0,0,667,1,37
1,38,0,0,29,0,0,29,1,38
1,39,0,0,181,0,0,181,1,39
1,40,64,0,69,0,0,133,1,40
1,41,0,0,657,0,0,657,1,41
1,43,160,0,624,0,0,784,1,43
1,44,0,0,244,0,0,244,1,44
1,45,0,0,442,0,0,442,1,45
1,46,0,0,440,0,0,440,1,46
1,47,0,0,383,0,0,383,1,47
1,48,0,0,445,0,0,445,1,48
1,49,0,0,206,0,0,206,1,49
1,50,0,0,24,0,0,24,1,50
1,51,193,0,440,0,0,633,1,51
1,52,61,0,485,0,0,546,1,52
1,53,0,0,19,0,0,19,1,53
1,54,0,0,149,0,0,149,1,54
1,56,0,0,224,0,0,224,1,56
1,57,0,0,350,0,0,350,1,57
1,58,0,0,546,0,0,546,1,58
1,59,0,0,267,0,0,267,1,59
1,60,0,0,664,0,0,664,1,60
1,61,415,0,586,0,0,1001,1,61
1,62,49,0,56,0,0,105,1,62
1,63,0,0,63,0,0,63,1,63
1,64,0,0,95,0,0,95,1,64
1,65,116,0,244,0,0,360,1,65
1,66,0,0,103,0,0,103,1,66
1,67,161,0,60,0,0,221,1,67
1,68,0,0,396,0,0,396,1,68
1,74,0,0,93,0,0,93,1,74
1,75,0,0,258,0,0,258,1,75
1,76,38,0,148,72,0,258,1,76
1,77,0,0,43,0,0,43,1,77
1,78,203,0,222,102,0,527,1,78
1,79,0,0,386,0,0,386,1,79
1,80,0,0,442,0,0,442,1,80
1,81,0,0,37,0,0,37,1,81
1,82,31,0,83,0,0,114,1,82
1,83,69,0,589,0,0,658,1,83
1,84,51,0,43,51,0,145,1,84
1,85,0,0,12,0,0,12,1,85
1,87,67,0,33,0,0,100,1,87
1,88,0,0,389,404,0,793,1,88
1,89,0,0,72,0,0,72,1,89
1,90,0,0,128,0,0,128,1,90
1,92,0,0,4,0,0,4,1,92
1,93,0,0,879,0,0,879,1,93
1,96,0,0,134,0,0,134,1,96
1,97,0,0,116,0,0,116,1,97
1,100,150,0,0,0,0,150,1,100
1,101,0,0,321,0,0,321,1,101
1,102,0,0,217,0,0,217,1,102
1,103,0,0,11,0,0,11,1,103
1,104,21,0,0,0,0,21,1,104
1,105,150,0,184,0,0,334,1,105
1,106,0,0,0,60,0,60,1,106
1,107,0,0,108,0,0,108,1,107
1,108,0,0,14,0,0,14,1,108
1,109,0,0,1418,0,0,1418,1,109
1,110,877,0,693,0,0,1570,1,110
1,112,0,0,323,0,0,323,1,112
1,113,0,0,67,0,0,67,1,113
1,116,0,0,2919,0,0,2919,1,116
1,122,0,0,384,0,0,384,1,122
1,124,0,0,1375,0,0,1375,1,124
1,128,0,0,31,0,0,31,1,128
1,129,0,0,80,0,0,80,1,129
1,130,0,0,45,0,0,45,1,130
1,131,0,0,29,0,0,29,1,131
1,132,138,0,0,0,0,138,1,132
1,133,0,0,917,0,0,917,1,133
1,135,0,0,170,0,0,170,1,135
1,136,0,0,717,0,0,717,1,136
1,137,0,0,1180,0,0,1180,1,137
1,138,0,0,71,0,0,71,1,138
1,139,0,0,262,0,0,262,1,139
1,140,0,0,963,0,0,963,1,140
1,141,0,0,730,0,0,730,1,141
1,144,0,0,564,0,0,564,1,144
1,145,0,0,35,0,0,35,1,145
1,148,0,0,241,0,0,241,1,148
1,150,0,0,474,0,0,474,1,150
1,151,0,0,1789,0,0,1789,1,151
1,152,0,0,187,0,0,187,1,152
1,153,0,0,488,0,0,488,1,153
1,154,0,0,542,0,0,542,1,154
1,155,0,0,579,0,0,579,1,155
1,156,0,0,243,0,0,243,1,156
1,158,0,0,1058,0,0,1058,1,158
1,163,0,0,1152,0,0,1152,1,163
1,165,0,0,72,0,0,72,1,165
1,166,201,0,568,330,0,1099,1,166
1,167,0,0,870,0,0,870,1,167
1,168,0,0,431,0,0,431,1,168
1,169,0,0,879,0,0,879,1,169
1,170,0,0,305,0,0,305,1,170
1,171,0,0,126,0,0,126,1,171
1,172,0,0,121,0,0,121,1,172
1,173,544,0,0,0,0,544,1,173
1,174,357,0,0,0,0,357,1,174
1,175,0,0,236,0,0,236,1,175
1,177,0,0,198,0,0,198,1,177
1,182,0,0,90,0,0,90,1,182
1,183,0,0,282,0,0,282,1,183
1,184,0,0,359,0,0,359,1,184
1,185,0,0,351,0,0,351,1,185
1,186,0,0,160,0,0,160,1,186
1,187,0,0,464,0,0,464,1,187
1,190,244,0,0,0,0,244,1,190
1,192,0,0,546,0,0,546,1,192
1,194,255,0,127,0,0,382,1,194
1,195,0,0,214,0,0,214,1,195
1,197,95,0,0,0,0,95,1,197
1,198,0,0,482,0,0,482,1,198
1,199,0,0,541,0,0,541,1,199
1,200,0,0,222,0,0,222,1,200
1,201,0,0,146,0,0,146,1,201
1,203,0,0,153,0,0,153,1,203
1,204,0,0,1517,0,0,1517,1,204
1,206,0,0,1701,0,0,1701,1,206
1,209,0,0,206,0,0,206,1,209
1,210,0,0,588,0,0,588,1,210
1,211,0,0,623,0,0,623,1,211
1,214,0,0,87,0,0,87,1,214
1,215,0,0,310,0,0,310,1,215
1,217,0,0,637,0,0,637,1,217
1,218,0,0,1278,0,0,1278,1,218
1,220,0,0,184,0,0,184,1,220
1,221,0,0,263,0,0,263,1,221
1,225,0,0,268,0,0,268,1,225
1,228,0,0,206,0,0,206,1,228
1,229,0,0,1147,0,0,1147,1,229
1,231,0,0,152,0,0,152,1,231
1,232,0,0,195,0,0,195,1,232
1,233,0,0,550,0,0,550,1,233
1,234,0,0,1367,0,0,1367,1,234
1,235,0,0,525,0,0,525,1,235
1,236,33,0,414,0,59,506,1,236
1,237,26,0,70,0,0,96,1,237
1,238,0,0,309,0,0,309,1,238
1,239,0,0,345,0,0,345,1,239
1,240,0,0,434,206,0,640,1,240
1,241,53,0,0,0,0,53,1,241
1,243,0,0,574,0,0,574,1,243
1,244,0,0,195,0,0,195,1,244
1,245,135,0,577,0,0,712,1,245
1,246,0,0,114,0,0,114,1,246
1,247,0,0,893,725,0,1618,1,247
1,250,0,0,123,0,0,123,1,250
1,251,0,0,200,0,0,200,1,251
1,252,105,0,380,0,0,485,1,252
1,254,0,0,1181,0,0,1181,1,254
1,258,0,0,711,0,0,711,1,258
1,260,0,0,312,0,0,312,1,260
1,263,0,0,851,0,0,851,1,263
1,264,0,0,613,0,0,613,1,264
1,265,0,0,373,343,0,716,1,265
1,270,594,0,228,0,0,822,1,270
1,271,159,0,0,0,0,159,1,271
1,272,38,0,123,0,0,161,1,272
1,274,0,0,196,0,0,196,1,274
1,277,0,0,276,0,0,276,1,277
1,278,0,0,395,0,0,395,1,278
1,280,353,0,188,0,0,541,1,280
1,293,0,0,869,0,0,869,1,293
1,294,0,0,860,0,0,860,1,294
1,298,0,0,657,0,0,657,1,298
1,299,0,0,88,0,0,88,1,299
1,300,0,0,285,0,0,285,1,300
1,301,0,0,57,0,0,57,1,301
1,303,0,0,359,0,0,359,1,303
1,304,0,0,993,0,0,993,1,304
1,306,0,0,764,0,0,764,1,306
1,307,0,0,773,0,0,773,1,307
1,312,0,0,161,0,0,161,1,312
1,315,0,0,185,0,0,185,1,315
1,316,0,0,103,0,0,103,1,316
1,318,0,0,0,103,0,103,1,318
1,319,48,0,0,0,0,48,1,319
1,320,0,0,569,0,0,569,1,320
1,321,0,0,214,111,0,325,1,321
1,322,77,0,0,121,0,198,1,322
1,325,0,0,0,364,0,364,1,325
1,326,0,0,498,0,0,498,1,326
1,327,27,0,306,0,0,333,1,327
1,328,0,0,79,0,0,79,1,328
1,329,119,0,101,0,0,220,1,329
1,339,0,0,522,0,0,522,1,339
1,340,0,0,460,0,0,460,1,340
1,342,0,0,373,0,0,373,1,342
2,1,86,5061,79,0,0,5226,2,1
2,2,0,12436,0,0,0,12436,2,2
2,3,0,1805,0,0,331,2136,2,3
2,4,0,474,93,0,0,567,2,4
2,5,612,775,193,0,0,1580,2,5
2,6,0,2109,1085,257,0,3451,2,6
2,7,0,1976,342,0,0,2318,2,7
2,9,92,66,92,0,0,250,2,9
2,11,0,0,12,0,0,12,2,11
2,12,0,0,347,0,0,347,2,12
2,13,0,111,15,0,0,126,2,13
2,14,16,0,476,0,0,492,2,14
2,15,0,0,351,0,0,351,2,15
2,16,0,408,193,0,0,601,2,16
2,17,0,863,127,143,0,1133,2,17
2,18,128,0,299,0,0,427,2,18
2,19,0,0,28,0,0,28,2,19
2,20,0,138,425,0,212,775,2,20
2,22,0,178,67,0,0,245,2,22
2,23,0,63,141,0,41,245,2,23
2,24,0,175,517,0,0,692,2,24
2,25,0,74,325,0,0,399,2,25
2,26,0,0,139,0,0,139,2,26
2,27,60,0,169,60,0,289,2,27
2,30,64,58,0,64,0,186,2,30
2,31,128,0,612,49,0,789,2,31
2,32,0,0,190,0,0,190,2,32
2,33,15,0,17,0,0,32,2,33
2,34,0,0,42,77,0,119,2,34
2,35,0,0,0,40,0,40,2,35
2,36,0,0,131,0,0,131,2,36
2,37,0,0,93,0,0,93,2,37
2,38,0,0,0,35,0,35,2,38
2,39,0,0,85,0,0,85,2,39
2,41,1364,0,90,0,0,1454,2,41
2,42,0,24,30,0,0,54,2,42
2,43,63,0,174,63,0,300,2,43
2,44,455,0,165,0,0,620,2,44
2,45,240,0,1300,0,0,1540,2,45
2,48,247,0,269,0,0,516,2,48
2,49,0,0,197,0,0,197,2,49
2,50,0,0,98,74,0,172,2,50
2,51,104,0,93,0,0,197,2,51
2,53,0,0,58,0,0,58,2,53
2,54,0,0,268,0,0,268,2,54
2,55,0,0,14,0,0,14,2,55
2,56,0,0,381,0,0,381,2,56
2,57,0,0,171,0,0,171,2,57
2,58,100,0,615,0,0,715,2,58
2,59,0,0,1213,0,0,1213,2,59
2,60,0,0,386,0,0,386,2,60
2,62,26,0,0,0,0,26,2,62
2,64,274,0,104,0,0,378,2,64
2,65,0,0,104,0,0,104,2,65
2,66,58,0,0,0,0,58,2,66
2,67,0,0,88,0,0,88,2,67
2,68,0,0,281,0,0,281,2,68
2,69,80,0,0,0,0,80,2,69
2,70,84,0,160,0,0,244,2,70
2,72,0,0,89,0,0,89,2,72
2,73,0,0,180,0,0,180,2,73
2,74,0,0,489,0,0,489,2,74
2,75,46,0,126,0,0,172,2,75
2,77,0,0,188,0,0,188,2,77
2,78,102,0,52,0,0,154,2,78
2,79,105,0,57,0,0,162,2,79
2,80,26,0,88,0,64,178,2,80
2,81,0,0,92,0,0,92,2,81
2,82,0,0,421,0,0,421,2,82
2,83,0,0,69,0,0,69,2,83
2,84,0,0,270,0,0,270,2,84
2,85,0,0,11,0,0,11,2,85
2,86,0,0,64,0,0,64,2,86
2,88,0,0,413,0,0,413,2,88
2,90,0,0,0,0,89,89,2,90
2,93,100,0,44,0,0,144,2,93
2,95,37,0,75,0,0,112,2,95
2,96,66,0,0,0,0,66,2,96
2,97,70,0,0,0,0,70,2,97
2,99,0,0,208,0,0,208,2,99
2,100,0,0,150,0,0,150,2,100
2,101,0,0,166,0,0,166,2,101
2,103,0,0,20,0,0,20,2,103
2,105,0,0,78,0,0,78,2,105
2,106,0,0,60,0,0,60,2,106
2,107,0,0,99,0,0,99,2,107
2,109,0,0,985,0,0,985,2,109
2,110,0,0,439,0,0,439,2,110
2,116,0,0,1515,0,0,1515,2,116
2,128,0,0,10,0,0,10,2,128
2,129,443,0,1035,0,0,1478,2,129
2,130,0,0,45,0,0,45,2,130
2,131,53,0,43,0,0,96,2,131
2,132,267,0,0,0,0,267,2,132
2,134,233,0,211,0,0,444,2,134
2,135,0,0,75,565,0,640,2,135
2,136,145,0,46,0,0,191,2,136
2,137,0,0,468,0,0,468,2,137
2,141,0,0,1657,0,0,1657,2,141
2,142,0,0,298,0,0,298,2,142
2,144,162,0,671,0,0,833,2,144
2,145,31,0,0,0,0,31,2,145
2,151,0,0,882,0,0,882,2,151
2,152,0,0,921,0,0,921,2,152
2,154,0,0,1325,0,0,1325,2,154
2,157,0,0,167,0,0,167,2,157
2,159,787,0,119,0,0,906,2,159
2,160,0,0,233,0,0,233,2,160
2,161,0,0,628,0,0,628,2,161
2,164,0,0,59,0,0,59,2,164
2,165,88,0,32,0,0,120,2,165
2,166,0,0,1531,0,0,1531,2,166
2,169,85,0,779,0,0,864,2,169
2,170,46,0,0,0,0,46,2,170
2,172,516,0,0,0,0,516,2,172
2,176,0,0,453,0,0,453,2,176
2,177,46,0,97,0,0,143,2,177
2,180,0,0,66,0,0,66,2,180
2,181,0,0,599,0,0,599,2,181
2,183,0,0,156,0,0,156,2,183
2,187,222,0,0,0,0,222,2,187
2,188,0,0,188,0,0,188,2,188
2,190,0,0,550,0,0,550,2,190
2,192,0,0,294,0,0,294,2,192
2,193,0,0,151,0,0,151,2,193
2,195,0,0,60,0,0,60,2,195
2,197,0,0,762,0,0,762,2,197
2,198,0,0,833,0,0,833,2,198
2,199,0,0,541,0,0,541,2,199
2,201,0,0,390,0,0,390,2,201
2,202,0,0,444,0,0,444,2,202
2,204,0,0,1308,0,0,1308,2,204
2,205,0,0,1297,0,0,1297,2,205
2,206,0,0,974,0,0,974,2,206
2,207,0,0,594,0,0,594,2,207
2,212,0,0,653,0,0,653,2,212
2,213,0,0,412,0,0,412,2,213
2,214,0,0,323,0,0,323,2,214
2,217,0,0,467,0,0,467,2,217
2,219,0,0,343,0,0,343,2,219
2,220,0,0,576,0,0,576,2,220
2,222,1489,0,0,0,0,1489,2,222
2,223,0,0,572,0,0,572,2,223
2,225,0,0,134,0,0,134,2,225
2,226,0,0,3087,0,0,3087,2,226
2,228,0,0,687,0,0,687,2,228
2,229,0,0,3014,46,0,3060,2,229
2,230,0,0,1326,0,0,1326,2,230
2,231,0,0,398,0,0,398,2,231
2,233,0,0,338,0,0,338,2,233
2,234,0,0,287,0,0,287,2,234
2,235,0,0,890,409,0,1299,2,235
2,236,0,0,15,0,0,15,2,236
2,237,26,0,0,0,0,26,2,237
2,239,107,0,116,0,0,223,2,239
2,241,0,0,126,0,0,126,2,241
2,243,0,0,275,0,0,275,2,243
2,245,0,0,400,0,0,400,2,245
2,246,0,0,165,0,0,165,2,246
2,247,1535,0,963,0,0,2498,2,247
2,249,0,0,607,0,0,607,2,249
2,250,254,0,396,0,0,650,2,250
2,255,863,0,0,0,0,863,2,255
2,258,0,0,317,0,0,317,2,258
2,261,0,0,292,0,0,292,2,261
2,263,0,0,0,582,0,582,2,263
2,266,0,0,114,0,0,114,2,266
2,268,43,0,35,0,0,78,2,268
2,269,0,0,0,119,0,119,2,269
2,270,0,0,288,0,0,288,2,270
2,272,0,0,148,0,0,148,2,272
2,274,0,0,196,0,0,196,2,274
2,275,0,0,169,0,0,169,2,275
2,276,0,0,627,0,0,627,2,276
2,278,0,0,546,0,0,546,2,278
2,279,0,0,711,0,0,711,2,279
2,282,0,0,433,0,0,433,2,282
2,284,0,0,272,0,0,272,2,284
2,288,77,0,0,0,0,77,2,288
2,294,0,0,2830,0,0,2830,2,294
2,297,50,0,0,0,0,50,2,297
2,300,0,0,295,0,0,295,2,300
2,301,0,0,86,0,0,86,2,301
2,305,0,0,220,202,0,422,2,305
2,307,0,0,0,300,0,300,2,307
2,309,0,0,645,0,0,645,2,309
2,311,0,0,1481,0,0,1481,2,311
2,315,0,0,378,0,0,378,2,315
2,316,0,0,72,0,0,72,2,316
2,317,14,0,0,0,0,14,2,317
2,318,0,0,158,0,0,158,2,318
2,321,95,0,0,111,0,206,2,321
2,322,0,0,84,0,0,84,2,322
2,324,923,0,0,0,0,923,2,324
2,329,51,0,51,0,0,102,2,329
2,330,882,0,430,0,0,1312,2,330
2,331,0,0,503,0,0,503,2,331
2,332,86,0,0,0,0,86,2,332
2,333,383,0,0,0,0,383,2,333
2,334,0,0,320,0,0,320,2,334
2,335,0,0,0,418,0,418,2,335
2,336,320,0,0,0,0,320,2,336
2,339,0,0,100,0,0,100,2,339
2,340,0,0,144,0,0,144,2,340
2,341,0,0,136,0,0,136,2,341
2,342,373,0,0,0,0,373,2,342
3,1,0,3665,485,0,0,4150,3,1
3,2,0,1805,0,0,331,2136,3,2
3,3,0,12004,0,0,0,12004,3,3
3,4,0,198,0,0,0,198,3,4
3,5,156,0,156,39,0,351,3,5
3,6,0,156,0,0,0,156,3,6
3,7,0,0,78,0,0,78,3,7
3,8,0,0,156,0,0,156,3,8
3,12,0,0,170,0,0,170,3,12
3,15,0,320,393,0,0,713,3,15
3,16,0,0,569,68,0,637,3,16
3,17,0,106,0,0,0,106,3,17
3,18,184,556,170,0,0,910,3,18
3,20,0,307,465,312,0,1084,3,20
3,21,904,0,250,0,0,1154,3,21
3,23,0,88,145,0,0,233,3,23
3,24,0,4433,0,0,0,4433,3,24
3,25,0,0,225,60,0,285,3,25
3,26,0,127,515,90,0,732,3,26
3,27,355,0,46,0,0,401,3,27
3,28,38,0,38,0,0,76,3,28
3,29,0,0,236,0,0,236,3,29
3,30,405,0,0,0,0,405,3,30
3,31,87,0,30,0,0,117,3,31
3,32,0,0,466,0,0,466,3,32
3,33,31,0,0,0,0,31,3,33
3,34,39,0,0,0,0,39,3,34
3,35,135,0,0,0,0,135,3,35
3,36,0,0,663,0,0,663,3,36
3,38,0,0,35,0,0,35,3,38
3,43,126,0,238,509,0,873,3,43
3,49,0,0,439,244,0,683,3,49
3,50,0,0,507,0,0,507,3,50
3,52,0,0,61,0,0,61,3,52
3,53,0,0,138,0,0,138,3,53
3,54,0,0,37,0,0,37,3,54
3,56,0,0,32,0,0,32,3,56
3,57,434,0,199,90,0,723,3,57
3,58,0,0,200,0,0,200,3,58
3,59,0,0,481,0,0,481,3,59
3,61,724,0,0,0,0,724,3,61
3,62,0,0,27,0,0,27,3,62
3,64,0,0,352,0,0,352,3,64
3,66,0,0,118,0,0,118,3,66
3,67,0,0,171,80,0,251,3,67
3,68,0,0,95,0,0,95,3,68
3,69,0,0,253,80,0,333,3,69
3,72,36,0,0,0,0,36,3,72
3,73,0,0,156,0,0,156,3,73
3,74,0,0,656,0,0,656,3,74
3,76,309,0,38,0,0,347,3,76
3,78,0,0,0,176,0,176,3,78
3,79,116,0,82,0,0,198,3,79
3,81,111,0,115,0,0,226,3,81
3,82,0,0,436,0,0,436,3,82
3,83,0,0,443,0,0,443,3,83
3,84,51,0,47,45,0,143,3,84
3,85,0,0,24,47,0,71,3,85
3,87,33,0,240,0,0,273,3,87
3,90,0,0,123,0,0,123,3,90
3,92,0,0,867,0,0,867,3,92
3,93,0,0,0,312,0,312,3,93
3,94,0,0,31,0,0,31,3,94
3,96,0,0,27,0,0,27,3,96
3,103,0,0,32,0,0,32,3,103
3,124,0,0,249,0,0,249,3,124
3,126,0,0,41,0,0,41,3,126
3,129,0,0,49,0,0,49,3,129
3,131,0,0,11,0,0,11,3,131
3,133,0,0,495,0,0,495,3,133
3,135,0,0,93,0,0,93,3,135
3,141,0,0,427,0,0,427,3,141
3,142,0,0,297,0,0,297,3,142
3,145,0,0,37,0,0,37,3,145
3,153,0,0,152,0,0,152,3,153
3,156,0,0,292,0,0,292,3,156
3,166,0,0,368,0,0,368,3,166
3,167,305,0,0,0,0,305,3,167
3,169,0,0,493,0,0,493,3,169
3,170,0,0,202,0,0,202,3,170
3,171,247,0,247,0,0,494,3,171
3,176,0,0,670,0,0,670,3,176
3,200,0,0,218,0,0,218,3,200
3,208,268,0,0,0,0,268,3,208
3,209,0,0,620,0,0,620,3,209
3,210,117,0,0,0,0,117,3,210
3,217,170,0,0,0,0,170,3,217
3,218,0,0,482,0,0,482,3,218
3,222,0,0,352,0,0,352,3,222
3,223,0,0,274,0,0,274,3,223
3,229,0,0,365,0,0,365,3,229
3,233,0,0,220,0,0,220,3,233
3,237,0,0,26,0,0,26,3,237
3,239,0,0,610,0,0,610,3,239
3,240,0,0,109,0,0,109,3,240
3,241,0,0,26,0,0,26,3,241
3,250,0,0,118,0,0,118,3,250
3,251,0,0,645,0,0,645,3,251
3,253,0,0,0,23,0,23,3,253
3,254,0,0,351,0,0,351,3,254
3,257,0,0,277,0,0,277,3,257
3,267,0,0,153,0,0,153,3,267
3,269,139,0,462,0,0,601,3,269
3,278,0,0,825,0,0,825,3,278
3,279,0,0,245,0,0,245,3,279
3,280,0,0,170,0,0,170,3,280
3,287,0,0,106,0,0,106,3,287
3,302,0,0,129,0,0,129,3,302
3,303,0,0,32,0,0,32,3,303
3,311,0,0,806,0,0,806,3,311
3,320,275,0,0,0,0,275,3,320
3,327,0,0,307,0,0,307,3,327
3,329,0,0,156,0,0,156,3,329
3,335,67,0,0,0,0,67,3,335
3,340,0,0,124,0,0,124,3,340
4,1,0,949,0,98,0,1047,4,1
4,2,0,327,101,214,0,642,4,2
4,3,0,198,0,0,0,198,4,3
4,4,372,11811,0,0,0,12183,4,4
4,5,0,2190,0,455,287,2932,4,5
4,8,159,159,90,0,0,408,4,8
4,15,0,0,214,0,0,214,4,15
4,16,0,0,178,0,0,178,4,16
4,17,0,0,64,0,0,64,4,17
4,18,198,0,0,0,0,198,4,18
4,20,913,0,0,0,0,913,4,20
4,21,0,0,206,0,0,206,4,21
4,22,0,0,73,0,0,73,4,22
4,24,276,445,0,0,0,721,4,24
4,25,0,3850,0,0,0,3850,4,25
4,26,0,1347,0,0,94,1441,4,26
4,27,619,970,0,913,0,2502,4,27
4,28,0,0,102,0,0,102,4,28
4,29,127,300,0,0,0,427,4,29
4,30,64,0,0,58,660,782,4,30
4,31,2147,2767,487,0,0,5401,4,31
4,32,21,562,272,0,0,855,4,32
4,33,0,0,8,0,0,8,4,33
4,34,0,77,42,0,43,162,4,34
4,35,162,744,1565,0,0,2471,4,35
4,36,0,131,466,0,0,597,4,36
4,40,0,0,18,0,0,18,4,40
4,43,0,0,742,0,0,742,4,43
4,45,0,0,246,0,0,246,4,45
4,48,247,0,0,0,0,247,4,48
4,53,643,0,0,0,0,643,4,53
4,55,0,0,72,0,0,72,4,55
4,56,0,0,0,453,0,453,4,56
4,57,0,0,248,447,0,695,4,57
4,58,0,0,455,0,0,455,4,58
4,60,214,0,0,0,0,214,4,60
4,61,0,0,204,0,0,204,4,61
4,64,0,0,193,0,0,193,4,64
4,66,0,0,101,0,0,101,4,66
4,67,0,0,583,0,0,583,4,67
4,68,0,0,215,0,0,215,4,68
4,69,0,0,233,0,0,233,4,69
4,73,0,0,373,0,0,373,4,73
4,74,0,0,191,947,0,1138,4,74
4,75,70,0,38,0,0,108,4,75
4,76,0,0,495,0,0,495,4,76
4,77,0,0,241,140,0,381,4,77
4,78,88,0,11,0,0,99,4,78
4,79,239,122,1305,0,0,1666,4,79
4,80,44,0,44,0,0,88,4,80
4,81,150,0,0,0,0,150,4,81
4,82,0,0,72,0,0,72,4,82
4,84,0,0,55,0,0,55,4,84
4,85,11,0,0,0,0,11,4,85
4,86,0,0,18,20,0,38,4,86
4,87,0,0,36,0,0,36,4,87
4,88,0,101,0,0,0,101,4,88
4,89,0,0,198,168,0,366,4,89
4,92,0,0,1,0,0,1,4,92
4,93,0,0,561,0,0,561,4,93
4,94,35,0,35,0,0,70,4,94
4,96,0,0,77,0,0,77,4,96
4,99,272,0,0,214,0,486,4,99
4,100,0,0,742,0,0,742,4,100
4,101,130,0,0,0,0,130,4,101
4,102,30,0,0,0,0,30,4,102
4,109,0,0,214,0,0,214,4,109
4,112,0,0,182,0,0,182,4,112
4,113,0,0,586,0,0,586,4,113
4,118,0,0,129,0,0,129,4,118
4,121,0,0,542,0,0,542,4,121
4,124,0,0,507,0,0,507,4,124
4,131,7,0,0,0,0,7,4,131
4,134,612,0,0,0,0,612,4,134
4,138,0,0,21,0,0,21,4,138
4,140,0,0,455,0,0,455,4,140
4,141,427,0,1829,0,0,2256,4,141
4,148,0,0,263,0,0,263,4,148
4,162,0,0,58,0,0,58,4,162
4,165,0,0,32,0,0,32,4,165
4,182,0,0,473,0,0,473,4,182
4,187,0,0,342,0,0,342,4,187
4,189,0,0,1146,0,0,1146,4,189
4,190,0,0,244,0,0,244,4,190
4,203,0,0,190,0,0,190,4,203
4,205,0,0,1153,0,0,1153,4,205
4,208,0,0,826,0,0,826,4,208
4,210,111,0,0,117,0,228,4,210
4,212,0,0,323,0,0,323,4,212
4,214,0,0,438,0,0,438,4,214
4,215,0,178,922,0,0,1100,4,215
4,221,121,0,0,0,0,121,4,221
4,229,0,0,398,0,0,398,4,229
4,230,0,0,306,0,0,306,4,230
4,237,0,0,26,0,0,26,4,237
4,238,0,0,178,0,0,178,4,238
4,242,0,0,339,0,0,339,4,242
4,243,0,0,392,0,0,392,4,243
4,245,0,0,255,0,0,255,4,245
4,246,114,0,0,0,0,114,4,246
4,252,0,0,51,0,0,51,4,252
4,255,0,0,805,0,0,805,4,255
4,270,0,0,83,0,0,83,4,270
4,288,0,0,84,0,0,84,4,288
4,290,0,0,572,0,0,572,4,290
4,293,0,0,495,0,0,495,4,293
4,298,0,0,272,0,0,272,4,298
4,301,79,0,57,0,0,136,4,301
4,303,910,0,0,0,0,910,4,303
4,306,0,0,206,0,0,206,4,306
4,309,382,0,166,0,0,548,4,309
4,311,0,0,554,0,0,554,4,311
4,317,15,0,0,0,0,15,4,317
4,319,0,0,18,0,0,18,4,319
4,321,1119,0,0,0,0,1119,4,321
4,327,0,0,73,0,0,73,4,327
4,329,0,0,55,0,0,55,4,329
4,331,0,0,368,0,0,368,4,331
4,332,0,0,257,0,0,257,4,332
4,339,0,0,198,0,0,198,4,339
5,1,77,2131,354,67,0,2629,5,1
5,2,270,973,193,303,0,1739,5,2
5,3,156,156,156,0,0,468,5,3
5,4,0,2770,73,455,287,3585,5,4
5,5,0,35101,0,0,86,35187,5,5
5,6,67,5356,0,0,0,5423,5,6
5,7,0,0,210,0,0,210,5,7
5,8,0,0,88,0,121,209,5,8
5,9,0,92,208,0,29,329,5,9
5,12,0,0,191,0,0,191,5,12
5,13,0,0,59,360,0,419,5,13
5,14,0,0,197,37,0,234,5,14
5,15,0,0,59,0,0,59,5,15
5,16,0,0,68,0,0,68,5,16
5,17,0,0,26,0,0,26,5,17
5,18,0,0,691,145,0,836,5,18
5,19,296,0,285,365,0,946,5,19
5,20,0,0,276,0,0,276,5,20
5,21,0,0,467,0,0,467,5,21
5,22,178,0,125,67,0,370,5,22
5,23,0,0,29,0,0,29,5,23
5,24,0,0,928,0,0,928,5,24
5,25,0,135,162,0,0,297,5,25
5,27,106,60,1096,31,86,1379,5,27
5,28,0,102,1039,0,0,1141,5,28
5,29,0,333,265,0,0,598,5,29
5,30,0,281,263,301,0,845,5,30
5,31,348,1253,518,0,0,2119,5,31
5,32,0,93,856,0,0,949,5,32
5,33,23,0,15,0,0,38,5,33
5,34,587,0,39,39,0,665,5,34
5,35,0,2734,1820,0,234,4788,5,35
5,36,139,326,1224,95,34,1818,5,36
5,37,0,0,20,0,0,20,5,37
5,40,0,0,18,0,0,18,5,40
5,41,0,0,55,0,0,55,5,41
5,42,0,0,0,360,0,360,5,42
5,43,126,0,1629,0,0,1755,5,43
5,44,42,0,0,0,0,42,5,44
5,45,240,0,483,166,0,889,5,45
5,49,0,0,547,0,0,547,5,49
5,50,74,0,0,0,0,74,5,50
5,51,0,0,456,104,0,560,5,51
5,52,0,0,61,0,0,61,5,52
5,53,0,0,576,267,0,843,5,53
5,54,37,0,37,0,0,74,5,54
5,55,0,0,72,0,0,72,5,55
5,56,1357,0,148,0,0,1505,5,56
5,57,155,0,521,0,0,676,5,57
5,58,0,0,100,0,0,100,5,58
5,59,0,0,0,452,0,452,5,59
5,60,0,0,370,69,0,439,5,60
5,61,72,0,1789,0,0,1861,5,61
5,62,81,0,29,27,0,137,5,62
5,63,62,0,176,0,0,238,5,63
5,64,120,0,0,0,0,120,5,64
5,66,116,0,0,0,0,116,5,66
5,67,18,0,53,88,0,159,5,67
5,68,640,0,97,0,0,737,5,68
5,69,80,0,248,0,0,328,5,69
5,70,0,0,22,0,0,22,5,70
5,71,0,0,193,0,302,495,5,71
5,72,0,0,33,0,0,33,5,72
5,73,0,0,76,0,0,76,5,73
5,75,112,0,538,0,0,650,5,75
5,76,0,0,142,0,0,142,5,76
5,77,0,0,531,0,0,531,5,77
5,78,0,0,455,0,0,455,5,78
5,79,0,0,325,101,0,426,5,79
5,80,88,0,502,161,0,751,5,80
5,81,56,0,56,0,0,112,5,81
5,82,199,0,128,162,0,489,5,82
5,83,224,0,213,49,0,486,5,83
5,84,45,0,1451,0,0,1496,5,84
5,85,0,0,52,11,0,63,5,85
5,86,0,0,48,18,0,66,5,86
5,87,0,0,91,0,0,91,5,87
5,88,666,0,909,291,200,2066,5,88
5,90,80,0,234,0,0,314,5,90
5,92,0,0,4,0,0,4,5,92
5,93,0,0,232,0,0,232,5,93
5,94,305,0,77,0,0,382,5,94
5,98,7,0,0,0,0,7,5,98
5,99,0,0,209,0,0,209,5,99
5,100,0,0,274,21,0,295,5,100
5,101,0,0,691,0,0,691,5,101
5,102,114,0,313,49,0,476,5,102
5,103,0,0,38,0,0,38,5,103
5,104,0,0,21,0,0,21,5,104
5,105,128,0,0,0,0,128,5,105
5,107,0,0,176,0,0,176,5,107
5,109,0,0,980,0,0,980,5,109
5,110,267,0,0,0,0,267,5,110
5,115,427,0,427,0,0,854,5,115
5,116,0,0,773,0,0,773,5,116
5,119,0,0,464,0,0,464,5,119
5,121,0,0,1059,0,0,1059,5,121
5,122,0,0,698,0,0,698,5,122
5,124,0,0,1375,0,0,1375,5,124
5,125,131,0,1049,0,0,1180,5,125
5,126,0,0,402,0,0,402,5,126
5,127,427,0,912,0,0,1339,5,127
5,128,0,0,69,0,0,69,5,128
5,129,0,0,74,0,0,74,5,129
5,130,0,0,28,0,0,28,5,130
5,131,0,0,15,0,0,15,5,131
5,132,0,0,601,0,0,601,5,132
5,133,296,0,1693,0,0,1989,5,133
5,134,0,0,233,0,0,233,5,134
5,135,0,0,75,0,0,75,5,135
5,137,841,0,1444,0,0,2285,5,137
5,139,0,0,624,0,0,624,5,139
5,140,299,0,799,0,0,1098,5,140
5,141,0,0,1522,0,0,1522,5,141
5,145,0,0,60,0,0,60,5,145
5,147,0,0,504,0,0,504,5,147
5,150,324,0,38,0,0,362,5,150
5,151,0,0,814,0,0,814,5,151
5,152,498,0,498,0,0,996,5,152
5,153,0,0,0,152,0,152,5,153
5,155,290,0,304,0,0,594,5,155
5,156,0,0,122,0,0,122,5,156
5,157,0,0,368,307,0,675,5,157
5,158,0,0,1036,0,0,1036,5,158
5,161,0,0,294,0,0,294,5,161
5,163,0,0,238,0,0,238,5,163
5,164,0,0,47,0,0,47,5,164
5,165,0,0,32,30,0,62,5,165
5,166,0,0,602,0,0,602,5,166
5,168,0,0,101,0,0,101,5,168
5,169,0,0,860,0,0,860,5,169
5,170,0,0,327,0,0,327,5,170
5,172,0,0,475,0,0,475,5,172
5,175,0,0,460,297,0,757,5,175
5,182,0,0,1877,0,0,1877,5,182
5,186,44,0,97,0,0,141,5,186
5,187,442,0,249,0,0,691,5,187
5,188,0,0,610,0,0,610,5,188
5,189,0,0,269,0,0,269,5,189
5,190,0,0,282,0,0,282,5,190
5,192,0,0,276,0,0,276,5,192
5,193,0,0,671,0,0,671,5,193
5,194,0,0,522,0,0,522,5,194
5,197,0,0,189,0,0,189,5,197
5,198,0,0,597,0,0,597,5,198
5,199,0,0,1696,0,0,1696,5,199
5,200,0,0,149,0,0,149,5,200
5,201,0,0,530,0,0,530,5,201
5,203,0,0,1181,0,0,1181,5,203
5,204,0,0,550,0,0,550,5,204
5,205,0,0,412,0,0,412,5,205
5,208,0,0,397,0,0,397,5,208
5,209,0,0,870,0,0,870,5,209
5,210,0,0,1217,0,0,1217,5,210
5,213,0,0,256,0,0,256,5,213
5,214,0,0,115,0,0,115,5,214
5,218,0,0,482,0,0,482,5,218
5,219,0,0,654,0,0,654,5,219
5,220,184,0,1145,0,0,1329,5,220
5,221,0,0,727,0,0,727,5,221
5,222,0,0,812,0,0,812,5,222
5,225,0,0,134,0,0,134,5,225
5,226,0,0,1177,0,0,1177,5,226
5,227,0,0,674,0,0,674,5,227
5,228,0,0,192,0,0,192,5,228
5,229,0,0,126,731,0,857,5,229
5,231,0,0,152,0,0,152,5,231
5,233,0,0,311,0,0,311,5,233
5,236,0,0,51,0,0,51,5,236
5,237,0,0,47,0,0,47,5,237
5,240,235,0,0,512,0,747,5,240
5,242,0,0,563,0,0,563,5,242
5,244,0,0,195,0,0,195,5,244
5,245,0,0,423,0,0,423,5,245
5,249,608,0,241,0,0,849,5,249
5,250,0,0,108,0,0,108,5,250
5,251,0,0,200,0,0,200,5,251
5,252,0,0,126,0,0,126,5,252
5,256,0,0,88,0,0,88,5,256
5,261,0,0,464,0,0,464,5,261
5,264,0,0,613,0,0,613,5,264
5,268,0,0,116,0,0,116,5,268
5,269,0,0,151,0,0,151,5,269
5,273,629,0,640,0,0,1269,5,273
5,274,196,0,0,0,0,196,5,274
5,275,0,0,595,0,0,595,5,275
5,276,0,0,797,0,0,797,5,276
5,278,251,0,265,0,0,516,5,278
5,281,0,0,589,0,0,589,5,281
5,283,49,0,0,0,0,49,5,283
5,285,0,0,467,0,0,467,5,285
5,287,0,0,106,0,0,106,5,287
5,289,0,0,505,0,0,505,5,289
5,292,0,0,687,0,0,687,5,292
5,293,0,0,1545,0,0,1545,5,293
5,298,0,0,644,0,0,644,5,298
5,302,294,0,92,0,0,386,5,302
5,303,0,0,462,0,0,462,5,303
5,305,0,0,405,0,0,405,5,305
5,309,0,0,427,0,0,427,5,309
5,315,0,0,181,0,0,181,5,315
5,316,44,0,0,0,0,44,5,316
5,317,7,0,38,0,0,45,5,317
5,318,0,0,112,0,0,112,5,318
5,319,270,0,17,0,0,287,5,319
5,320,125,0,455,0,0,580,5,320
5,321,111,0,0,0,0,111,5,321
5,322,77,0,0,0,0,77,5,322
5,325,0,0,22,0,0,22,5,325
5,327,97,0,22,0,0,119,5,327
5,329,0,0,356,0,0,356,5,329
5,330,0,0,960,0,0,960,5,330
5,331,298,0,0,0,0,298,5,331
5,332,0,0,426,0,0,426,5,332
5,333,0,0,186,0,0,186,5,333
5,334,0,0,879,0,0,879,5,334
5,335,418,0,418,0,0,836,5,335
5,336,0,0,0,349,0,349,5,336
5,338,0,0,310,0,0,310,5,338
5,339,0,0,558,0,0,558,5,339
5,340,0,0,40,0,0,40,5,340
5,341,0,0,110,0,0,110,5,341
6,1,152,2084,305,0,0,2541,6,1
6,2,0,2051,1475,126,0,3652,6,2
6,3,0,156,0,0,0,156,6,3
6,4,0,26,0,0,0,26,6,4
6,5,204,3914,0,0,0,4118,6,5
6,6,240,17024,0,0,0,17264,6,6
6,7,0,2118,0,190,340,2648,6,7
6,9,0,69,40,0,162,271,6,9
6,10,0,0,581,0,0,581,6,10
6,11,0,0,24,0,0,24,6,11
6,12,257,72,354,159,0,842,6,12
6,13,0,0,40,0,0,40,6,13
6,15,0,0,53,0,0,53,6,15
6,17,0,369,198,0,0,567,6,17
6,19,0,0,276,0,0,276,6,19
6,21,0,0,83,0,0,83,6,21
6,22,0,495,73,96,0,664,6,22
6,23,0,0,92,0,0,92,6,23
6,24,0,169,350,0,0,519,6,24
6,25,0,162,0,0,0,162,6,25
6,26,0,0,1085,71,0,1156,6,26
6,27,0,36,97,0,0,133,6,27
6,28,0,0,251,0,0,251,6,28
6,29,80,0,0,257,0,337,6,29
6,30,0,111,0,0,187,298,6,30
6,31,0,215,345,94,0,654,6,31
6,32,0,0,488,0,0,488,6,32
6,34,0,0,42,0,0,42,6,34
6,35,0,5117,683,0,0,5800,6,35
6,36,0,0,163,0,649,812,6,36
6,37,0,0,704,0,0,704,6,37
6,41,0,0,378,0,0,378,6,41
6,42,0,0,511,0,0,511,6,42
6,43,63,0,1198,69,0,1330,6,43
6,46,0,0,280,0,0,280,6,46
6,47,0,0,107,0,0,107,6,47
6,50,0,0,74,0,0,74,6,50
6,51,0,0,104,0,0,104,6,51
6,53,0,0,58,0,0,58,6,53
6,54,0,0,14,0,0,14,6,54
6,55,0,0,168,0,0,168,6,55
6,56,0,0,529,0,0,529,6,56
6,57,0,0,424,0,0,424,6,57
6,59,0,0,257,0,0,257,6,59
6,61,204,0,619,0,0,823,6,61
6,63,23,0,0,0,0,23,6,63
6,64,120,0,0,120,0,240,6,64
6,66,58,0,0,0,0,58,6,66
6,67,80,0,0,0,0,80,6,67
6,68,0,0,121,0,0,121,6,68
6,69,0,0,79,0,0,79,6,69
6,70,0,0,91,0,0,91,6,70
6,71,193,0,0,0,0,193,6,71
6,73,0,0,169,0,0,169,6,73
6,74,0,0,55,0,0,55,6,74
6,75,0,0,61,0,0,61,6,75
6,76,0,0,321,0,0,321,6,76
6,77,0,0,435,0,0,435,6,77
6,78,102,0,111,102,148,463,6,78
6,79,0,23,85,0,0,108,6,79
6,80,0,0,44,223,0,267,6,80
6,82,0,0,257,0,0,257,6,82
6,83,0,0,363,0,0,363,6,83
6,84,40,0,102,45,0,187,6,84
6,86,9,0,0,0,0,9,6,86
6,87,0,0,36,0,0,36,6,87
6,88,0,0,0,440,0,440,6,88
6,89,0,0,231,0,0,231,6,89
6,90,62,0,76,0,0,138,6,90
6,92,3,0,1,0,0,4,6,92
6,93,0,0,1486,0,0,1486,6,93
6,94,0,0,38,0,0,38,6,94
6,100,0,0,249,0,0,249,6,100
6,103,0,0,6,0,0,6,6,103
6,104,21,0,11,0,0,32,6,104
6,105,222,0,0,0,0,222,6,105
6,110,0,0,422,0,0,422,6,110
6,116,537,0,1009,0,0,1546,6,116
6,122,0,0,883,0,0,883,6,122
6,124,1014,0,670,0,0,1684,6,124
6,125,0,0,457,0,0,457,6,125
6,127,838,0,348,0,0,1186,6,127
6,128,10,0,10,0,0,20,6,128
6,129,0,0,22,0,0,22,6,129
6,132,0,0,469,0,0,469,6,132
6,134,0,0,612,0,0,612,6,134
6,135,0,0,122,0,0,122,6,135
6,136,0,0,493,0,0,493,6,136
6,139,0,0,79,0,0,79,6,139
6,140,0,0,0,899,0,899,6,140
6,142,0,0,323,0,0,323,6,142
6,144,0,0,350,712,0,1062,6,144
6,145,37,0,0,0,0,37,6,145
6,151,0,0,401,0,0,401,6,151
6,152,0,0,45,0,0,45,6,152
6,154,991,0,601,0,0,1592,6,154
6,157,154,0,59,0,0,213,6,157
6,162,0,0,87,0,0,87,6,162
6,164,0,0,111,0,79,190,6,164
6,165,0,0,32,0,0,32,6,165
6,166,0,0,804,0,0,804,6,166
6,167,0,0,857,0,0,857,6,167
6,168,257,0,257,0,0,514,6,168
6,169,245,0,0,0,0,245,6,169
6,175,0,0,608,0,0,608,6,175
6,176,453,0,0,0,0,453,6,176
6,177,0,0,46,0,0,46,6,177
6,181,0,0,419,0,0,419,6,181
6,183,0,0,84,0,0,84,6,183
6,189,0,0,397,0,0,397,6,189
6,190,102,0,0,0,0,102,6,190
6,196,0,0,393,0,0,393,6,196
6,197,0,0,333,0,0,333,6,197
6,204,0,0,678,0,0,678,6,204
6,207,0,0,1138,0,0,1138,6,207
6,210,0,0,542,0,0,542,6,210
6,214,0,0,124,0,0,124,6,214
6,218,0,0,1377,0,0,1377,6,218
6,219,343,0,0,0,0,343,6,219
6,222,25,0,0,0,0,25,6,222
6,226,0,0,521,0,0,521,6,226
6,227,0,0,56,0,0,56,6,227
6,231,236,0,0,0,0,236,6,231
6,232,0,0,49,0,0,49,6,232
6,236,0,0,28,0,0,28,6,236
6,238,0,0,294,0,0,294,6,238
6,240,308,0,0,0,0,308,6,240
6,254,0,0,280,0,0,280,6,254
6,255,466,0,0,0,0,466,6,255
6,258,0,0,674,0,0,674,6,258
6,261,0,0,928,0,0,928,6,261
6,262,0,0,335,0,0,335,6,262
6,264,382,0,0,0,0,382,6,264
6,266,0,0,217,0,0,217,6,266
6,274,0,0,419,0,0,419,6,274
6,275,0,0,274,0,0,274,6,275
6,278,0,0,395,0,0,395,6,278
6,285,0,0,666,0,0,666,6,285
6,288,0,0,166,0,0,166,6,288
6,295,555,0,0,0,0,555,6,295
6,297,25,0,0,0,0,25,6,297
6,298,0,0,301,0,0,301,6,298
6,301,52,0,0,0,0,52,6,301
6,303,0,0,494,0,0,494,6,303
6,304,0,0,558,0,0,558,6,304
6,305,0,0,404,0,0,404,6,305
6,307,0,0,298,0,0,298,6,307
6,309,0,0,249,0,0,249,6,309
6,314,0,0,0,740,0,740,6,314
6,315,0,0,321,0,0,321,6,315
6,316,87,0,0,0,0,87,6,316
6,321,111,0,0,0,0,111,6,321
6,326,0,0,498,0,0,498,6,326
6,329,0,0,614,0,0,614,6,329
6,330,0,0,267,0,0,267,6,330
6,331,0,0,0,210,0,210,6,331
6,332,0,0,331,0,0,331,6,332
6,335,157,0,0,0,0,157,6,335
6,340,0,0,257,0,0,257,6,340
6,341,0,0,139,0,0,139,6,341
7,1,0,19,0,234,0,253,7,1
7,2,882,1693,177,0,0,2752,7,2
7,3,0,0,78,0,0,78,7,3
7,5,37,0,311,0,0,348,7,5
7,6,0,2020,0,190,340,2550,7,6
7,7,265,18102,0,0,58,18425,7,7
7,8,159,3449,0,0,94,3702,7,8
7,9,0,1600,29,26,58,1713,7,9
7,10,155,43,0,0,0,198,7,10
7,11,0,67,36,0,0,103,7,11
7,12,234,636,198,235,0,1303,7,12
7,13,0,269,314,144,24,751,7,13
7,15,0,179,0,0,0,179,7,15
7,16,235,397,0,0,0,632,7,16
7,17,0,98,46,106,0,250,7,17
7,18,182,0,0,0,0,182,7,18
7,20,76,0,0,0,0,76,7,20
7,23,0,0,322,0,0,322,7,23
7,24,0,0,60,0,0,60,7,24
7,25,0,0,174,0,0,174,7,25
7,27,469,0,60,0,0,529,7,27
7,28,0,0,26,0,0,26,7,28
7,29,80,0,0,0,0,80,7,29
7,31,0,0,221,0,0,221,7,31
7,32,0,0,234,0,0,234,7,32
7,34,0,0,0,62,0,62,7,34
7,35,0,1806,139,0,0,1945,7,35
7,36,114,131,0,448,0,693,7,36
7,37,80,83,97,0,0,260,7,37
7,38,71,35,32,0,0,138,7,38
7,40,9,0,0,0,0,9,7,40
7,41,11,0,0,0,0,11,7,41
7,42,0,0,81,0,0,81,7,42
7,43,167,0,500,45,0,712,7,43
7,44,0,0,534,0,0,534,7,44
7,48,0,0,305,0,0,305,7,48
7,49,0,0,100,0,0,100,7,49
7,56,0,0,440,0,0,440,7,56
7,57,155,0,0,0,0,155,7,57
7,59,234,0,1158,0,0,1392,7,59
7,60,0,0,102,0,0,102,7,60
7,61,0,0,210,0,0,210,7,61
7,62,26,0,29,0,0,55,7,62
7,64,0,0,120,0,0,120,7,64
7,66,0,0,0,58,0,58,7,66
7,67,55,0,0,0,0,55,7,67
7,68,150,0,100,746,0,996,7,68
7,69,0,0,75,0,0,75,7,69
7,73,0,0,129,0,0,129,7,73
7,74,0,0,83,0,0,83,7,74
7,75,0,0,161,0,0,161,7,75
7,76,0,0,42,0,0,42,7,76
7,78,111,0,0,0,0,111,7,78
7,79,84,0,42,0,0,126,7,79
7,81,98,0,0,78,0,176,7,81
7,83,0,0,304,0,0,304,7,83
7,84,297,0,0,0,0,297,7,84
7,85,11,0,0,144,0,155,7,85
7,86,18,0,0,18,0,36,7,86
7,88,420,0,163,0,0,583,7,88
7,89,0,0,392,0,0,392,7,89
7,92,0,0,0,189,0,189,7,92
7,93,40,0,0,0,0,40,7,93
7,94,0,0,83,0,0,83,7,94
7,95,75,0,204,0,0,279,7,95
7,99,0,0,129,0,0,129,7,99
7,100,0,0,554,0,0,554,7,100
7,106,0,0,0,16,0,16,7,106
7,107,99,0,0,0,0,99,7,107
7,111,239,0,0,0,0,239,7,111
7,116,0,0,0,537,0,537,7,116
7,118,0,0,16,0,0,16,7,118
7,121,0,0,823,0,0,823,7,121
7,123,0,0,878,0,0,878,7,123
7,125,0,0,143,0,0,143,7,125
7,127,0,0,745,0,0,745,7,127
7,128,10,0,0,0,0,10,7,128
7,129,0,0,689,0,0,689,7,129
7,130,0,0,49,0,0,49,7,130
7,133,0,0,821,0,0,821,7,133
7,135,100,0,234,0,0,334,7,135
7,136,0,0,0,140,0,140,7,136
7,138,0,0,52,0,0,52,7,138
7,139,0,0,93,0,0,93,7,139
7,142,669,0,0,0,0,669,7,142
7,144,128,0,206,0,0,334,7,144
7,145,31,0,0,47,0,78,7,145
7,147,0,0,635,0,0,635,7,147
7,151,0,0,0,0,1133,1133,7,151
7,152,0,0,921,0,0,921,7,152
7,154,0,0,223,0,0,223,7,154
7,157,0,0,70,0,0,70,7,157
7,162,0,0,100,0,0,100,7,162
7,163,621,0,0,0,0,621,7,163
7,165,0,0,210,0,0,210,7,165
7,168,0,0,222,0,0,222,7,168
7,170,0,0,106,0,0,106,7,170
7,172,0,0,700,0,0,700,7,172
7,176,0,0,493,0,0,493,7,176
7,180,630,0,0,630,0,1260,7,180
7,181,0,0,71,0,0,71,7,181
7,182,473,0,0,0,0,473,7,182
7,187,0,0,273,0,0,273,7,187
7,190,253,0,0,0,0,253,7,190
7,192,0,0,362,0,0,362,7,192
7,194,0,0,127,0,0,127,7,194
7,195,0,0,214,0,0,214,7,195
7,197,333,0,0,0,0,333,7,197
7,199,0,0,541,0,0,541,7,199
7,202,0,0,594,0,0,594,7,202
7,207,0,0,1138,0,0,1138,7,207
7,211,0,0,0,1368,0,1368,7,211
7,212,0,0,53,0,0,53,7,212
7,216,0,0,883,0,0,883,7,216
7,217,0,0,447,0,0,447,7,217
7,218,0,0,738,0,0,738,7,218
7,219,0,0,447,0,0,447,7,219
7,223,0,0,210,0,0,210,7,223
7,225,0,0,134,0,0,134,7,225
7,226,0,0,607,0,0,607,7,226
7,227,0,0,295,0,0,295,7,227
7,229,0,0,1228,0,0,1228,7,229
7,230,0,0,770,0,0,770,7,230
7,234,684,0,0,0,0,684,7,234
7,239,45,0,0,0,0,45,7,239
7,242,339,0,0,0,0,339,7,242
7,249,0,0,332,0,0,332,7,249
7,250,26,0,0,0,0,26,7,250
7,251,200,0,0,0,0,200,7,251
7,253,0,0,24,0,0,24,7,253
7,255,144,0,0,0,0,144,7,255
7,268,109,0,0,0,0,109,7,268
7,269,277,0,0,0,0,277,7,269
7,273,0,0,287,0,0,287,7,273
7,275,0,0,967,0,0,967,7,275
7,276,0,0,849,0,0,849,7,276
7,283,0,0,5,0,0,5,7,283
7,284,0,0,0,353,0,353,7,284
7,300,0,0,210,0,0,210,7,300
7,302,85,0,0,0,0,85,7,302
7,311,0,0,740,0,0,740,7,311
7,313,0,0,114,0,0,114,7,313
7,317,0,0,21,0,0,21,7,317
7,319,35,0,0,45,0,80,7,319
7,322,77,0,0,0,0,77,7,322
7,327,0,0,0,27,0,27,7,327
7,329,0,0,51,0,0,51,7,329
7,339,0,0,384,0,0,384,7,339
7,342,0,0,558,0,0,558,7,342
8,1,0,0,90,0,0,90,8,1
8,2,0,83,0,0,0,83,8,2
8,3,0,0,156,0,0,156,8,3
8,4,159,159,90,0,0,408,8,4
8,5,0,0,195,0,121,316,8,5
8,7,159,3574,0,0,0,3733,8,7
8,8,395,12602,271,0,0,13268,8,8
8,9,147,644,0,0,0,791,8,9
8,10,0,8,48,0,0,56,8,10
8,13,83,0,0,166,0,249,8,13
8,14,302,0,0,0,0,302,8,14
8,15,0,0,90,0,0,90,8,15
8,17,0,20,90,0,0,110,8,17
8,19,0,0,111,0,0,111,8,19
8,20,83,0,320,0,0,403,8,20
8,23,0,0,0,83,0,83,8,23
8,24,0,0,125,0,0,125,8,24
8,27,0,0,38,0,0,38,8,27
8,30,0,0,0,160,0,160,8,30
8,31,0,0,280,348,0,628,8,31
8,35,0,1356,252,0,0,1608,8,35
8,36,111,0,211,0,0,322,8,36
8,37,0,993,0,0,391,1384,8,37
8,38,0,0,0,35,0,35,8,38
8,39,0,0,52,0,0,52,8,39
8,43,0,0,83,0,0,83,8,43
8,45,166,0,0,0,0,166,8,45
8,64,0,0,167,0,0,167,8,64
8,65,224,0,0,0,0,224,8,65
8,66,262,0,0,0,0,262,8,66
8,70,0,0,111,0,0,111,8,70
8,76,64,0,0,0,0,64,8,76
8,79,82,0,111,0,0,193,8,79
8,81,43,0,155,0,0,198,8,81
8,84,24,0,120,0,0,144,8,84
8,85,0,0,12,0,0,12,8,85
8,87,98,0,0,0,0,98,8,87
8,88,0,0,71,0,0,71,8,88
8,91,24,228,80,0,0,332,8,91
8,93,0,0,232,0,0,232,8,93
8,94,0,0,38,0,0,38,8,94
8,100,21,0,0,0,0,21,8,100
8,102,49,0,0,0,0,49,8,102
8,107,0,0,90,0,0,90,8,107
8,112,0,45,0,0,0,45,8,112
8,113,0,0,0,84,0,84,8,113
8,115,0,0,328,0,0,328,8,115
8,121,0,0,442,0,0,442,8,121
8,123,0,0,706,0,0,706,8,123
8,126,0,0,268,0,0,268,8,126
8,129,0,0,41,0,0,41,8,129
8,131,0,0,173,0,55,228,8,131
8,134,233,0,0,0,0,233,8,134
8,136,659,84,541,122,0,1406,8,136
8,137,0,0,107,0,0,107,8,137
8,138,221,0,0,0,0,221,8,138
8,139,0,0,595,0,0,595,8,139
8,140,0,0,166,0,0,166,8,140
8,145,0,0,28,0,0,28,8,145
8,159,0,0,38,0,0,38,8,159
8,164,0,0,80,0,0,80,8,164
8,166,38,0,0,0,0,38,8,166
8,198,0,0,178,0,0,178,8,198
8,201,0,0,742,0,0,742,8,201
8,208,0,0,0,45,0,45,8,208
8,209,0,0,466,0,0,466,8,209
8,227,0,0,321,0,0,321,8,227
8,261,0,0,251,0,0,251,8,261
8,275,83,0,0,0,0,83,8,275
8,292,0,0,0,687,0,687,8,292
8,300,111,0,83,0,0,194,8,300
9,2,92,40,100,0,0,232,9,2
9,5,0,92,208,0,29,329,9,5
9,6,0,36,40,0,162,238,9,6
9,7,0,1440,29,41,58,1568,9,7
9,8,167,598,0,0,0,765,9,8
9,9,77,3264,29,123,58,3551,9,9
9,10,26,1553,0,191,0,1770,9,10
9,11,23,0,0,0,0,23,9,11
9,12,61,578,0,0,0,639,9,12
9,13,0,71,0,0,0,71,9,13
9,14,0,0,40,0,0,40,9,14
9,17,0,30,0,0,0,30,9,17
9,19,353,0,0,0,0,353,9,19
9,20,57,0,0,0,0,57,9,20
9,21,0,0,111,0,0,111,9,21
9,23,0,0,26,0,0,26,9,23
9,24,0,0,20,295,0,315,9,24
9,26,201,0,0,0,0,201,9,26
9,27,0,0,60,0,0,60,9,27
9,28,0,0,26,0,0,26,9,28
9,31,0,0,79,0,0,79,9,31
9,34,0,0,134,0,0,134,9,34
9,35,0,0,88,0,0,88,9,35
9,36,0,0,109,0,0,109,9,36
9,37,18,92,441,0,0,551,9,37
9,42,0,0,0,37,0,37,9,42
9,43,0,71,20,53,0,144,9,43
9,44,56,0,0,0,0,56,9,44
9,45,0,0,754,0,0,754,9,45
9,50,32,0,74,0,0,106,9,50
9,51,0,0,80,0,0,80,9,51
9,54,37,0,0,0,0,37,9,54
9,55,0,0,168,0,0,168,9,55
9,56,92,0,107,0,0,199,9,56
9,57,0,0,30,0,0,30,9,57
9,59,0,0,1213,0,0,1213,9,59
9,60,0,0,327,0,0,327,9,60
9,65,0,0,92,0,0,92,9,65
9,68,0,0,29,0,0,29,9,68
9,77,0,0,92,0,0,92,9,77
9,80,0,0,40,0,0,40,9,80
9,81,0,0,26,0,0,26,9,81
9,82,26,0,0,0,0,26,9,82
9,84,0,0,45,0,0,45,9,84
9,86,0,0,20,0,0,20,9,86
9,87,0,0,33,0,0,33,9,87
9,88,62,0,138,0,0,200,9,88
9,89,62,0,0,0,0,62,9,89
9,93,0,0,92,0,0,92,9,93
9,94,0,0,92,0,0,92,9,94
9,99,0,0,58,0,0,58,9,99
9,116,0,0,236,0,0,236,9,116
9,123,0,0,71,0,0,71,9,123
9,125,0,0,593,0,0,593,9,125
9,128,0,0,310,0,0,310,9,128
9,129,0,0,295,0,0,295,9,129
9,131,0,0,95,0,0,95,9,131
9,134,0,0,154,0,0,154,9,134
9,135,18,0,0,0,0,18,9,135
9,139,0,0,93,0,0,93,9,139
9,140,0,0,343,0,0,343,9,140
9,141,0,0,578,0,0,578,9,141
9,142,0,0,728,0,0,728,9,142
9,144,742,0,59,0,0,801,9,144
9,148,95,0,0,0,0,95,9,148
9,150,460,0,0,0,0,460,9,150
9,152,0,0,92,0,0,92,9,152
9,153,0,0,152,0,0,152,9,153
9,154,0,0,219,0,0,219,9,154
9,157,154,0,0,0,0,154,9,157
9,160,0,0,0,71,0,71,9,160
9,161,77,0,0,0,0,77,9,161
9,162,26,0,0,0,0,26,9,162
9,164,92,0,0,0,0,92,9,164
9,165,0,141,40,0,0,181,9,165
9,168,0,0,101,0,0,101,9,168
9,173,0,0,0,272,0,272,9,173
9,185,234,0,0,0,0,234,9,185
9,196,0,0,113,0,0,113,9,196
9,201,0,0,779,0,0,779,9,201
9,205,384,0,0,0,0,384,9,205
9,211,0,0,812,0,0,812,9,211
9,214,0,0,26,0,0,26,9,214
9,228,0,0,176,0,0,176,9,228
9,229,0,0,398,0,0,398,9,229
9,231,0,0,152,0,0,152,9,231
9,235,0,0,1202,0,0,1202,9,235
9,243,0,0,275,0,0,275,9,243
9,256,0,0,404,0,0,404,9,256
9,265,0,0,679,0,0,679,9,265
9,274,208,0,87,0,0,295,9,274
9,280,0,0,0,0,207,207,9,280
9,283,0,0,49,0,0,49,9,283
9,284,0,0,250,0,0,250,9,284
9,287,0,0,26,0,0,26,9,287
9,300,0,0,20,0,0,20,9,300
9,304,0,0,558,0,0,558,9,304
9,327,27,0,0,0,0,27,9,327
9,339,0,0,92,0,0,92,9,339
9,340,0,0,73,0,0,73,9,340
10,1,0,0,161,0,0,161,10,1
10,6,0,0,469,0,0,469,10,6
10,7,147,43,141,0,0,331,10,7
10,8,26,8,36,0,0,70,10,8
10,9,0,1458,104,95,0,1657,10,9
10,10,131,1075,0,0,277,1483,10,10
10,11,156,66,0,0,0,222,10,11
10,12,17,1269,218,0,39,1543,10,12
10,13,0,130,0,14,0,144,10,13
10,14,8,34,0,0,12,54,10,14
10,17,0,0,20,0,0,20,10,17
10,19,0,0,0,396,0,396,10,19
10,22,67,0,0,0,0,67,10,22
10,27,147,0,0,0,0,147,10,27
10,29,0,0,32,0,0,32,10,29
10,30,0,0,12,0,0,12,10,30
10,31,0,0,21,0,0,21,10,31
10,32,0,0,18,0,0,18,10,32
10,34,0,0,11,0,0,11,10,34
10,35,0,11,0,0,0,11,10,35
10,38,0,18,0,84,0,102,10,38
10,39,0,0,51,0,7,58,10,39
10,42,11,0,0,5,0,16,10,42
10,43,0,0,63,0,0,63,10,43
10,47,21,0,0,0,0,21,10,47
10,49,0,0,8,0,0,8,10,49
10,50,35,0,0,0,0,35,10,50
10,51,0,0,104,0,0,104,10,51
10,53,0,0,11,0,0,11,10,53
10,54,0,0,111,0,0,111,10,54
10,63,0,0,8,0,0,8,10,63
10,68,0,0,12,0,0,12,10,68
10,76,0,0,11,0,0,11,10,76
10,85,0,0,0,24,0,24,10,85
10,90,0,0,0,189,0,189,10,90
10,93,0,0,58,0,0,58,10,93
10,118,0,0,281,0,0,281,10,118
10,127,0,0,0,246,0,246,10,127
10,128,45,49,0,0,0,94,10,128
10,131,0,19,0,0,0,19,10,131
10,133,0,8,0,0,0,8,10,133
10,134,233,0,0,0,0,233,10,134
10,135,0,0,0,15,0,15,10,135
10,141,0,0,0,903,0,903,10,141
10,144,0,0,1110,0,0,1110,10,144
10,151,0,0,0,11,0,11,10,151
10,154,498,0,0,0,0,498,10,154
10,158,0,0,3143,0,0,3143,10,158
10,159,0,0,1005,0,0,1005,10,159
10,160,0,0,546,0,0,546,10,160
10,161,1453,0,0,0,0,1453,10,161
10,162,0,0,257,0,0,257,10,162
10,163,0,0,676,0,0,676,10,163
10,164,8,0,53,0,0,61,10,164
10,169,0,0,11,0,0,11,10,169
10,170,0,0,295,0,0,295,10,170
10,172,0,0,88,0,0,88,10,172
10,173,0,0,469,0,0,469,10,173
10,177,0,0,50,0,0,50,10,177
10,204,0,0,550,0,0,550,10,204
10,205,0,0,592,0,0,592,10,205
10,210,117,0,0,0,0,117,10,210
10,226,0,0,521,0,0,521,10,226
10,240,204,0,0,0,0,204,10,240
10,241,0,0,58,0,0,58,10,241
10,249,0,0,114,0,0,114,10,249
10,253,0,0,5,0,0,5,10,253
10,265,8,0,0,0,0,8,10,265
11,6,0,0,22,0,0,22,11,6
11,7,0,67,36,0,0,103,11,7
11,9,23,0,0,0,0,23,11,9
11,10,167,66,0,0,0,233,11,10
11,11,708,393,0,0,0,1101,11,11
11,12,352,479,24,462,0,1317,11,12
11,13,0,25,24,0,0,49,11,13
11,14,0,135,12,0,0,147,11,14
11,15,19,0,0,0,0,19,11,15
11,16,36,0,0,0,0,36,11,16
11,17,0,47,29,0,83,159,11,17
11,19,0,0,24,0,0,24,11,19
11,24,0,0,61,0,0,61,11,24
11,28,0,0,71,0,0,71,11,28
11,30,0,0,0,19,0,19,11,30
11,37,0,0,49,23,0,72,11,37
11,38,22,460,0,69,0,551,11,38
11,39,91,11,0,0,0,102,11,39
11,42,79,11,10,27,0,127,11,42
11,45,46,0,0,0,0,46,11,45
11,48,23,0,0,0,0,23,11,48
11,50,0,0,62,0,0,62,11,50
11,54,0,0,24,0,0,24,11,54
11,55,0,0,45,0,0,45,11,55
11,61,0,0,22,0,0,22,11,61
11,68,0,0,24,0,0,24,11,68
11,70,11,0,0,0,0,11,11,70
11,77,33,0,0,0,0,33,11,77
11,79,0,0,19,0,0,19,11,79
11,80,22,0,0,0,0,22,11,80
11,81,0,0,63,0,0,63,11,81
11,100,0,0,14,0,0,14,11,100
11,108,22,0,0,0,0,22,11,108
11,109,158,0,0,0,0,158,11,109
11,150,0,0,352,0,0,352,11,150
11,156,0,0,1736,0,0,1736,11,156
11,161,23,0,0,0,0,23,11,161
11,162,54,0,0,0,0,54,11,162
11,163,0,0,49,0,0,49,11,163
11,164,141,0,0,0,0,141,11,164
11,166,23,0,21,0,0,44,11,166
11,168,23,0,0,0,0,23,11,168
11,176,0,0,21,0,0,21,11,176
11,180,0,0,0,752,0,752,11,180
11,208,23,0,0,0,0,23,11,208
11,217,0,0,0,310,0,310,11,217
11,237,22,0,0,0,0,22,11,237
11,250,649,0,0,0,0,649,11,250
11,254,208,0,0,0,0,208,11,254
11,263,0,0,513,0,0,513,11,263
11,265,343,0,0,0,0,343,11,265
11,315,669,0,0,0,0,669,11,315
11,317,7,0,0,0,0,7,11,317
12,1,43,0,0,0,0,43,12,1
12,2,0,68,54,0,0,122,12,2
12,3,0,0,170,0,0,170,12,3
12,5,0,0,191,303,0,494,12,5
12,6,0,329,340,0,0,669,12,6
12,7,234,636,198,235,0,1303,12,7
12,9,144,674,0,0,0,818,12,9
12,10,17,1163,281,0,39,1500,12,10
12,11,355,492,12,473,55,1387,12,11
12,12,508,8195,0,37,531,9271,12,12
12,13,0,1161,14,0,14,1189,12,13
12,14,36,1184,0,67,0,1287,12,14
12,15,93,68,0,0,0,161,12,15
12,16,0,0,272,0,0,272,12,16
12,17,0,184,24,21,0,229,12,17
12,23,63,0,0,0,0,63,12,23
12,24,0,0,57,0,0,57,12,24
12,26,0,0,74,0,0,74,12,26
12,29,0,0,0,0,88,88,12,29
12,32,0,0,100,0,0,100,12,32
12,37,0,0,70,0,441,511,12,37
12,38,112,212,70,0,0,394,12,38
12,40,0,0,20,0,0,20,12,40
12,41,202,0,0,0,0,202,12,41
12,42,446,803,0,0,0,1249,12,42
12,44,0,0,61,0,0,61,12,44
12,63,0,0,19,6,0,25,12,63
12,64,156,0,0,0,0,156,12,64
12,70,156,0,0,0,0,156,12,70
12,74,124,0,0,0,0,124,12,74
12,77,0,0,68,0,0,68,12,77
12,82,182,0,0,0,0,182,12,82
12,89,118,0,0,0,0,118,12,89
12,93,0,0,152,0,0,152,12,93
12,110,0,0,347,0,0,347,12,110
12,121,0,0,0,666,0,666,12,121
12,128,751,83,0,0,0,834,12,128
12,131,0,0,0,152,0,152,12,131
12,135,0,0,1142,0,0,1142,12,135
12,136,0,0,176,0,0,176,12,136
12,137,0,0,732,0,0,732,12,137
12,147,0,0,305,0,0,305,12,147
12,150,0,0,500,0,0,500,12,150
12,159,1125,0,0,0,0,1125,12,159
12,162,0,83,415,0,0,498,12,162
12,163,0,0,63,590,0,653,12,163
12,164,55,178,0,0,125,358,12,164
12,165,64,0,27,0,0,91,12,165
12,169,0,0,46,0,0,46,12,169
12,170,336,0,395,0,0,731,12,170
12,173,0,0,47,0,0,47,12,173
12,181,0,0,486,0,0,486,12,181
12,182,53,0,0,0,0,53,12,182
12,189,0,0,488,0,0,488,12,189
12,193,0,0,151,0,0,151,12,193
12,195,0,0,451,0,0,451,12,195
12,199,0,0,1108,0,0,1108,12,199
12,203,0,0,307,0,0,307,12,203
12,205,0,0,473,0,0,473,12,205
12,207,513,0,0,0,0,513,12,207
12,211,519,0,0,0,0,519,12,211
12,214,0,0,299,0,0,299,12,214
12,217,363,0,0,0,0,363,12,217
12,220,0,0,239,0,0,239,12,220
12,226,0,0,607,0,0,607,12,226
12,231,0,0,165,0,0,165,12,231
12,238,135,0,0,0,0,135,12,238
12,241,53,0,0,0,0,53,12,241
12,250,0,0,108,0,0,108,12,250
12,263,0,0,109,0,0,109,12,263
12,276,0,0,569,0,0,569,12,276
12,281,0,0,159,0,0,159,12,281
12,315,0,0,884,0,0,884,12,315
12,323,0,0,416,0,0,416,12,323
12,329,18,0,0,0,0,18,12,329
12,332,0,0,33,0,0,33,12,332
12,335,0,0,170,0,0,170,12,335
13,1,0,0,12,0,0,12,13,1
13,2,0,94,31,144,0,269,13,2
13,5,0,0,450,0,0,450,13,5
13,6,0,0,40,0,0,40,13,6
13,7,0,269,314,0,24,607,13,7
13,8,83,0,0,166,0,249,13,8
13,9,0,71,0,0,0,71,13,9
13,10,0,130,0,14,0,144,13,10
13,11,0,25,24,0,0,49,13,11
13,12,0,1179,0,13,14,1206,13,12
13,13,0,1437,0,0,0,1437,13,13
13,14,0,214,0,34,0,248,13,14
13,15,0,267,0,0,0,267,13,15
13,17,0,299,0,0,0,299,13,17
13,20,0,0,42,0,0,42,13,20
13,24,0,0,288,0,0,288,13,24
13,26,0,0,0,227,0,227,13,26
13,37,0,0,18,0,0,18,13,37
13,41,17,24,18,0,0,59,13,41
13,42,0,102,0,42,0,144,13,42
13,45,0,0,11,0,0,11,13,45
13,80,0,0,44,0,0,44,13,80
13,87,0,0,33,0,0,33,13,87
13,128,0,0,0,13,0,13,13,128
13,140,174,0,0,0,0,174,13,140
13,151,0,0,1422,0,0,1422,13,151
13,153,152,0,0,0,0,152,13,153
13,156,0,0,13,0,0,13,13,156
13,157,0,0,380,0,0,380,13,157
13,161,877,0,0,0,0,877,13,161
13,163,0,0,100,0,0,100,13,163
13,164,0,0,106,0,0,106,13,164
13,166,0,0,77,0,0,77,13,166
13,168,0,10,110,0,0,120,13,168
13,169,202,0,0,0,0,202,13,169
13,183,0,0,84,0,0,84,13,183
13,188,585,0,0,0,0,585,13,188
13,192,0,0,270,0,0,270,13,192
13,196,0,0,676,0,0,676,13,196
13,199,0,0,567,0,0,567,13,199
13,200,0,0,456,0,0,456,13,200
13,205,0,0,507,0,0,507,13,205
13,207,0,0,1272,0,0,1272,13,207
13,209,0,0,17,0,0,17,13,209
13,211,623,0,0,0,0,623,13,211
13,213,143,0,0,0,0,143,13,213
13,225,0,0,306,0,0,306,13,225
13,254,0,0,0,33,0,33,13,254
13,255,3695,0,0,0,0,3695,13,255
13,256,0,0,74,0,0,74,13,256
14,1,0,30,18,0,0,48,14,1
14,2,0,0,686,0,0,686,14,2
14,5,0,0,197,0,0,197,14,5
14,7,333,0,0,0,0,333,14,7
14,8,385,0,0,0,0,385,14,8
14,9,83,0,40,37,0,160,14,9
14,10,0,34,0,0,12,46,14,10
14,11,0,170,12,0,0,182,14,11
14,12,36,1113,0,103,0,1252,14,12
14,13,0,214,0,34,0,248,14,13
14,14,75,9654,0,0,0,9729,14,14
14,15,0,1699,0,0,0,1699,14,15
14,16,0,251,159,126,0,536,14,16
14,17,0,426,0,66,70,562,14,17
14,18,0,124,135,0,0,259,14,18
14,20,0,0,76,0,0,76,14,20
14,24,181,0,0,0,0,181,14,24
14,29,37,0,0,0,0,37,14,29
14,30,0,0,37,0,0,37,14,30
14,31,30,0,0,15,0,45,14,31
14,32,0,0,32,0,0,32,14,32
14,35,0,0,29,0,0,29,14,35
14,37,18,0,0,0,0,18,14,37
14,38,0,35,0,0,0,35,14,38
14,41,180,59,137,0,0,376,14,41
14,42,268,1685,72,0,0,2025,14,42
14,43,315,0,45,63,0,423,14,43
14,44,0,0,0,75,0,75,14,44
14,49,0,0,31,0,0,31,14,49
14,50,0,0,62,0,0,62,14,50
14,56,296,0,0,0,0,296,14,56
14,57,0,0,37,0,0,37,14,57
14,74,196,0,0,0,0,196,14,74
14,77,0,0,105,0,0,105,14,77
14,79,0,0,47,37,0,84,14,79
14,80,180,0,0,0,0,180,14,80
14,81,111,0,0,0,0,111,14,81
14,82,0,0,61,0,0,61,14,82
14,97,35,0,0,0,0,35,14,97
14,99,131,0,0,0,0,131,14,99
14,102,36,0,0,0,0,36,14,102
14,112,0,0,206,0,0,206,14,112
14,116,0,0,697,0,0,697,14,116
14,126,1045,0,0,0,0,1045,14,126
14,127,320,0,912,0,0,1232,14,127
14,131,0,0,20,0,0,20,14,131
14,137,0,0,535,0,0,535,14,137
14,142,677,0,589,0,0,1266,14,142
14,144,0,0,807,0,0,807,14,144
14,153,0,0,17,0,0,17,14,153
14,154,0,0,226,0,0,226,14,154
14,159,0,0,1861,0,0,1861,14,159
14,161,0,0,41,0,0,41,14,161
14,162,0,0,257,0,0,257,14,162
14,164,0,0,31,0,0,31,14,164
14,165,32,0,0,0,0,32,14,165
14,167,0,0,41,0,0,41,14,167
14,169,0,0,541,0,0,541,14,169
14,170,731,0,499,0,0,1230,14,170
14,172,0,0,88,0,0,88,14,172
14,173,272,0,0,0,0,272,14,173
14,174,0,0,389,0,0,389,14,174
14,175,0,0,297,0,0,297,14,175
14,176,0,0,71,0,0,71,14,176
14,177,0,0,95,0,0,95,14,177
14,181,0,0,34,0,0,34,14,181
14,183,0,0,329,0,0,329,14,183
14,184,0,0,193,0,0,193,14,184
14,185,351,0,0,0,0,351,14,185
14,186,0,0,106,0,0,106,14,186
14,187,0,0,372,342,0,714,14,187
14,188,0,0,503,0,0,503,14,188
14,189,0,0,397,0,0,397,14,189
14,193,0,0,151,0,0,151,14,193
14,194,121,0,0,0,0,121,14,194
14,196,0,0,416,0,0,416,14,196
14,197,0,0,332,0,0,332,14,197
14,198,0,0,0,246,0,246,14,198
14,200,0,0,134,0,0,134,14,200
14,201,0,0,1265,0,0,1265,14,201
14,202,0,0,546,0,0,546,14,202
14,205,0,0,1177,0,0,1177,14,205
14,206,0,0,598,0,0,598,14,206
14,211,0,0,812,0,0,812,14,211
14,212,0,0,381,0,0,381,14,212
14,221,0,0,425,0,0,425,14,221
14,226,0,0,641,0,0,641,14,226
14,227,0,0,762,0,0,762,14,227
14,228,0,0,301,0,0,301,14,228
14,229,0,0,935,0,0,935,14,229
14,230,0,0,770,0,0,770,14,230
14,231,0,0,444,0,0,444,14,231
14,234,0,0,287,0,0,287,14,234
14,237,0,0,28,0,0,28,14,237
14,240,0,0,228,0,0,228,14,240
14,243,0,0,270,0,0,270,14,243
14,253,0,0,24,0,0,24,14,253
14,254,0,0,41,0,0,41,14,254
14,259,0,0,227,0,0,227,14,259
14,262,0,0,788,0,0,788,14,262
14,265,0,0,373,0,0,373,14,265
14,271,0,0,0,36,0,36,14,271
14,278,0,0,0,395,0,395,14,278
14,280,0,0,155,0,0,155,14,280
14,294,0,0,1145,0,0,1145,14,294
14,305,0,0,621,0,0,621,14,305
14,306,922,0,0,808,0,1730,14,306
14,307,0,0,325,0,0,325,14,307
14,322,515,0,0,0,0,515,14,322
14,330,328,0,0,0,0,328,14,330
15,2,0,53,294,0,0,347,15,2
15,3,0,156,223,0,0,379,15,3
15,4,0,0,233,0,0,233,15,4
15,5,0,0,59,0,0,59,15,5
15,6,0,0,53,0,0,53,15,6
15,7,0,179,0,0,0,179,15,7
15,8,0,0,90,0,0,90,15,8
15,11,19,0,0,0,0,19,15,11
15,12,93,68,0,0,0,161,15,12
15,13,0,277,0,0,0,277,15,13
15,14,0,1699,0,0,0,1699,15,14
15,15,358,3235,0,0,0,3593,15,15
15,16,150,494,0,138,0,782,15,16
15,17,20,456,0,0,0,476,15,17
15,23,0,0,24,0,0,24,15,23
15,24,0,0,91,0,0,91,15,24
15,27,0,0,63,0,0,63,15,27
15,28,0,0,24,0,0,24,15,28
15,29,0,0,111,0,0,111,15,29
15,32,157,0,0,0,0,157,15,32
15,36,0,0,79,0,0,79,15,36
15,38,0,18,0,0,0,18,15,38
15,39,0,0,85,0,0,85,15,39
15,41,403,1110,321,439,99,2372,15,41
15,42,98,569,0,56,154,877,15,42
15,43,281,233,45,138,0,697,15,43
15,44,68,0,499,86,0,653,15,44
15,45,240,24,0,0,0,264,15,45
15,47,106,0,0,0,0,106,15,47
15,49,0,0,24,0,0,24,15,49
15,65,116,0,0,0,0,116,15,65
15,73,0,0,24,0,0,24,15,73
15,74,53,0,24,0,0,77,15,74
15,77,0,0,127,0,0,127,15,77
15,82,0,0,70,0,0,70,15,82
15,93,0,0,53,0,0,53,15,93
15,113,0,0,62,28,0,90,15,113
15,122,0,0,197,0,0,197,15,122
15,130,0,0,15,0,0,15,15,130
15,135,179,0,0,0,0,179,15,135
15,154,0,0,288,0,0,288,15,154
15,161,719,0,0,0,0,719,15,161
15,162,0,0,257,0,0,257,15,162
15,165,53,0,0,0,0,53,15,165
15,167,0,0,53,0,0,53,15,167
15,168,0,0,33,0,0,33,15,168
15,169,202,0,58,0,0,260,15,169
15,171,53,0,0,0,0,53,15,171
15,173,0,0,668,49,0,717,15,173
15,177,0,0,62,0,0,62,15,177
15,180,0,0,85,0,0,85,15,180
15,181,0,0,208,0,0,208,15,181
15,185,0,0,171,0,0,171,15,185
15,187,0,0,249,0,0,249,15,187
15,192,0,0,79,0,0,79,15,192
15,194,0,0,402,0,0,402,15,194
15,200,0,0,506,0,0,506,15,200
15,202,0,0,1047,0,0,1047,15,202
15,204,0,0,825,0,0,825,15,204
15,212,0,0,0,403,0,403,15,212
15,213,0,0,194,0,0,194,15,213
15,214,0,0,53,0,0,53,15,214
15,216,0,0,439,0,0,439,15,216
15,220,239,0,0,0,0,239,15,220
15,221,0,0,425,0,0,425,15,221
15,225,0,0,165,0,0,165,15,225
15,226,0,0,493,0,0,493,15,226
15,229,0,0,795,0,0,795,15,229
15,233,0,0,338,0,0,338,15,233
15,234,0,0,264,0,0,264,15,234
15,236,0,0,263,0,0,263,15,236
15,238,0,0,135,0,0,135,15,238
15,241,53,0,0,0,0,53,15,241
15,246,0,0,114,0,0,114,15,246
15,254,0,0,863,0,0,863,15,254
15,256,261,0,0,0,0,261,15,256
15,258,0,0,565,0,0,565,15,258
15,264,0,0,613,0,0,613,15,264
15,294,0,0,107,0,0,107,15,294
15,305,0,0,220,0,0,220,15,305
15,336,0,0,53,0,0,53,15,336
15,338,0,0,109,0,0,109,15,338
16,1,111,1043,770,55,0,1979,16,1
16,2,0,294,243,0,0,537,16,2
16,3,0,0,544,68,0,612,16,3
16,4,0,0,193,0,0,193,16,4
16,5,0,0,576,0,0,576,16,5
16,7,235,397,0,0,0,632,16,7
16,11,36,0,0,0,0,36,16,11
16,12,0,68,272,0,0,340,16,12
16,14,84,187,228,42,0,541,16,14
16,15,91,441,0,138,0,670,16,15
16,16,129,7328,0,612,562,8631,16,16
16,17,230,2242,0,40,0,2512,16,17
16,18,247,1210,135,78,0,1670,16,18
16,21,0,0,0,111,0,111,16,21
16,22,0,0,67,0,0,67,16,22
16,24,83,32,228,0,0,343,16,24
16,26,0,227,0,0,0,227,16,26
16,28,0,38,155,0,0,193,16,28
16,29,0,0,504,0,0,504,16,29
16,31,0,0,68,126,0,194,16,31
16,35,291,0,2057,0,0,2348,16,35
16,37,0,0,130,0,0,130,16,37
16,39,0,0,51,0,0,51,16,39
16,40,18,9,10,63,0,100,16,40
16,41,0,0,68,0,98,166,16,41
16,42,0,0,0,68,118,186,16,42
16,43,403,129,0,0,0,532,16,43
16,44,149,250,131,63,0,593,16,44
16,45,0,126,300,129,0,555,16,45
16,54,0,0,74,0,0,74,16,54
16,56,0,0,148,0,0,148,16,56
16,57,0,0,126,0,0,126,16,57
16,61,309,0,0,0,0,309,16,61
16,73,55,0,155,0,0,210,16,73
16,75,0,0,56,0,0,56,16,75
16,79,0,0,275,0,0,275,16,79
16,80,44,0,219,0,0,263,16,80
16,82,0,0,171,0,0,171,16,82
16,87,266,0,142,0,0,408,16,87
16,92,0,0,4,0,0,4,16,92
16,93,0,0,40,0,0,40,16,93
16,98,0,0,23,0,0,23,16,98
16,107,0,0,129,0,0,129,16,107
16,131,0,0,11,0,0,11,16,131
16,133,0,0,229,0,0,229,16,133
16,136,68,0,0,0,0,68,16,136
16,141,0,0,241,0,0,241,16,141
16,150,0,0,500,0,0,500,16,150
16,152,226,0,0,0,0,226,16,152
16,154,0,0,129,0,0,129,16,154
16,158,0,0,85,0,0,85,16,158
16,162,0,0,325,0,0,325,16,162
16,164,0,0,59,0,0,59,16,164
16,167,460,0,246,0,0,706,16,167
16,168,0,0,284,0,0,284,16,168
16,169,0,0,273,0,0,273,16,169
16,172,0,0,247,0,0,247,16,172
16,176,1123,0,0,0,0,1123,16,176
16,178,0,0,229,0,0,229,16,178
16,183,0,0,961,0,0,961,16,183
16,189,0,0,397,0,0,397,16,189
16,194,0,0,127,0,0,127,16,194
16,196,0,0,758,0,0,758,16,196
16,197,0,0,275,0,0,275,16,197
16,198,0,0,650,0,0,650,16,198
16,200,0,0,134,0,0,134,16,200
16,202,0,0,470,0,0,470,16,202
16,205,0,0,728,0,0,728,16,205
16,207,0,0,202,0,0,202,16,207
16,209,0,0,373,0,0,373,16,209
16,211,129,0,0,0,0,129,16,211
16,217,363,0,0,0,0,363,16,217
16,218,0,0,639,0,0,639,16,218
16,220,0,0,0,0,267,267,16,220
16,225,0,0,172,0,0,172,16,225
16,231,152,0,0,0,0,152,16,231
16,241,173,0,0,0,0,173,16,241
16,246,114,0,124,0,0,238,16,246
16,250,254,0,0,0,0,254,16,250
16,257,0,0,277,0,0,277,16,257
16,262,0,0,915,0,0,915,16,262
16,267,0,0,153,0,0,153,16,267
16,268,0,0,0,36,0,36,16,268
16,270,54,0,0,0,0,54,16,270
16,274,0,0,129,0,0,129,16,274
16,300,0,0,223,0,0,223,16,300
16,305,0,0,265,0,0,265,16,305
16,307,0,0,706,0,0,706,16,307
16,321,111,0,0,0,0,111,16,321
16,329,0,0,55,0,0,55,16,329
16,333,0,0,135,0,0,135,16,333
16,338,109,0,0,0,0,109,16,338
17,1,0,0,58,0,0,58,17,1
17,2,0,779,127,143,0,1049,17,2
17,3,0,106,0,0,0,106,17,3
17,5,0,0,26,0,0,26,17,5
17,6,0,369,203,0,0,572,17,6
17,7,0,98,46,106,0,250,17,7
17,8,0,20,90,0,0,110,17,8
17,9,0,30,21,0,0,51,17,9
17,10,0,0,20,0,0,20,17,10
17,11,0,24,29,0,28,81,17,11
17,12,0,208,24,21,55,308,17,12
17,13,0,299,0,0,0,299,17,13
17,14,50,362,0,79,70,561,17,14
17,15,78,456,0,0,0,534,17,15
17,16,209,2451,0,40,0,2700,17,16
17,17,58,5346,0,0,0,5404,17,17
17,18,48,58,0,0,0,106,17,18
17,19,128,0,0,0,0,128,17,19
17,20,192,0,0,0,0,192,17,20
17,22,0,0,49,0,0,49,17,22
17,24,0,0,15,60,0,75,17,24
17,27,0,0,60,0,0,60,17,27
17,28,0,0,24,0,0,24,17,28
17,31,0,0,24,0,0,24,17,31
17,32,21,0,0,0,0,21,17,32
17,34,23,0,0,0,0,23,17,34
17,36,0,0,89,0,0,89,17,36
17,39,0,0,122,0,0,122,17,39
17,40,0,0,0,24,0,24,17,40
17,41,0,0,141,0,0,141,17,41
17,42,0,48,0,0,107,155,17,42
17,43,156,0,0,0,0,156,17,43
17,44,0,0,330,0,0,330,17,44
17,45,24,0,553,226,0,803,17,45
17,46,0,0,210,0,0,210,17,46
17,49,0,0,74,0,0,74,17,49
17,50,148,0,0,0,0,148,17,50
17,51,0,0,104,0,0,104,17,51
17,53,0,0,20,0,0,20,17,53
17,54,0,0,0,0,35,35,17,54
17,56,0,0,107,0,0,107,17,56
17,60,0,0,20,0,0,20,17,60
17,62,0,0,26,0,0,26,17,62
17,64,95,0,0,0,0,95,17,64
17,66,0,0,0,101,0,101,17,66
17,69,20,0,0,0,0,20,17,69
17,73,0,0,0,76,0,76,17,73
17,78,0,0,102,0,0,102,17,78
17,79,0,0,44,49,0,93,17,79
17,81,0,0,13,0,0,13,17,81
17,87,0,0,0,220,0,220,17,87
17,92,0,0,21,0,0,21,17,92
17,93,0,0,61,0,0,61,17,93
17,94,13,0,0,0,0,13,17,94
17,100,58,0,26,0,0,84,17,100
17,101,0,0,328,0,0,328,17,101
17,104,21,0,0,0,0,21,17,104
17,132,58,0,0,0,0,58,17,132
17,133,0,0,26,0,0,26,17,133
17,136,0,0,64,0,0,64,17,136
17,140,0,0,48,0,0,48,17,140
17,154,601,0,0,0,0,601,17,154
17,158,0,0,498,0,0,498,17,158
17,163,0,0,864,0,0,864,17,163
17,166,660,0,31,201,0,892,17,166
17,169,67,0,0,0,0,67,17,169
17,172,0,0,259,0,0,259,17,172
17,174,372,0,0,0,0,372,17,174
17,175,0,0,312,0,0,312,17,175
17,176,0,0,64,0,0,64,17,176
17,181,147,0,0,0,0,147,17,181
17,187,0,0,130,0,0,130,17,187
17,189,0,0,432,0,0,432,17,189
17,190,0,0,421,0,0,421,17,190
17,192,0,0,258,0,0,258,17,192
17,196,0,0,416,0,0,416,17,196
17,208,537,0,21,0,0,558,17,208
17,209,164,0,0,0,0,164,17,209
17,211,0,0,677,0,0,677,17,211
17,216,0,0,477,0,0,477,17,216
17,222,0,0,223,0,0,223,17,222
17,228,0,0,217,0,0,217,17,228
17,231,0,0,118,0,0,118,17,231
17,235,0,0,696,0,0,696,17,235
17,240,0,0,0,24,0,24,17,240
17,242,0,0,120,0,0,120,17,242
17,244,0,0,600,0,0,600,17,244
17,248,0,0,26,0,0,26,17,248
17,250,0,0,35,0,0,35,17,250
17,252,0,0,58,0,0,58,17,252
17,256,0,0,472,0,0,472,17,256
17,287,0,0,118,0,0,118,17,287
17,294,0,0,20,0,0,20,17,294
17,295,0,0,21,0,0,21,17,295
17,308,0,0,245,0,0,245,17,308
17,322,77,0,0,0,0,77,17,322
17,325,0,0,445,0,0,445,17,325
17,333,0,0,24,0,0,24,17,333
18,1,299,0,460,0,0,759,18,1
18,2,128,0,325,0,0,453,18,2
18,3,184,556,170,0,0,910,18,3
18,4,198,0,0,0,0,198,18,4
18,5,0,0,691,186,0,877,18,5
18,6,0,0,276,0,0,276,18,6
18,7,182,0,0,0,0,182,18,7
18,9,0,0,111,0,0,111,18,9
18,14,0,124,135,0,0,259,18,14
18,16,0,1205,0,0,0,1205,18,16
18,17,48,58,0,78,0,184,18,17
18,18,2757,12173,0,0,0,14930,18,18
18,19,2232,929,87,0,0,3248,18,19
18,20,233,1067,0,0,0,1300,18,20
18,21,119,59,102,83,0,363,18,21
18,22,0,2615,0,125,0,2740,18,22
18,23,0,0,409,0,0,409,18,23
18,28,38,0,0,0,0,38,18,28
18,29,124,0,0,0,0,124,18,29
18,31,198,0,0,0,0,198,18,31
18,32,0,0,310,0,0,310,18,32
18,34,23,0,0,0,0,23,18,34
18,35,0,0,129,852,0,981,18,35
18,38,35,0,0,0,0,35,18,38
18,39,249,0,122,0,0,371,18,39
18,40,27,0,135,0,0,162,18,40
18,41,121,0,0,0,0,121,18,41
18,42,66,0,20,0,0,86,18,42
18,43,0,595,462,0,433,1490,18,43
18,44,0,0,326,743,0,1069,18,44
18,45,379,263,0,80,0,722,18,45
18,46,0,0,786,0,0,786,18,46
18,47,125,0,0,372,0,497,18,47
18,48,615,0,254,247,0,1116,18,48
18,49,0,0,325,80,0,405,18,49
18,50,301,62,38,0,0,401,18,50
18,51,104,0,0,0,0,104,18,51
18,52,184,0,0,0,0,184,18,52
18,56,169,0,0,167,0,336,18,56
18,58,100,0,0,0,0,100,18,58
18,68,124,0,0,0,0,124,18,68
18,69,0,0,87,0,0,87,18,69
18,73,84,0,0,0,0,84,18,73
18,79,124,0,248,0,0,372,18,79
18,80,0,0,135,0,0,135,18,80
18,82,0,0,366,0,0,366,18,82
18,99,0,0,0,96,0,96,18,99
18,100,0,0,229,0,0,229,18,100
18,104,21,0,0,0,0,21,18,104
18,106,0,0,88,0,0,88,18,106
18,116,0,0,292,0,0,292,18,116
18,129,0,0,74,0,0,74,18,129
18,130,0,0,45,0,0,45,18,130
18,136,673,0,0,0,0,673,18,136
18,152,187,0,0,0,0,187,18,152
18,160,0,0,484,0,0,484,18,160
18,165,66,0,124,0,0,190,18,165
18,166,0,0,143,0,0,143,18,166
18,167,2091,0,294,0,0,2385,18,167
18,173,0,0,272,0,0,272,18,173
18,177,0,0,50,0,0,50,18,177
18,187,0,0,273,0,0,273,18,187
18,189,212,0,0,0,0,212,18,189
18,190,282,0,282,0,0,564,18,190
18,193,0,0,140,0,0,140,18,193
18,202,0,0,754,0,0,754,18,202
18,204,0,0,1859,0,0,1859,18,204
18,206,0,0,598,0,0,598,18,206
18,207,722,0,0,0,0,722,18,207
18,208,0,0,447,0,0,447,18,208
18,209,0,0,230,0,0,230,18,209
18,211,180,0,0,0,0,180,18,211
18,214,124,0,0,0,0,124,18,214
18,217,170,0,0,0,0,170,18,217
18,225,134,0,0,0,0,134,18,225
18,228,0,0,455,0,0,455,18,228
18,229,0,0,365,0,0,365,18,229
18,233,0,0,338,0,0,338,18,233
18,236,0,0,246,96,0,342,18,236
18,237,466,0,426,0,0,892,18,237
18,239,373,0,136,0,0,509,18,239
18,240,889,0,295,0,0,1184,18,240
18,241,111,0,417,0,77,605,18,241
18,242,339,0,0,0,0,339,18,242
18,243,635,0,0,0,0,635,18,243
18,244,1312,0,366,0,0,1678,18,244
18,245,254,0,0,0,0,254,18,245
18,247,0,0,0,93,0,93,18,247
18,253,0,0,0,0,34,34,18,253
18,254,0,0,102,0,0,102,18,254
18,258,0,0,881,0,0,881,18,258
18,260,0,0,282,0,0,282,18,260
18,261,0,0,292,0,0,292,18,261
18,262,0,0,915,0,0,915,18,262
18,263,0,0,634,0,0,634,18,263
18,264,0,0,335,0,0,335,18,264
18,269,184,0,0,0,0,184,18,269
18,271,124,0,231,0,0,355,18,271
18,272,136,0,0,0,0,136,18,272
18,274,0,0,196,0,0,196,18,274
18,300,124,0,301,0,0,425,18,300
18,303,0,0,79,0,0,79,18,303
18,307,0,0,613,0,0,613,18,307
18,314,0,0,1282,0,0,1282,18,314
18,316,44,0,0,0,0,44,18,316
18,317,263,0,0,0,0,263,18,317
18,320,274,0,270,0,0,544,18,320
18,333,0,0,202,0,0,202,18,333
18,334,291,0,0,0,0,291,18,334
18,340,13,0,0,0,0,13,18,340
19,1,379,22,413,0,0,814,19,1
19,2,0,0,220,0,0,220,19,2
19,5,296,0,285,365,0,946,19,5
19,8,0,0,111,0,0,111,19,8
19,10,0,0,0,396,0,396,19,10
19,11,0,0,24,0,0,24,19,11
19,17,128,0,0,0,0,128,19,17
19,18,2107,1009,0,0,0,3116,19,18
19,19,3669,6632,170,451,0,10922,19,19
19,20,242,805,548,57,0,1652,19,20
19,21,854,648,128,332,0,1962,19,21
19,22,67,122,518,0,0,707,19,22
19,23,128,0,15,0,0,143,19,23
19,24,156,0,0,0,0,156,19,24
19,27,124,0,0,60,0,184,19,27
19,29,0,0,145,0,0,145,19,29
19,31,0,0,170,178,0,348,19,31
19,32,0,0,339,0,0,339,19,32
19,35,0,0,647,0,0,647,19,35
19,43,37,0,0,70,0,107,19,43
19,45,0,0,0,236,0,236,19,45
19,47,0,0,117,0,0,117,19,47
19,49,274,256,128,0,0,658,19,49
19,50,785,339,180,0,0,1304,19,50
19,51,0,434,0,0,0,434,19,51
19,52,756,0,170,80,0,1006,19,52
19,53,0,0,170,79,0,249,19,53
19,54,183,0,0,0,0,183,19,54
19,55,161,0,0,712,0,873,19,55
19,56,38,226,170,128,0,562,19,56
19,57,0,0,197,0,0,197,19,57
19,58,674,0,0,100,0,774,19,58
19,59,146,0,0,0,0,146,19,59
19,61,0,0,552,0,0,552,19,61
19,67,0,0,91,0,0,91,19,67
19,69,201,0,0,35,0,236,19,69
19,73,146,0,0,0,0,146,19,73
19,74,0,0,0,254,0,254,19,74
19,75,0,0,38,0,0,38,19,75
19,78,230,0,0,0,0,230,19,78
19,79,63,0,0,0,0,63,19,79
19,80,0,0,140,49,0,189,19,80
19,82,0,0,0,156,0,156,19,82
19,85,24,0,0,0,0,24,19,85
19,86,0,0,80,0,0,80,19,86
19,87,0,0,26,0,0,26,19,87
19,88,138,0,0,0,0,138,19,88
19,92,4,0,0,0,0,4,19,92
19,93,0,0,156,0,0,156,19,93
19,104,0,0,146,0,0,146,19,104
19,110,0,0,329,0,0,329,19,110
19,113,284,0,0,0,0,284,19,113
19,124,146,0,0,0,0,146,19,124
19,126,0,0,394,100,0,494,19,126
19,130,0,0,90,0,0,90,19,130
19,133,0,0,162,0,0,162,19,133
19,135,0,0,714,0,0,714,19,135
19,163,114,0,0,0,0,114,19,163
19,165,0,0,128,0,0,128,19,165
19,170,146,0,0,0,0,146,19,170
19,186,97,0,0,0,0,97,19,186
19,193,0,0,278,0,0,278,19,193
19,199,0,0,541,0,0,541,19,199
19,201,1206,0,0,0,0,1206,19,201
19,208,0,0,495,0,0,495,19,208
19,231,0,0,236,0,0,236,19,231
19,237,136,0,0,0,0,136,19,237
19,238,178,0,0,0,0,178,19,238
19,239,1620,0,67,198,0,1885,19,239
19,240,2462,743,140,336,0,3681,19,240
19,241,256,0,58,0,0,314,19,241
19,242,178,0,272,0,0,450,19,242
19,243,558,0,0,0,0,558,19,243
19,247,0,0,1487,0,0,1487,19,247
19,248,0,0,145,0,0,145,19,248
19,252,210,0,0,0,0,210,19,252
19,255,758,0,506,0,0,1264,19,255
19,256,0,0,74,0,0,74,19,256
19,259,0,0,213,0,0,213,19,259
19,267,0,0,153,0,0,153,19,267
19,271,128,0,0,0,0,128,19,271
19,273,292,0,0,0,0,292,19,273
19,274,0,0,128,0,0,128,19,274
19,275,0,0,577,0,0,577,19,275
19,276,0,0,867,0,0,867,19,276
19,278,0,0,0,265,0,265,19,278
19,290,0,0,629,0,0,629,19,290
19,305,0,0,220,0,0,220,19,305
19,317,14,0,0,0,0,14,19,317
19,318,0,0,110,0,0,110,19,318
19,325,0,0,202,0,0,202,19,325
19,329,0,0,53,0,0,53,19,329
19,331,0,0,0,298,0,298,19,331
19,339,0,0,156,0,226,382,19,339
20,1,468,0,911,83,0,1462,20,1
20,2,0,138,216,0,212,566,20,2
20,3,0,307,1317,312,0,1936,20,3
20,5,254,0,254,0,0,508,20,5
20,7,76,0,0,0,0,76,20,7
20,8,0,0,320,0,0,320,20,8
20,9,57,0,0,0,0,57,20,9
20,14,0,0,82,0,0,82,20,14
20,18,233,1067,0,0,0,1300,20,18
20,19,242,1008,548,311,0,2109,20,19
20,20,468,9188,0,0,0,9656,20,20
20,21,1708,612,404,58,0,2782,20,21
20,22,266,824,234,0,0,1324,20,22
20,23,233,0,191,0,0,424,20,23
20,24,0,252,424,519,0,1195,20,24
20,26,0,0,276,0,0,276,20,26
20,27,1139,0,0,0,0,1139,20,27
20,28,57,0,82,0,0,139,20,28
20,29,0,0,133,0,0,133,20,29
20,30,0,0,276,0,0,276,20,30
20,31,76,0,174,0,0,250,20,31
20,32,0,215,509,0,0,724,20,32
20,35,0,254,0,0,0,254,20,35
20,40,0,0,120,0,0,120,20,40
20,41,0,0,62,0,0,62,20,41
20,42,0,0,209,0,0,209,20,42
20,43,63,0,0,0,0,63,20,43
20,45,0,0,180,0,0,180,20,45
20,47,724,0,0,0,0,724,20,47
20,49,1123,50,785,151,0,2109,20,49
20,50,468,0,0,192,0,660,20,50
20,52,0,0,60,0,0,60,20,52
20,53,0,0,254,0,0,254,20,53
20,56,154,254,60,0,0,468,20,56
20,57,254,0,1037,0,0,1291,20,57
20,59,0,0,76,76,0,152,20,59
20,60,323,0,0,0,0,323,20,60
20,62,0,0,0,254,0,254,20,62
20,69,0,0,319,0,0,319,20,69
20,72,76,0,0,0,0,76,20,72
20,73,0,0,0,76,0,76,20,73
20,74,0,0,267,39,0,306,20,74
20,78,555,0,0,254,0,809,20,78
20,81,511,0,0,0,0,511,20,81
20,82,0,0,306,0,0,306,20,82
20,83,0,0,254,0,0,254,20,83
20,88,138,0,0,0,0,138,20,88
20,93,0,0,0,254,0,254,20,93
20,130,0,0,281,0,0,281,20,130
20,136,0,0,480,0,0,480,20,136
20,151,0,0,313,0,0,313,20,151
20,162,0,0,0,43,0,43,20,162
20,167,76,0,254,0,0,330,20,167
20,223,0,0,55,0,0,55,20,223
20,233,0,0,616,0,0,616,20,233
20,237,0,0,509,0,0,509,20,237
20,239,254,0,0,0,0,254,20,239
20,240,0,0,16,0,0,16,20,240
20,242,0,0,576,0,0,576,20,242
20,243,0,0,133,0,0,133,20,243
20,244,0,0,0,803,0,803,20,244
20,247,519,0,653,0,0,1172,20,247
20,255,758,0,0,0,0,758,20,255
20,261,0,0,892,0,0,892,20,261
20,267,0,0,153,0,0,153,20,267
20,273,76,0,0,0,0,76,20,273
20,275,0,0,281,0,0,281,20,275
20,281,442,0,0,0,0,442,20,281
20,296,15,0,15,0,0,30,20,296
20,301,783,0,0,0,0,783,20,301
20,307,0,0,82,0,0,82,20,307
20,341,0,0,230,0,0,230,20,341
21,1,59,0,263,0,0,322,21,1
21,3,904,0,250,0,0,1154,21,3
21,4,0,0,206,0,0,206,21,4
21,5,0,0,467,0,0,467,21,5
21,6,0,0,83,0,0,83,21,6
21,16,0,0,0,111,0,111,21,16
21,18,119,153,120,83,0,475,21,18
21,19,39,846,946,198,0,2029,21,19
21,20,2097,612,180,137,0,3026,21,20
21,21,1122,5140,0,686,0,6948,21,21
21,22,165,1483,73,178,0,1899,21,22
21,23,215,152,0,329,0,696,21,23
21,24,155,134,467,0,0,756,21,24
21,27,0,0,0,83,0,83,21,27
21,28,38,0,0,0,0,38,21,28
21,29,83,0,740,241,0,1064,21,29
21,31,30,0,329,0,0,359,21,31
21,32,110,0,90,0,0,200,21,32
21,34,119,0,0,0,0,119,21,34
21,35,0,0,90,0,160,250,21,35
21,36,0,0,466,0,0,466,21,36
21,37,0,0,83,0,0,83,21,37
21,45,0,0,0,321,0,321,21,45
21,49,972,227,258,76,0,1533,21,49
21,51,656,72,0,0,0,728,21,51
21,52,527,439,0,0,0,966,21,52
21,53,0,0,261,0,0,261,21,53
21,54,26,0,0,0,0,26,21,54
21,55,1150,221,0,379,0,1750,21,55
21,56,420,121,0,0,0,541,21,56
21,57,119,0,120,0,0,239,21,57
21,58,100,0,0,0,0,100,21,58
21,59,551,0,0,274,0,825,21,59
21,60,0,0,83,0,0,83,21,60
21,61,486,0,83,0,0,569,21,61
21,62,110,0,0,0,0,110,21,62
21,64,128,0,0,0,0,128,21,64
21,65,1072,0,0,0,0,1072,21,65
21,66,48,0,0,0,0,48,21,66
21,69,0,0,72,0,0,72,21,69
21,72,0,0,83,0,0,83,21,72
21,73,321,0,83,0,0,404,21,73
21,74,0,0,78,83,0,161,21,74
21,75,0,0,42,0,0,42,21,75
21,76,83,0,0,0,0,83,21,76
21,77,0,0,0,143,0,143,21,77
21,78,0,0,0,83,0,83,21,78
21,79,41,0,0,0,0,41,21,79
21,83,0,0,321,0,0,321,21,83
21,84,0,0,111,0,0,111,21,84
21,86,0,0,70,0,0,70,21,86
21,88,138,0,0,0,0,138,21,88
21,91,0,0,313,0,0,313,21,91
21,93,83,0,0,0,0,83,21,93
21,97,0,0,349,0,0,349,21,97
21,108,0,0,83,0,0,83,21,108
21,127,98,0,0,0,0,98,21,127
21,144,0,0,111,0,0,111,21,144
21,154,83,0,0,0,0,83,21,154
21,184,159,0,0,0,0,159,21,184
21,203,0,0,110,0,0,110,21,203
21,208,0,0,349,0,0,349,21,208
21,210,0,0,111,0,0,111,21,210
21,216,0,0,439,0,0,439,21,216
21,236,178,0,0,0,0,178,21,236
21,237,0,0,90,0,0,90,21,237
21,238,41,0,336,151,0,528,21,238
21,239,493,0,466,0,0,959,21,239
21,240,1132,0,447,0,0,1579,21,240
21,241,0,0,0,106,0,106,21,241
21,250,0,0,108,0,0,108,21,250
21,251,151,0,217,0,0,368,21,251
21,254,83,0,0,0,0,83,21,254
21,266,0,0,0,83,0,83,21,266
21,270,54,0,83,0,0,137,21,270
21,272,0,0,42,0,0,42,21,272
21,273,292,0,0,704,0,996,21,273
21,274,0,0,0,230,0,230,21,274
21,276,0,0,0,72,0,72,21,276
21,282,83,0,0,0,0,83,21,282
21,285,0,0,83,0,0,83,21,285
21,288,0,0,56,0,0,56,21,288
21,289,59,0,0,0,0,59,21,289
21,300,836,0,440,0,0,1276,21,300
21,301,0,0,163,0,0,163,21,301
21,303,111,0,0,0,0,111,21,303
21,305,0,0,220,0,0,220,21,305
21,311,110,0,0,0,0,110,21,311
21,320,111,0,0,0,0,111,21,320
21,326,0,0,598,0,0,598,21,326
21,329,0,0,0,83,0,83,21,329
21,333,165,0,0,0,0,165,21,333
21,339,111,0,149,0,0,260,21,339
22,1,0,0,339,103,0,442,22,1
22,2,0,0,194,0,0,194,22,2
22,4,0,31,73,0,0,104,22,4
22,5,178,0,228,67,0,473,22,5
22,6,0,495,0,0,0,495,22,6
22,7,0,0,178,0,0,178,22,7
22,10,67,0,0,0,0,67,22,10
22,16,0,0,67,0,0,67,22,16
22,17,0,0,49,0,0,49,22,17
22,18,249,2615,96,125,0,3085,22,18
22,19,67,0,518,122,0,707,22,19
22,20,184,1292,215,0,0,1691,22,20
22,21,165,1372,73,178,0,1788,22,21
22,22,424,792,0,0,0,1216,22,22
22,23,273,1904,185,0,0,2362,22,23
22,24,124,1187,150,0,0,1461,22,24
22,26,0,167,0,0,94,261,22,26
22,27,774,424,120,0,0,1318,22,27
22,28,0,0,97,0,0,97,22,28
22,29,0,0,103,0,0,103,22,29
22,30,87,0,96,0,0,183,22,30
22,31,0,0,364,0,0,364,22,31
22,32,0,0,367,0,0,367,22,32
22,34,39,0,0,0,0,39,22,34
22,35,0,0,73,0,0,73,22,35
22,36,109,0,131,0,0,240,22,36
22,40,0,0,18,0,0,18,22,40
22,43,96,0,0,0,0,96,22,43
22,47,0,0,107,0,0,107,22,47
22,48,0,0,36,0,0,36,22,48
22,49,0,885,0,0,107,992,22,49
22,50,0,0,38,0,0,38,22,50
22,51,455,0,104,0,0,559,22,51
22,52,61,0,76,0,0,137,22,52
22,53,0,0,303,0,0,303,22,53
22,54,0,0,36,0,0,36,22,54
22,55,0,0,36,0,0,36,22,55
22,56,690,119,0,123,0,932,22,56
22,57,583,197,0,0,0,780,22,57
22,58,256,0,0,0,0,256,22,58
22,59,0,267,614,0,0,881,22,59
22,60,69,0,0,0,0,69,22,60
22,61,0,67,96,0,0,163,22,61
22,65,116,0,0,0,0,116,22,65
22,71,0,0,46,0,0,46,22,71
22,72,177,0,0,0,0,177,22,72
22,73,67,0,178,0,0,245,22,73
22,74,0,0,98,0,0,98,22,74
22,75,67,0,0,0,0,67,22,75
22,76,38,0,0,0,0,38,22,76
22,77,0,0,94,0,0,94,22,77
22,78,0,0,160,0,0,160,22,78
22,80,0,0,209,0,0,209,22,80
22,81,29,0,0,0,0,29,22,81
22,82,0,0,36,0,0,36,22,82
22,83,0,0,69,0,0,69,22,83
22,84,0,0,104,67,0,171,22,84
22,88,0,0,150,0,0,150,22,88
22,93,0,0,111,0,0,111,22,93
22,99,0,0,67,0,0,67,22,99
22,100,0,0,162,0,0,162,22,100
22,102,134,0,0,0,0,134,22,102
22,116,0,0,537,0,0,537,22,116
22,121,0,0,346,0,0,346,22,121
22,145,0,0,31,0,0,31,22,145
22,153,0,0,160,0,0,160,22,153
22,155,0,0,290,0,0,290,22,155
22,159,1181,0,0,0,0,1181,22,159
22,161,0,0,29,0,0,29,22,161
22,163,0,0,876,0,0,876,22,163
22,173,0,0,272,0,0,272,22,173
22,195,0,0,130,0,0,130,22,195
22,201,0,0,107,0,0,107,22,201
22,226,0,0,163,0,0,163,22,226
22,227,0,0,464,0,0,464,22,227
22,239,589,0,0,0,0,589,22,239
22,251,0,0,279,0,0,279,22,251
22,254,0,0,640,0,0,640,22,254
22,260,0,0,787,0,0,787,22,260
22,264,83,0,0,0,0,83,22,264
22,269,85,0,0,0,0,85,22,269
22,274,0,0,263,0,0,263,22,274
22,275,0,0,67,0,0,67,22,275
22,278,77,0,0,0,0,77,22,278
22,293,0,0,593,0,0,593,22,293
22,300,0,0,67,0,0,67,22,300
22,311,0,0,554,0,0,554,22,311
22,327,67,0,0,0,0,67,22,327
22,328,0,0,0,122,0,122,22,328
22,339,0,0,546,0,0,546,22,339
22,340,0,0,37,0,0,37,22,340
23,1,894,56,86,0,0,1036,23,1
23,2,0,63,1047,0,41,1151,23,2
23,3,0,88,145,0,0,233,23,3
23,4,0,0,152,0,0,152,23,4
23,5,0,0,0,29,0,29,23,5
23,6,0,0,0,96,0,96,23,6
23,8,0,0,0,83,0,83,23,8
23,9,0,0,26,0,0,26,23,9
23,12,63,0,0,0,0,63,23,12
23,15,0,0,24,0,0,24,23,15
23,16,309,0,0,0,0,309,23,16
23,18,0,0,231,0,0,231,23,18
23,19,128,0,0,0,0,128,23,19
23,20,233,0,109,0,0,342,23,20
23,21,215,222,69,127,0,633,23,21
23,22,273,1987,185,0,0,2445,23,22
23,23,0,4311,0,83,0,4394,23,23
23,24,0,1609,29,0,0,1638,23,24
23,26,0,428,0,0,81,509,23,26
23,27,0,570,0,65,0,635,23,27
23,28,0,29,186,0,0,215,23,28
23,29,63,60,193,0,0,316,23,29
23,31,200,0,99,0,0,299,23,31
23,32,0,0,63,0,0,63,23,32
23,33,0,0,56,0,0,56,23,33
23,35,0,0,123,0,0,123,23,35
23,36,0,0,131,0,0,131,23,36
23,40,0,0,189,0,0,189,23,40
23,41,0,0,43,121,0,164,23,41
23,43,63,0,69,0,0,132,23,43
23,44,0,0,127,0,0,127,23,44
23,45,240,0,180,0,0,420,23,45
23,46,0,0,0,420,0,420,23,46
23,49,155,1409,32,0,0,1596,23,49
23,53,0,0,112,0,0,112,23,53
23,54,0,0,225,0,0,225,23,54
23,56,63,569,199,0,0,831,23,56
23,57,0,475,0,155,0,630,23,57
23,58,127,0,0,0,0,127,23,58
23,59,607,0,173,393,0,1173,23,59
23,61,98,0,415,0,0,513,23,61
23,63,56,0,0,0,0,56,23,63
23,64,346,0,224,120,0,690,23,64
23,65,116,0,0,0,0,116,23,65
23,66,58,0,0,0,0,58,23,66
23,68,178,0,61,0,0,239,23,68
23,69,63,0,0,0,0,63,23,69
23,70,127,0,29,0,0,156,23,70
23,73,0,0,114,56,0,170,23,73
23,74,0,0,154,0,0,154,23,74
23,75,56,0,428,0,0,484,23,75
23,76,557,0,56,0,111,724,23,76
23,77,140,0,275,0,0,415,23,77
23,78,0,0,102,0,0,102,23,78
23,79,0,0,23,0,0,23,23,79
23,80,82,0,57,0,0,139,23,80
23,81,37,0,84,0,0,121,23,81
23,83,0,0,191,0,0,191,23,83
23,84,0,0,51,0,0,51,23,84
23,85,0,0,32,0,0,32,23,85
23,87,0,0,33,0,0,33,23,87
23,88,170,0,350,0,0,520,23,88
23,91,0,0,738,0,0,738,23,91
23,93,40,0,29,0,0,69,23,93
23,96,0,0,56,0,0,56,23,96
23,97,0,0,56,0,0,56,23,97
23,98,0,0,7,0,0,7,23,98
23,99,138,0,0,0,0,138,23,99
23,100,0,0,29,0,0,29,23,100
23,109,0,0,2193,0,0,2193,23,109
23,127,0,0,0,360,0,360,23,127
23,128,0,0,38,0,0,38,23,128
23,131,0,0,70,0,0,70,23,131
23,135,0,0,639,0,0,639,23,135
23,141,0,0,29,0,0,29,23,141
23,144,1021,0,85,0,0,1106,23,144
23,145,0,0,24,0,0,24,23,145
23,150,0,0,474,0,0,474,23,150
23,151,0,0,522,0,0,522,23,151
23,154,0,0,226,0,0,226,23,154
23,157,0,0,154,0,0,154,23,157
23,161,0,0,590,0,0,590,23,161
23,163,0,0,114,0,0,114,23,163
23,167,0,0,158,0,0,158,23,167
23,168,0,0,207,0,0,207,23,168
23,173,0,0,290,0,0,290,23,173
23,176,0,0,453,0,0,453,23,176
23,177,0,0,152,0,0,152,23,177
23,180,458,0,0,0,0,458,23,180
23,181,0,0,447,0,0,447,23,181
23,183,0,0,282,0,0,282,23,183
23,184,0,0,210,0,0,210,23,184
23,190,0,0,282,0,0,282,23,190
23,195,0,0,317,0,0,317,23,195
23,203,0,0,249,0,0,249,23,203
23,205,788,0,0,0,0,788,23,205
23,208,0,0,455,0,0,455,23,208
23,213,0,0,1394,0,0,1394,23,213
23,221,0,0,754,0,0,754,23,221
23,222,0,0,315,0,0,315,23,222
23,226,0,0,788,0,0,788,23,226
23,228,0,0,245,0,0,245,23,228
23,229,0,0,452,0,0,452,23,229
23,232,0,0,373,0,0,373,23,232
23,233,0,0,436,0,0,436,23,233
23,235,0,0,0,1202,0,1202,23,235
23,236,112,0,0,0,0,112,23,236
23,237,0,0,47,0,0,47,23,237
23,239,0,0,560,0,0,560,23,239
23,240,204,0,319,0,0,523,23,240
23,241,0,0,100,0,0,100,23,241
23,242,0,0,178,0,0,178,23,242
23,246,0,0,453,0,0,453,23,246
23,247,0,0,953,0,0,953,23,247
23,250,99,0,315,0,0,414,23,250
23,253,39,0,44,0,0,83,23,253
23,260,0,0,787,0,0,787,23,260
23,261,0,0,561,0,0,561,23,261
23,264,0,0,449,0,0,449,23,264
23,268,36,0,0,0,0,36,23,268
23,269,0,0,214,0,0,214,23,269
23,272,0,0,114,0,0,114,23,272
23,274,392,0,1558,0,0,1950,23,274
23,275,0,0,288,0,0,288,23,275
23,278,0,0,1658,0,0,1658,23,278
23,280,0,0,115,0,0,115,23,280
23,283,0,0,54,0,0,54,23,283
23,284,0,0,299,0,0,299,23,284
23,285,0,0,467,0,0,467,23,285
23,286,56,0,0,0,0,56,23,286
23,290,0,0,1030,0,0,1030,23,290
23,301,79,0,0,0,0,79,23,301
23,303,56,0,29,0,0,85,23,303
23,311,81,0,0,0,0,81,23,311
23,315,0,0,48,0,0,48,23,315
23,316,53,0,0,0,0,53,23,316
23,317,0,0,14,0,0,14,23,317
23,319,0,0,18,0,0,18,23,319
23,320,0,0,190,0,0,190,23,320
23,322,77,0,0,0,0,77,23,322
23,327,104,0,127,22,0,253,23,327
23,332,0,0,405,0,0,405,23,332
24,1,0,713,555,0,0,1268,24,1
24,2,0,92,1061,0,0,1153,24,2
24,3,0,4250,0,0,0,4250,24,3
24,4,255,492,0,0,0,747,24,4
24,5,0,0,276,0,0,276,24,5
24,6,0,169,366,0,0,535,24,6
24,7,0,0,60,0,0,60,24,7
24,8,0,0,125,0,0,125,24,8
24,9,0,0,20,0,0,20,24,9
24,11,0,0,61,0,0,61,24,11
24,12,0,0,83,0,0,83,24,12
24,14,425,0,15,0,0,440,24,14
24,15,0,0,167,0,0,167,24,15
24,16,83,32,94,0,0,209,24,16
24,17,0,0,15,60,0,75,24,17
24,19,156,0,0,0,0,156,24,19
24,20,0,770,582,254,0,1606,24,20
24,21,155,134,0,0,0,289,24,21
24,22,339,906,157,67,0,1469,24,22
24,23,0,1483,29,0,0,1512,24,23
24,24,1023,8245,0,500,0,9768,24,24
24,26,156,956,0,66,0,1178,24,26
24,27,181,192,66,243,0,682,24,27
24,28,121,0,49,0,0,170,24,28
24,29,297,0,138,0,0,435,24,29
24,30,0,0,64,47,0,111,24,30
24,31,0,0,0,88,0,88,24,31
24,32,164,0,207,0,0,371,24,32
24,33,0,0,6,0,0,6,24,33
24,34,0,0,0,39,0,39,24,34
24,35,0,0,181,0,0,181,24,35
24,36,0,0,181,0,0,181,24,36
24,38,0,0,29,0,0,29,24,38
24,39,78,0,47,0,0,125,24,39
24,41,0,0,317,0,0,317,24,41
24,42,0,0,66,0,0,66,24,42
24,43,0,0,174,0,0,174,24,43
24,45,61,0,222,0,0,283,24,45
24,49,0,0,396,0,0,396,24,49
24,50,0,0,163,0,0,163,24,50
24,51,0,0,274,0,0,274,24,51
24,52,179,0,1011,0,0,1190,24,52
24,54,14,0,146,367,0,527,24,54
24,55,0,0,123,72,0,195,24,55
24,56,61,0,60,0,0,121,24,56
24,57,183,0,0,88,0,271,24,57
24,58,0,0,97,0,0,97,24,58
24,59,0,0,1302,0,0,1302,24,59
24,60,0,0,643,0,0,643,24,60
24,61,181,0,637,0,0,818,24,61
24,62,0,0,189,71,76,336,24,62
24,64,215,0,272,0,0,487,24,64
24,65,132,0,0,0,0,132,24,65
24,67,0,0,55,0,0,55,24,67
24,68,0,0,150,0,263,413,24,68
24,69,80,0,150,0,0,230,24,69
24,70,0,0,0,110,0,110,24,70
24,72,89,0,0,0,0,89,24,72
24,73,0,0,181,0,0,181,24,73
24,74,39,0,0,0,0,39,24,74
24,75,0,0,56,0,0,56,24,75
24,76,77,0,84,18,0,179,24,76
24,77,38,0,38,0,0,76,24,77
24,78,0,0,72,0,0,72,24,78
24,79,231,0,72,0,0,303,24,79
24,80,0,0,0,44,0,44,24,80
24,81,46,0,0,0,0,46,24,81
24,82,181,0,72,0,0,253,24,82
24,83,0,0,146,0,0,146,24,83
24,84,51,0,0,0,0,51,24,84
24,85,24,0,0,0,0,24,24,85
24,86,0,0,28,0,0,28,24,86
24,87,0,0,53,0,0,53,24,87
24,88,138,0,0,0,0,138,24,88
24,90,0,0,1028,0,0,1028,24,90
24,93,0,0,187,0,0,187,24,93
24,97,0,0,96,23,0,119,24,97
24,99,0,0,429,0,0,429,24,99
24,101,0,0,130,0,0,130,24,101
24,105,0,0,107,50,0,157,24,105
24,109,0,0,1410,0,0,1410,24,109
24,116,0,0,551,0,0,551,24,116
24,117,0,0,309,0,0,309,24,117
24,118,0,0,166,0,0,166,24,118
24,126,261,0,0,0,0,261,24,126
24,127,0,0,1300,0,0,1300,24,127
24,128,0,0,19,0,0,19,24,128
24,129,0,0,213,0,0,213,24,129
24,131,0,0,189,0,0,189,24,131
24,133,0,0,162,0,0,162,24,133
24,138,45,0,0,0,0,45,24,138
24,140,0,0,392,0,0,392,24,140
24,141,0,0,982,0,0,982,24,141
24,144,742,0,0,0,0,742,24,144
24,145,0,0,27,31,0,58,24,145
24,152,0,0,781,0,0,781,24,152
24,153,0,0,281,0,0,281,24,153
24,154,0,0,149,0,0,149,24,154
24,155,0,0,290,0,0,290,24,155
24,156,0,0,338,0,0,338,24,156
24,158,0,0,3830,0,0,3830,24,158
24,163,0,0,336,0,0,336,24,163
24,164,0,0,59,0,0,59,24,164
24,165,63,0,19,0,0,82,24,165
24,168,0,0,661,0,0,661,24,168
24,169,657,0,0,0,0,657,24,169
24,170,0,0,81,295,0,376,24,170
24,172,0,0,326,0,0,326,24,172
24,174,229,0,372,0,0,601,24,174
24,180,0,0,458,0,0,458,24,180
24,181,0,0,888,0,0,888,24,181
24,184,0,0,159,0,0,159,24,184
24,189,0,0,531,0,0,531,24,189
24,197,0,0,154,0,0,154,24,197
24,204,0,0,550,0,0,550,24,204
24,206,0,0,235,0,0,235,24,206
24,208,142,0,0,0,0,142,24,208
24,209,0,0,379,0,0,379,24,209
24,216,0,0,439,0,0,439,24,216
24,218,0,0,45,0,0,45,24,218
24,226,0,0,521,0,0,521,24,226
24,230,0,0,419,0,0,419,24,230
24,231,0,0,149,0,0,149,24,231
24,233,0,0,436,0,0,436,24,233
24,236,0,0,311,0,0,311,24,236
24,239,0,0,110,0,0,110,24,239
24,240,286,0,317,0,0,603,24,240
24,241,0,0,110,0,0,110,24,241
24,242,181,0,0,0,0,181,24,242
24,243,0,0,275,0,0,275,24,243
24,244,0,0,642,0,0,642,24,244
24,246,0,0,113,0,0,113,24,246
24,250,108,0,0,0,0,108,24,250
24,251,0,0,0,66,0,66,24,251
24,252,126,0,254,0,0,380,24,252
24,254,150,0,245,0,0,395,24,254
24,257,0,0,197,0,0,197,24,257
24,258,0,0,1055,0,0,1055,24,258
24,260,0,0,857,0,0,857,24,260
24,261,0,0,292,0,0,292,24,261
24,264,0,0,132,0,0,132,24,264
24,265,0,0,905,0,0,905,24,265
24,267,0,0,275,0,0,275,24,267
24,268,0,0,168,36,0,204,24,268
24,270,0,0,83,0,0,83,24,270
24,273,0,0,431,0,0,431,24,273
24,275,0,0,274,0,0,274,24,275
24,276,0,0,524,0,0,524,24,276
24,277,244,0,0,0,0,244,24,277
24,278,0,0,718,0,0,718,24,278
24,280,0,0,154,0,0,154,24,280
24,281,0,0,485,0,0,485,24,281
24,285,0,0,666,0,0,666,24,285
24,286,0,0,93,0,0,93,24,286
24,292,0,0,1475,0,0,1475,24,292
24,295,0,0,321,0,0,321,24,295
24,301,0,0,80,0,0,80,24,301
24,302,85,0,0,170,0,255,24,302
24,303,0,0,163,0,0,163,24,303
24,305,0,0,202,0,0,202,24,305
24,309,0,0,249,0,0,249,24,309
24,316,0,0,144,0,0,144,24,316
24,317,0,0,29,0,0,29,24,317
24,319,17,0,14,60,0,91,24,319
24,320,0,0,299,0,0,299,24,320
24,322,77,0,0,0,0,77,24,322
24,327,65,0,149,0,0,214,24,327
24,328,122,0,0,0,0,122,24,328
24,329,0,0,323,0,0,323,24,329
24,333,0,0,89,0,0,89,24,333
24,337,125,0,0,0,0,125,24,337
24,338,0,0,109,0,0,109,24,338
24,341,0,0,136,0,0,136,24,341
25,1,0,240,0,0,0,240,25,1
25,2,0,74,325,0,0,399,25,2
25,3,0,0,245,0,0,245,25,3
25,4,0,3115,0,735,0,3850,25,4
25,5,0,135,564,0,0,699,25,5
25,6,162,0,0,0,0,162,25,6
25,7,0,0,174,0,0,174,25,7
25,23,0,0,160,0,0,160,25,23
25,25,0,4986,0,0,0,4986,25,25
25,26,421,1692,0,0,0,2113,25,26
25,27,631,2005,174,0,0,2810,25,27
25,28,0,871,0,358,0,1229,25,28
25,29,0,1444,0,0,0,1444,25,29
25,31,0,2775,0,128,0,2903,25,31
25,32,0,21,98,0,0,119,25,32
25,36,202,0,0,0,285,487,25,36
25,43,0,0,82,0,0,82,25,43
25,49,0,48,74,32,0,154,25,49
25,51,104,0,0,0,0,104,25,51
25,54,0,0,14,0,0,14,25,54
25,57,149,160,904,0,0,1213,25,57
25,58,0,0,379,0,0,379,25,58
25,60,0,0,201,0,0,201,25,60
25,62,0,0,0,26,0,26,25,62
25,65,24,0,176,0,0,200,25,65
25,67,0,0,176,0,0,176,25,67
25,68,0,0,132,208,0,340,25,68
25,69,0,0,174,0,0,174,25,69
25,70,84,0,0,0,0,84,25,70
25,71,0,0,376,0,0,376,25,71
25,72,0,0,98,0,0,98,25,72
25,73,0,0,0,0,285,285,25,73
25,74,336,0,0,0,0,336,25,74
25,75,0,0,76,0,0,76,25,75
25,76,162,0,24,0,0,186,25,76
25,77,0,0,218,0,0,218,25,77
25,78,0,97,807,72,0,976,25,78
25,79,1043,197,176,0,0,1416,25,79
25,83,0,0,0,162,0,162,25,83
25,84,0,0,81,0,0,81,25,84
25,85,73,0,0,0,0,73,25,85
25,88,138,0,201,0,0,339,25,88
25,93,0,0,160,0,0,160,25,93
25,94,670,0,201,0,0,871,25,94
25,96,0,0,379,0,0,379,25,96
25,106,349,0,0,0,0,349,25,106
25,111,336,0,0,0,0,336,25,111
25,130,0,0,45,0,0,45,25,130
25,131,0,0,434,0,0,434,25,131
25,166,0,0,74,0,0,74,25,166
25,167,0,0,349,0,0,349,25,167
25,183,0,0,961,0,0,961,25,183
25,204,0,0,0,678,0,678,25,204
25,205,0,0,384,0,0,384,25,205
25,207,0,0,924,0,0,924,25,207
25,258,0,0,417,0,0,417,25,258
25,266,0,0,162,0,0,162,25,266
25,268,0,0,38,0,0,38,25,268
25,269,0,0,214,0,0,214,25,269
25,283,0,0,74,0,0,74,25,283
25,298,0,0,0,14,0,14,25,298
25,299,0,0,96,0,0,96,25,299
25,302,76,0,0,0,0,76,25,302
25,306,0,0,472,0,0,472,25,306
25,307,0,0,301,0,0,301,25,307
25,312,0,0,294,0,0,294,25,312
25,314,0,0,0,90,0,90,25,314
25,316,0,0,81,0,0,81,25,316
25,320,0,0,299,0,0,299,25,320
25,339,0,0,81,0,0,81,25,339
25,342,0,0,373,0,0,373,25,342
26,1,0,115,395,0,0,510,26,1
26,3,0,127,220,90,0,437,26,3
26,4,0,1347,0,0,94,1441,26,4
26,6,0,0,1237,71,0,1308,26,6
26,9,201,0,0,0,0,201,26,9
26,12,0,0,74,0,0,74,26,12
26,14,0,0,139,0,0,139,26,14
26,16,0,227,0,0,0,227,26,16
26,20,0,0,276,0,0,276,26,20
26,22,0,167,0,0,94,261,26,22
26,23,0,428,190,0,81,699,26,23
26,24,156,1347,0,66,0,1569,26,24
26,25,421,1552,0,0,0,1973,26,25
26,26,2025,7442,0,920,0,10387,26,26
26,27,1591,2445,295,0,0,4331,26,27
26,28,0,430,247,102,0,779,26,28
26,29,0,77,247,165,0,489,26,29
26,31,128,0,0,0,0,128,26,31
26,32,21,93,0,0,0,114,26,32
26,34,30,0,0,39,0,69,26,34
26,36,466,0,0,0,0,466,26,36
26,38,0,0,38,0,0,38,26,38
26,40,0,0,175,0,0,175,26,40
26,43,0,0,63,0,0,63,26,43
26,47,0,0,113,0,0,113,26,47
26,49,0,513,266,0,0,779,26,49
26,50,0,0,41,0,0,41,26,50
26,53,0,0,201,0,0,201,26,53
26,54,37,0,752,0,0,789,26,54
26,55,0,0,102,0,0,102,26,55
26,56,0,0,161,0,0,161,26,56
26,57,60,264,101,0,0,425,26,57
26,58,0,0,127,0,0,127,26,58
26,60,0,0,129,0,0,129,26,60
26,62,27,0,0,0,0,27,26,62
26,64,309,0,0,0,0,309,26,64
26,66,0,0,215,0,0,215,26,66
26,68,140,0,97,121,0,358,26,68
26,70,0,0,91,0,0,91,26,70
26,71,0,0,81,0,0,81,26,71
26,74,0,27,152,0,0,179,26,74
26,75,126,0,227,0,0,353,26,75
26,76,587,0,0,0,0,587,26,76
26,77,214,0,0,0,0,214,26,77
26,78,0,0,366,0,0,366,26,78
26,79,41,408,432,0,0,881,26,79
26,87,201,0,30,0,0,231,26,87
26,92,0,0,5,0,0,5,26,92
26,94,0,0,0,127,0,127,26,94
26,101,0,0,455,0,0,455,26,101
26,103,18,0,0,0,0,18,26,103
26,109,0,0,346,0,0,346,26,109
26,110,144,0,0,0,0,144,26,110
26,115,0,0,227,0,0,227,26,115
26,116,0,0,300,0,0,300,26,116
26,119,0,0,187,0,0,187,26,119
26,121,0,0,280,0,0,280,26,121
26,124,0,0,914,0,0,914,26,124
26,127,0,0,271,0,0,271,26,127
26,133,229,0,0,0,0,229,26,133
26,135,0,0,75,0,0,75,26,135
26,141,0,0,1369,0,0,1369,26,141
26,152,0,0,139,0,0,139,26,152
26,153,0,0,212,0,0,212,26,153
26,157,0,0,712,0,0,712,26,157
26,165,455,0,0,0,0,455,26,165
26,171,526,0,0,0,0,526,26,171
26,174,728,0,728,0,0,1456,26,174
26,182,88,0,0,0,0,88,26,182
26,184,0,0,181,0,0,181,26,184
26,190,0,0,521,0,0,521,26,190
26,192,0,0,276,0,0,276,26,192
26,198,0,0,246,0,0,246,26,198
26,222,0,0,145,0,0,145,26,222
26,226,521,0,0,0,0,521,26,226
26,238,227,0,0,0,0,227,26,238
26,240,127,0,0,0,0,127,26,240
26,246,0,0,253,0,0,253,26,246
26,251,113,0,0,0,0,113,26,251
26,268,36,0,0,0,0,36,26,268
26,271,0,0,156,0,0,156,26,271
26,275,967,0,377,0,0,1344,26,275
26,301,0,0,61,0,0,61,26,301
26,302,0,0,152,0,0,152,26,302
26,303,29,0,0,0,0,29,26,303
26,316,0,0,94,0,0,94,26,316
26,318,184,0,241,0,0,425,26,318
26,322,0,0,150,0,0,150,26,322
26,327,0,0,41,0,0,41,26,327
26,328,0,0,0,203,0,203,26,328
26,329,102,0,247,0,0,349,26,329
26,333,248,0,89,0,0,337,26,333
26,337,132,0,0,0,0,132,26,337
26,341,0,0,128,0,0,128,26,341
27,1,0,0,566,60,86,712,27,1
27,2,0,0,380,60,0,440,27,2
27,3,355,0,902,0,0,1257,27,3
27,4,365,883,204,717,0,2169,27,4
27,5,106,546,282,0,0,934,27,5
27,6,0,36,97,0,0,133,27,6
27,7,469,0,60,0,0,529,27,7
27,8,0,0,38,0,0,38,27,8
27,9,0,0,60,0,0,60,27,9
27,10,147,0,0,0,0,147,27,10
27,15,0,0,63,0,0,63,27,15
27,17,0,0,66,0,0,66,27,17
27,19,124,0,0,0,0,124,27,19
27,20,859,0,0,0,0,859,27,20
27,21,0,0,0,83,0,83,27,21
27,22,339,455,120,0,0,914,27,22
27,23,116,554,61,65,0,796,27,23
27,24,181,199,66,243,0,689,27,24
27,25,306,2082,174,0,0,2562,27,25
27,26,1591,2187,136,0,0,3914,27,26
27,27,238,12841,135,0,0,13214,27,27
27,28,240,1826,0,138,0,2204,27,28
27,29,183,941,246,0,0,1370,27,29
27,30,58,0,0,213,0,271,27,30
27,31,155,177,563,49,0,944,27,31
27,32,245,270,1370,100,0,1985,27,32
27,33,38,0,0,0,0,38,27,33
27,34,60,0,30,0,0,90,27,34
27,35,60,0,292,0,0,352,27,35
27,36,519,30,285,0,0,834,27,36
27,37,0,0,18,0,0,18,27,37
27,40,0,0,60,0,0,60,27,40
27,41,26,0,0,0,0,26,27,41
27,43,0,0,311,0,0,311,27,43
27,45,374,0,447,0,0,821,27,45
27,49,74,351,206,0,0,631,27,49
27,50,281,0,32,0,0,313,27,50
27,52,162,0,0,152,0,314,27,52
27,53,93,0,319,45,0,457,27,53
27,54,41,0,281,46,0,368,27,54
27,55,60,0,392,0,0,452,27,55
27,56,519,0,0,612,0,1131,27,56
27,57,1342,2915,133,183,256,4829,27,57
27,59,165,0,0,46,0,211,27,59
27,60,102,0,0,0,0,102,27,60
27,61,222,91,93,277,0,683,27,61
27,62,395,145,0,0,0,540,27,62
27,63,52,0,12,6,0,70,27,63
27,64,184,0,65,0,0,249,27,64
27,65,271,0,0,0,0,271,27,65
27,66,0,0,63,0,0,63,27,66
27,67,0,0,88,0,0,88,27,67
27,68,121,0,539,0,0,660,27,68
27,69,60,0,0,0,0,60,27,69
27,70,84,0,0,84,0,168,27,70
27,71,205,0,238,0,0,443,27,71
27,73,0,0,187,151,0,338,27,73
27,74,353,1063,26,192,0,1634,27,74
27,75,184,1002,0,0,0,1186,27,75
27,76,85,0,286,0,0,371,27,76
27,77,259,0,765,230,0,1254,27,77
27,78,393,78,293,102,256,1122,27,78
27,79,23,1086,481,83,0,1673,27,79
27,80,162,0,441,44,0,647,27,80
27,81,0,0,176,46,0,222,27,81
27,82,177,0,33,31,0,241,27,82
27,83,0,0,429,0,0,429,27,83
27,84,0,0,51,0,0,51,27,84
27,85,11,0,592,91,0,694,27,85
27,86,9,0,41,0,0,50,27,86
27,87,0,0,338,0,0,338,27,87
27,88,46,0,110,0,0,156,27,88
27,89,0,0,236,0,0,236,27,89
27,90,0,0,60,378,0,438,27,90
27,91,31,0,0,0,0,31,27,91
27,92,0,0,31,0,0,31,27,92
27,93,339,0,263,0,0,602,27,93
27,94,177,0,0,0,0,177,27,94
27,95,75,0,0,75,0,150,27,95
27,97,162,0,65,0,0,227,27,97
27,98,0,0,58,0,0,58,27,98
27,102,36,0,236,0,0,272,27,102
27,104,138,0,9,0,0,147,27,104
27,105,50,0,0,0,0,50,27,105
27,107,99,0,773,0,0,872,27,107
27,111,0,0,213,0,0,213,27,111
27,113,572,0,0,0,0,572,27,113
27,116,0,0,924,0,0,924,27,116
27,118,0,0,129,0,0,129,27,118
27,122,669,0,0,0,0,669,27,122
27,125,0,0,221,0,0,221,27,125
27,129,211,0,35,0,0,246,27,129
27,130,0,0,45,0,0,45,27,130
27,133,730,0,0,0,0,730,27,133
27,134,270,0,0,0,0,270,27,134
27,140,0,0,503,0,0,503,27,140
27,145,0,0,25,0,0,25,27,145
27,147,119,0,0,0,0,119,27,147
27,157,0,0,342,0,0,342,27,157
27,158,0,0,142,0,0,142,27,158
27,159,787,0,0,0,0,787,27,159
27,161,632,0,863,0,0,1495,27,161
27,163,0,0,238,0,0,238,27,163
27,165,93,0,43,0,0,136,27,165
27,167,0,0,60,0,0,60,27,167
27,168,0,0,251,0,0,251,27,168
27,169,447,0,31,0,0,478,27,169
27,171,0,0,268,0,0,268,27,171
27,173,0,0,393,0,0,393,27,173
27,180,458,0,66,0,0,524,27,180
27,181,447,0,277,0,0,724,27,181
27,182,0,0,60,0,0,60,27,182
27,183,0,0,282,0,0,282,27,183
27,186,0,0,73,0,0,73,27,186
27,187,0,0,455,0,0,455,27,187
27,192,0,0,226,0,0,226,27,192
27,193,0,0,207,0,0,207,27,193
27,199,0,0,900,0,0,900,27,199
27,205,0,0,384,0,0,384,27,205
27,208,268,0,0,0,0,268,27,208
27,209,1398,0,0,0,0,1398,27,209
27,218,0,0,1177,0,0,1177,27,218
27,222,60,0,0,0,0,60,27,222
27,225,0,0,637,0,0,637,27,225
27,230,0,0,1044,0,0,1044,27,230
27,233,0,0,436,0,0,436,27,233
27,234,31,0,0,0,0,31,27,234
27,236,41,0,0,0,0,41,27,236
27,237,47,0,76,0,0,123,27,237
27,238,135,0,151,0,0,286,27,238
27,239,0,0,240,0,0,240,27,239
27,240,60,0,59,204,0,323,27,240
27,241,0,0,189,0,0,189,27,241
27,242,0,0,178,0,0,178,27,242
27,247,0,0,1259,0,0,1259,27,247
27,249,0,0,332,0,0,332,27,249
27,254,0,0,600,0,0,600,27,254
27,255,0,0,758,0,0,758,27,255
27,257,0,0,734,0,0,734,27,257
27,261,0,0,426,0,0,426,27,261
27,265,0,0,343,0,0,343,27,265
27,268,43,0,0,0,0,43,27,268
27,269,0,0,106,0,0,106,27,269
27,270,114,0,0,0,0,114,27,270
27,274,0,0,478,0,0,478,27,274
27,275,91,0,289,0,0,380,27,275
27,276,0,0,1456,0,0,1456,27,276
27,278,0,0,488,0,0,488,27,278
27,279,0,0,299,0,0,299,27,279
27,281,0,0,173,0,0,173,27,281
27,283,0,0,70,0,0,70,27,283
27,289,0,0,332,0,0,332,27,289
27,290,0,0,311,0,0,311,27,290
27,294,0,0,1659,0,0,1659,27,294
27,296,0,0,30,0,0,30,27,296
27,298,0,0,250,0,0,250,27,298
27,300,332,0,189,0,0,521,27,300
27,301,79,0,151,0,0,230,27,301
27,302,60,0,83,0,0,143,27,302
27,303,27,0,0,0,0,27,27,303
27,305,0,0,170,0,0,170,27,305
27,307,0,0,1536,0,0,1536,27,307
27,311,0,0,477,0,0,477,27,311
27,314,0,0,1159,0,0,1159,27,314
27,315,0,0,549,0,0,549,27,315
27,316,60,0,0,0,0,60,27,316
27,317,36,0,0,7,0,43,27,317
27,318,0,0,110,437,0,547,27,318
27,319,17,0,192,12,0,221,27,319
27,320,0,0,274,0,0,274,27,320
27,321,111,0,0,0,0,111,27,321
27,324,0,0,502,0,0,502,27,324
27,325,0,0,445,0,0,445,27,325
27,326,0,0,78,0,0,78,27,326
27,327,65,0,0,0,0,65,27,327
27,329,0,0,0,51,0,51,27,329
27,332,646,0,646,0,0,1292,27,332
27,334,0,0,0,341,0,341,27,334
27,336,0,0,469,0,0,469,27,336
27,337,198,0,0,0,0,198,27,337
27,339,106,0,1289,0,0,1395,27,339
27,340,0,0,58,0,0,58,27,340
28,1,0,60,572,26,0,658,28,1
28,3,38,0,41,0,0,79,28,3
28,4,0,214,102,0,0,316,28,4
28,5,0,102,38,0,0,140,28,5
28,6,0,0,195,0,0,195,28,6
28,7,0,0,26,0,0,26,28,7
28,9,0,0,26,0,0,26,28,9
28,11,0,0,71,0,0,71,28,11
28,15,0,0,24,0,0,24,28,15
28,16,0,0,155,38,0,193,28,16
28,17,0,0,24,0,0,24,28,17
28,18,38,0,92,0,0,130,28,18
28,20,57,0,0,76,0,133,28,20
28,21,38,0,0,0,0,38,28,21
28,22,0,0,97,0,0,97,28,22
28,23,0,29,543,0,0,572,28,23
28,24,60,60,592,0,0,712,28,24
28,25,0,871,0,358,0,1229,28,25
28,26,0,657,0,102,0,759,28,26
28,27,53,2194,0,138,0,2385,28,27
28,28,205,5610,0,0,0,5815,28,28
28,29,0,1520,0,0,0,1520,28,29
28,30,0,35,47,167,0,249,28,30
28,31,128,221,107,0,0,456,28,31
28,32,38,232,60,96,0,426,28,32
28,33,0,0,30,0,0,30,28,33
28,34,23,0,0,0,0,23,28,34
28,35,310,0,0,0,0,310,28,35
28,36,102,0,178,38,144,462,28,36
28,41,0,0,63,0,0,63,28,41
28,43,0,0,91,0,0,91,28,43
28,45,0,0,306,0,0,306,28,45
28,49,177,48,213,0,0,438,28,49
28,51,0,0,87,0,126,213,28,51
28,52,0,0,857,0,0,857,28,52
28,53,0,0,94,0,0,94,28,53
28,54,26,0,172,0,0,198,28,54
28,55,0,0,110,196,0,306,28,55
28,56,64,0,148,0,0,212,28,56
28,57,26,1496,210,697,0,2429,28,57
28,59,102,0,393,0,0,495,28,59
28,60,102,0,26,54,0,182,28,60
28,62,0,0,41,0,0,41,28,62
28,63,0,11,0,0,0,11,28,63
28,64,175,0,41,120,0,336,28,64
28,65,561,0,0,0,0,561,28,65
28,66,0,0,155,0,0,155,28,66
28,67,80,0,0,80,0,160,28,67
28,68,76,0,493,182,0,751,28,68
28,69,80,0,24,152,0,256,28,69
28,71,0,0,145,0,0,145,28,71
28,72,38,0,174,110,0,322,28,72
28,73,216,0,198,64,0,478,28,73
28,74,111,2336,37,0,0,2484,28,74
28,75,320,776,0,93,0,1189,28,75
28,76,38,0,152,0,0,190,28,76
28,77,60,0,368,0,0,428,28,77
28,78,250,125,110,102,0,587,28,78
28,79,123,184,193,42,33,575,28,79
28,80,88,0,0,0,0,88,28,80
28,81,0,0,283,66,0,349,28,81
28,82,0,0,124,0,0,124,28,82
28,83,0,0,340,587,0,927,28,83
28,84,147,0,225,51,0,423,28,84
28,86,0,0,45,0,0,45,28,86
28,87,0,0,127,0,0,127,28,87
28,88,0,0,158,0,0,158,28,88
28,90,189,0,62,0,0,251,28,90
28,91,101,0,28,51,0,180,28,91
28,95,60,0,38,0,0,98,28,95
28,97,38,0,69,0,0,107,28,97
28,98,0,0,0,7,0,7,28,98
28,99,119,0,0,0,0,119,28,99
28,100,0,0,28,0,0,28,28,100
28,101,0,0,544,130,0,674,28,101
28,102,125,0,0,0,0,125,28,102
28,103,35,0,11,0,0,46,28,103
28,108,0,0,23,0,0,23,28,108
28,112,167,0,0,0,0,167,28,112
28,113,90,0,115,0,0,205,28,113
28,116,0,0,599,0,0,599,28,116
28,121,0,0,442,0,0,442,28,121
28,124,0,0,404,0,0,404,28,124
28,127,0,0,529,0,0,529,28,127
28,129,0,0,26,0,0,26,28,129
28,131,0,0,162,0,0,162,28,131
28,133,0,0,517,0,0,517,28,133
28,138,0,0,24,0,0,24,28,138
28,140,0,0,392,0,0,392,28,140
28,144,0,0,919,0,0,919,28,144
28,147,53,0,0,0,0,53,28,147
28,152,0,0,380,0,0,380,28,152
28,160,502,0,0,0,0,502,28,160
28,161,0,0,55,0,0,55,28,161
28,164,0,0,55,0,0,55,28,164
28,167,0,0,142,0,0,142,28,167
28,168,0,0,421,0,0,421,28,168
28,171,247,0,0,0,0,247,28,171
28,173,0,0,215,0,0,215,28,173
28,176,0,0,670,0,0,670,28,176
28,187,0,0,361,0,0,361,28,187
28,188,0,0,47,0,0,47,28,188
28,190,38,0,0,0,0,38,28,190
28,203,0,0,429,0,0,429,28,203
28,205,3851,0,0,0,0,3851,28,205
28,207,0,0,1138,0,0,1138,28,207
28,210,0,0,326,0,0,326,28,210
28,222,0,0,223,0,0,223,28,222
28,225,0,0,134,0,0,134,28,225
28,229,0,0,694,0,0,694,28,229
28,236,41,0,0,0,0,41,28,236
28,237,0,0,0,233,0,233,28,237
28,245,0,0,551,0,0,551,28,245
28,248,38,0,0,0,0,38,28,248
28,249,0,0,228,0,0,228,28,249
28,250,649,0,325,0,0,974,28,250
28,254,0,0,496,0,0,496,28,254
28,256,0,0,295,0,0,295,28,256
28,258,0,0,0,237,0,237,28,258
28,259,0,0,204,0,0,204,28,259
28,261,0,0,426,0,0,426,28,261
28,268,0,0,143,0,0,143,28,268
28,269,0,0,0,26,0,26,28,269
28,270,54,0,69,125,0,248,28,270
28,273,0,0,436,0,0,436,28,273
28,274,0,0,98,0,0,98,28,274
28,275,0,0,159,0,0,159,28,275
28,276,0,0,804,0,0,804,28,276
28,277,0,0,619,0,0,619,28,277
28,278,26,0,453,0,0,479,28,278
28,280,38,0,0,0,0,38,28,280
28,281,159,0,124,0,0,283,28,281
28,288,0,0,481,0,0,481,28,288
28,290,0,0,1012,0,0,1012,28,290
28,292,0,0,0,2161,0,2161,28,292
28,300,0,0,1025,0,0,1025,28,300
28,301,236,0,0,0,0,236,28,301
28,302,0,0,222,0,0,222,28,302
28,304,0,0,993,0,0,993,28,304
28,307,0,0,298,0,0,298,28,307
28,311,0,0,806,0,0,806,28,311
28,312,0,0,281,0,0,281,28,312
28,315,0,0,185,0,0,185,28,315
28,316,100,0,46,0,0,146,28,316
28,321,333,0,0,0,0,333,28,321
28,323,0,0,453,0,0,453,28,323
28,327,27,0,0,0,0,27,28,327
28,329,51,0,0,0,0,51,28,329
28,332,38,0,0,0,0,38,28,332
28,334,0,0,536,0,0,536,28,334
28,335,418,0,280,0,0,698,28,335
28,337,0,0,132,0,0,132,28,337
28,339,0,0,204,0,0,204,28,339
28,340,0,0,37,0,0,37,28,340
28,341,264,0,0,0,0,264,28,341
28,342,0,0,439,0,0,439,28,342
29,1,0,0,1093,0,0,1093,29,1
29,2,0,0,78,0,0,78,29,2
29,3,0,0,80,0,0,80,29,3
29,4,105,300,0,0,0,405,29,4
29,5,0,0,265,0,0,265,29,5
29,6,80,0,0,257,0,337,29,6
29,7,80,0,354,0,0,434,29,7
29,9,0,0,26,0,0,26,29,9
29,12,0,0,0,0,88,88,29,12
29,14,37,0,0,0,0,37,29,14
29,15,0,0,111,0,0,111,29,15
29,16,0,0,504,0,0,504,29,16
29,18,124,0,0,0,0,124,29,18
29,19,0,0,145,0,0,145,29,19
29,20,0,0,133,0,0,133,29,20
29,21,83,0,740,241,0,1064,29,21
29,22,0,0,139,0,0,139,29,22
29,23,63,0,263,0,0,326,29,23
29,24,282,0,252,0,0,534,29,24
29,25,357,1087,0,0,0,1444,29,25
29,26,0,323,247,165,0,735,29,26
29,27,80,774,106,0,0,960,29,27
29,28,0,1497,0,0,0,1497,29,28
29,29,15,8571,0,63,0,8649,29,29
29,30,252,64,64,0,0,380,29,30
29,31,173,1404,443,612,0,2632,29,31
29,32,58,2702,15,0,0,2775,29,32
29,33,7,0,21,23,0,51,29,33
29,34,39,0,65,34,0,138,29,34
29,35,45,0,0,0,0,45,29,35
29,36,131,0,143,0,0,274,29,36
29,40,0,0,18,0,0,18,29,40
29,41,0,0,399,0,0,399,29,41
29,43,63,0,262,0,0,325,29,43
29,44,0,0,152,0,0,152,29,44
29,45,0,0,240,0,0,240,29,45
29,49,0,0,88,0,0,88,29,49
29,50,55,0,0,0,0,55,29,50
29,51,0,0,93,0,0,93,29,51
29,52,0,0,185,0,0,185,29,52
29,53,0,0,577,58,0,635,29,53
29,54,0,0,87,14,0,101,29,54
29,55,100,0,312,0,0,412,29,55
29,56,83,0,408,0,0,491,29,56
29,57,539,0,286,0,0,825,29,57
29,58,100,0,100,0,0,200,29,58
29,59,0,0,660,0,0,660,29,59
29,60,240,0,190,0,0,430,29,60
29,61,0,0,412,0,0,412,29,61
29,62,0,0,29,26,0,55,29,62
29,63,23,0,0,11,0,34,29,63
29,64,297,0,0,0,0,297,29,64
29,65,116,0,0,0,0,116,29,65
29,66,143,0,0,0,0,143,29,66
29,67,55,0,0,0,0,55,29,67
29,68,427,0,518,114,0,1059,29,68
29,70,0,0,188,63,0,251,29,70
29,71,255,0,167,0,0,422,29,71
29,72,63,0,0,0,0,63,29,72
29,73,0,0,68,76,0,144,29,73
29,74,350,1170,55,46,0,1621,29,74
29,75,644,124,23,58,0,849,29,75
29,76,105,38,34,70,0,247,29,76
29,77,126,237,239,0,0,602,29,77
29,78,324,187,0,309,0,820,29,78
29,79,454,3424,72,26,75,4051,29,79
29,80,405,0,143,0,0,548,29,80
29,81,198,0,194,63,0,455,29,81
29,82,0,0,56,0,0,56,29,82
29,83,112,0,398,0,0,510,29,83
29,84,152,0,51,51,0,254,29,84
29,85,24,63,24,0,0,111,29,85
29,86,9,0,18,0,0,27,29,86
29,87,0,0,33,57,49,139,29,87
29,88,0,0,260,578,0,838,29,88
29,89,0,0,0,48,0,48,29,89
29,90,0,0,0,502,0,502,29,90
29,92,0,0,63,0,0,63,29,92
29,93,40,40,143,0,0,223,29,93
29,94,0,0,68,0,0,68,29,94
29,96,67,0,27,0,0,94,29,96
29,97,58,0,47,0,0,105,29,97
29,98,0,0,22,0,0,22,29,98
29,99,58,0,0,0,0,58,29,99
29,100,181,0,163,0,0,344,29,100
29,101,0,0,295,0,0,295,29,101
29,104,64,0,52,0,0,116,29,104
29,105,50,0,0,0,0,50,29,105
29,107,198,0,0,0,0,198,29,107
29,108,237,0,0,0,0,237,29,108
29,110,637,0,804,0,0,1441,29,110
29,111,0,0,365,0,0,365,29,111
29,113,0,0,293,0,0,293,29,113
29,123,0,0,594,0,0,594,29,123
29,124,0,0,1981,0,0,1981,29,124
29,126,0,0,362,0,0,362,29,126
29,128,0,0,19,0,0,19,29,128
29,129,0,0,32,0,0,32,29,129
29,133,0,0,325,0,0,325,29,133
29,134,95,0,0,0,0,95,29,134
29,135,0,0,778,0,0,778,29,135
29,138,24,0,0,0,0,24,29,138
29,144,0,0,742,0,0,742,29,144
29,145,0,0,31,0,0,31,29,145
29,147,0,0,75,0,0,75,29,147
29,152,0,0,125,0,0,125,29,152
29,153,0,0,73,0,0,73,29,153
29,156,0,0,292,0,0,292,29,156
29,160,0,0,910,0,0,910,29,160
29,166,201,0,0,0,0,201,29,166
29,182,0,0,473,0,0,473,29,182
29,187,0,0,222,0,0,222,29,187
29,188,0,0,175,0,0,175,29,188
29,192,0,0,315,0,0,315,29,192
29,195,0,0,214,60,0,274,29,195
29,197,0,0,146,0,0,146,29,197
29,198,0,0,246,0,0,246,29,198
29,200,0,0,149,0,0,149,29,200
29,201,0,0,372,0,0,372,29,201
29,205,384,0,0,0,0,384,29,205
29,208,268,0,0,0,0,268,29,208
29,210,97,0,326,0,0,423,29,210
29,216,0,0,336,0,0,336,29,216
29,217,0,0,467,0,0,467,29,217
29,218,0,0,390,0,0,390,29,218
29,222,0,0,223,0,0,223,29,222
29,223,0,0,391,0,0,391,29,223
29,226,0,0,521,0,0,521,29,226
29,227,618,0,501,0,0,1119,29,227
29,234,0,0,264,0,0,264,29,234
29,236,0,0,633,0,0,633,29,236
29,237,15,0,72,0,0,87,29,237
29,238,80,0,0,0,0,80,29,238
29,239,0,0,148,0,0,148,29,239
29,240,0,0,100,0,0,100,29,240
29,245,0,0,127,0,0,127,29,245
29,246,0,0,0,113,0,113,29,246
29,247,0,0,1677,0,0,1677,29,247
29,250,11,0,0,0,0,11,29,250
29,253,22,0,23,0,0,45,29,253
29,255,0,0,1355,0,0,1355,29,255
29,256,0,0,261,0,0,261,29,256
29,257,433,0,0,0,0,433,29,257
29,260,0,0,683,0,0,683,29,260
29,266,0,0,114,0,0,114,29,266
29,268,73,0,0,36,0,109,29,268
29,269,120,0,139,119,0,378,29,269
29,270,0,0,59,0,0,59,29,270
29,273,0,0,87,287,0,374,29,273
29,274,0,0,356,0,0,356,29,274
29,277,0,0,642,0,0,642,29,277
29,278,0,0,694,0,0,694,29,278
29,280,23,0,0,0,0,23,29,280
29,281,159,0,0,0,0,159,29,281
29,283,0,0,32,0,0,32,29,283
29,285,490,0,0,0,0,490,29,285
29,288,0,0,347,0,0,347,29,288
29,300,828,0,68,0,148,1044,29,300
29,302,0,0,569,0,0,569,29,302
29,303,0,0,55,0,0,55,29,303
29,304,0,0,1106,0,0,1106,29,304
29,306,0,0,879,0,0,879,29,306
29,311,0,0,806,0,0,806,29,311
29,312,0,0,281,0,0,281,29,312
29,313,0,0,108,0,0,108,29,313
29,314,0,0,279,0,0,279,29,314
29,315,0,0,277,0,0,277,29,315
29,316,188,0,0,0,0,188,29,316
29,317,7,0,15,22,0,44,29,317
29,318,0,0,635,0,0,635,29,318
29,319,68,0,0,35,0,103,29,319
29,320,0,0,1005,0,0,1005,29,320
29,321,238,0,189,0,0,427,29,321
29,322,77,0,0,0,0,77,29,322
29,325,0,0,248,0,0,248,29,325
29,326,0,0,0,422,0,422,29,326
29,327,49,0,182,0,0,231,29,327
29,329,51,0,55,0,0,106,29,329
29,330,102,0,25,0,0,127,29,330
29,331,0,0,210,0,0,210,29,331
29,332,646,0,0,0,0,646,29,332
29,336,0,0,354,0,0,354,29,336
29,337,0,0,257,0,0,257,29,337
29,339,63,0,502,0,0,565,29,339
29,340,0,0,50,0,0,50,29,340
29,342,0,0,129,0,0,129,29,342
30,1,193,43,341,55,0,632,30,1
30,2,64,58,0,103,0,225,30,2
30,3,405,0,0,0,0,405,30,3
30,4,187,58,0,129,660,1034,30,4
30,5,0,346,192,301,0,839,30,5
30,6,0,111,0,0,187,298,30,6
30,8,64,11,0,84,0,159,30,8
30,9,0,0,51,0,0,51,30,9
30,14,0,0,37,0,0,37,30,14
30,20,0,0,276,0,0,276,30,20
30,22,87,0,96,0,0,183,30,22
30,24,0,0,70,47,0,117,30,24
30,27,285,0,0,166,0,451,30,27
30,28,0,0,111,102,0,213,30,28
30,29,127,64,64,47,0,302,30,29
30,30,398,7559,0,0,136,8093,30,30
30,31,655,3496,0,80,0,4231,30,31
30,32,228,956,140,127,0,1451,30,32
30,33,46,147,8,283,0,484,30,33
30,34,1013,1851,0,99,0,2963,30,34
30,35,64,3138,0,0,0,3202,30,35
30,36,1125,1771,70,146,0,3112,30,36
30,37,219,0,0,0,0,219,30,37
30,38,0,64,70,0,0,134,30,38
30,43,47,0,0,0,0,47,30,43
30,46,629,0,0,0,0,629,30,46
30,51,0,0,94,0,0,94,30,51
30,54,0,0,44,26,0,70,30,54
30,55,117,0,0,72,0,189,30,55
30,56,272,0,0,0,0,272,30,56
30,57,181,0,119,64,0,364,30,57
30,58,0,0,100,0,0,100,30,58
30,59,0,0,58,0,0,58,30,59
30,62,91,0,27,0,0,118,30,62
30,63,483,0,0,0,0,483,30,63
30,64,274,0,201,64,0,539,30,64
30,65,39,0,126,0,0,165,30,65
30,66,129,0,0,0,0,129,30,66
30,67,43,0,0,0,0,43,30,67
30,68,129,0,346,254,0,729,30,68
30,69,64,80,64,0,0,208,30,69
30,70,0,0,0,71,0,71,30,70
30,71,0,0,349,0,0,349,30,71
30,72,0,0,70,0,93,163,30,72
30,73,305,0,775,64,0,1144,30,73
30,74,0,44,192,0,0,236,30,74
30,75,290,0,0,0,0,290,30,75
30,76,296,0,0,0,0,296,30,76
30,77,64,0,51,509,0,624,30,77
30,78,904,0,95,102,0,1101,30,78
30,79,64,0,58,146,0,268,30,79
30,80,0,0,58,44,0,102,30,80
30,81,120,0,0,0,0,120,30,81
30,82,402,0,164,64,0,630,30,82
30,83,510,0,64,0,0,574,30,83
30,84,126,0,55,0,0,181,30,84
30,85,138,0,19,0,0,157,30,85
30,86,9,18,70,20,0,117,30,86
30,87,33,0,184,0,0,217,30,87
30,88,539,0,389,358,0,1286,30,88
30,89,0,0,119,0,0,119,30,89
30,90,0,0,0,199,0,199,30,90
30,92,26,0,0,5,0,31,30,92
30,93,64,0,99,0,0,163,30,93
30,94,13,0,47,0,0,60,30,94
30,95,0,0,281,0,0,281,30,95
30,96,58,0,55,0,0,113,30,96
30,98,0,0,0,53,0,53,30,98
30,100,0,0,70,0,0,70,30,100
30,101,0,0,357,328,0,685,30,101
30,102,0,0,61,0,0,61,30,102
30,103,6,0,0,0,0,6,30,103
30,105,0,0,70,0,0,70,30,105
30,107,198,0,0,0,0,198,30,107
30,115,0,0,329,0,0,329,30,115
30,116,0,0,576,0,0,576,30,116
30,124,0,0,552,0,0,552,30,124
30,126,0,0,599,0,0,599,30,126
30,131,0,0,64,0,0,64,30,131
30,134,0,0,211,0,0,211,30,134
30,136,162,0,95,38,0,295,30,136
30,137,0,0,363,0,0,363,30,137
30,138,0,0,0,58,0,58,30,138
30,139,0,0,0,0,381,381,30,139
30,141,64,0,0,0,0,64,30,141
30,147,119,0,0,0,0,119,30,147
30,161,0,0,296,0,0,296,30,161
30,162,183,0,0,0,0,183,30,162
30,165,0,0,129,47,0,176,30,165
30,166,64,0,0,0,0,64,30,166
30,167,0,0,47,0,0,47,30,167
30,169,0,0,35,0,0,35,30,169
30,175,0,0,236,0,0,236,30,175
30,177,0,0,91,0,0,91,30,177
30,185,234,0,0,0,0,234,30,185
30,201,0,0,489,0,0,489,30,201
30,211,623,0,0,0,0,623,30,211
30,218,0,0,245,0,0,245,30,218
30,230,0,0,306,0,0,306,30,230
30,239,47,0,0,0,0,47,30,239
30,240,0,0,55,0,0,55,30,240
30,254,109,0,0,0,0,109,30,254
30,255,47,0,0,0,0,47,30,255
30,260,0,0,444,0,0,444,30,260
30,270,64,0,0,0,0,64,30,270
30,271,64,0,0,0,0,64,30,271
30,272,0,0,55,0,0,55,30,272
30,274,0,0,105,0,0,105,30,274
30,275,0,0,47,0,0,47,30,275
30,280,0,0,47,0,0,47,30,280
30,281,39,0,130,0,0,169,30,281
30,288,0,0,82,0,0,82,30,288
30,290,0,0,629,0,0,629,30,290
30,298,0,0,308,0,0,308,30,298
30,302,64,0,64,0,0,128,30,302
30,303,64,0,0,0,0,64,30,303
30,311,740,0,509,0,0,1249,30,311
30,317,72,0,0,0,0,72,30,317
30,319,17,0,31,0,0,48,30,319
30,322,452,0,0,0,0,452,30,322
30,327,38,0,0,0,0,38,30,327
30,331,0,0,211,0,0,211,30,331
30,333,64,0,0,186,0,250,30,333
30,335,64,0,0,0,0,64,30,335
30,338,0,0,0,109,0,109,30,338
30,339,94,0,246,0,0,340,30,339
30,340,136,0,58,0,0,194,30,340
31,1,0,0,966,0,0,966,31,1
31,2,128,0,716,49,0,893,31,2
31,3,87,0,184,0,0,271,31,3
31,4,993,3014,1104,0,0,5111,31,4
31,5,591,1274,140,0,0,2005,31,5
31,6,0,143,65,351,0,559,31,6
31,7,0,0,221,0,0,221,31,7
31,8,0,0,280,348,0,628,31,8
31,9,0,0,26,0,0,26,31,9
31,10,0,0,21,0,0,21,31,10
31,11,0,0,0,19,0,19,31,11
31,14,30,0,0,15,0,45,31,14
31,16,0,0,194,0,0,194,31,16
31,17,0,0,24,0,0,24,31,17
31,18,198,0,0,0,0,198,31,18
31,19,0,0,170,0,0,170,31,19
31,20,76,0,174,0,0,250,31,20
31,21,78,0,329,0,0,407,31,21
31,22,0,0,96,0,0,96,31,22
31,23,200,0,94,0,0,294,31,23
31,24,30,0,0,88,0,118,31,24
31,25,564,2493,0,543,0,3600,31,25
31,26,128,0,0,0,0,128,31,26
31,27,323,0,574,21,0,918,31,27
31,28,128,221,93,0,0,442,31,28
31,29,173,1985,797,267,0,3222,31,29
31,30,784,3384,0,107,0,4275,31,30
31,31,181,13678,0,289,0,14148,31,31
31,32,409,695,902,22,0,2028,31,32
31,33,15,0,24,0,22,61,31,33
31,34,147,479,32,206,0,864,31,34
31,35,831,125,0,0,0,956,31,35
31,36,1042,978,134,428,0,2582,31,36
31,37,366,0,125,0,0,491,31,37
31,40,87,0,9,0,0,96,31,40
31,41,1036,0,142,170,0,1348,31,41
31,43,63,0,361,0,0,424,31,43
31,44,0,0,81,0,0,81,31,44
31,46,0,0,404,0,0,404,31,46
31,48,0,0,149,0,0,149,31,48
31,49,158,0,206,0,0,364,31,49
31,50,0,0,62,0,0,62,31,50
31,51,197,0,0,0,0,197,31,51
31,52,0,0,174,0,0,174,31,52
31,53,128,0,88,0,0,216,31,53
31,54,0,0,14,0,0,14,31,54
31,55,381,0,268,0,0,649,31,55
31,56,0,0,1083,0,0,1083,31,56
31,57,564,0,98,0,0,662,31,57
31,58,0,0,100,0,0,100,31,58
31,59,0,0,972,0,0,972,31,59
31,60,0,0,284,0,0,284,31,60
31,61,0,0,415,0,0,415,31,61
31,63,23,0,32,0,0,55,31,63
31,64,654,0,294,128,0,1076,31,64
31,65,0,0,241,116,0,357,31,65
31,66,0,0,416,0,0,416,31,66
31,67,80,0,140,0,0,220,31,67
31,68,250,0,1250,150,0,1650,31,68
31,69,0,0,0,0,186,186,31,69
31,70,84,0,0,0,0,84,31,70
31,71,0,0,153,153,0,306,31,71
31,72,0,0,120,0,0,120,31,72
31,73,98,0,410,0,0,508,31,73
31,74,39,55,885,30,0,1009,31,74
31,75,71,0,250,98,0,419,31,75
31,76,348,0,106,0,0,454,31,76
31,77,0,0,319,0,0,319,31,77
31,78,137,183,129,102,0,551,31,78
31,79,86,311,1341,101,0,1839,31,79
31,80,0,0,567,0,0,567,31,80
31,81,0,0,424,214,0,638,31,81
31,82,27,0,337,49,0,413,31,82
31,83,530,0,418,172,0,1120,31,83
31,84,51,0,51,102,0,204,31,84
31,85,52,0,67,0,0,119,31,85
31,86,0,0,19,66,0,85,31,86
31,87,160,0,24,0,0,184,31,87
31,88,515,0,0,0,0,515,31,88
31,89,0,0,109,0,0,109,31,89
31,90,62,0,79,0,0,141,31,90
31,92,0,0,70,0,0,70,31,92
31,93,4,0,369,301,0,674,31,93
31,94,0,0,99,0,0,99,31,94
31,95,102,0,302,0,0,404,31,95
31,96,30,0,0,0,0,30,31,96
31,97,35,0,0,0,0,35,31,97
31,98,0,0,365,0,0,365,31,98
31,100,0,0,478,229,0,707,31,100
31,102,518,0,220,0,0,738,31,102
31,104,21,0,118,0,0,139,31,104
31,105,0,0,23,0,0,23,31,105
31,106,0,0,28,0,0,28,31,106
31,107,302,0,362,0,0,664,31,107
31,109,0,0,2603,0,0,2603,31,109
31,110,0,0,274,0,0,274,31,110
31,111,245,0,0,0,0,245,31,111
31,115,0,0,260,0,0,260,31,115
31,116,0,0,779,0,0,779,31,116
31,122,0,0,519,0,0,519,31,122
31,124,60,0,0,0,0,60,31,124
31,126,0,0,204,0,0,204,31,126
31,129,0,0,85,0,0,85,31,129
31,130,0,0,59,0,0,59,31,130
31,133,0,0,176,0,0,176,31,133
31,134,0,0,380,612,0,992,31,134
31,135,75,0,0,0,0,75,31,135
31,136,0,0,206,0,0,206,31,136
31,139,0,0,606,0,0,606,31,139
31,142,0,0,323,0,0,323,31,142
31,144,374,0,0,0,0,374,31,144
31,145,0,0,25,0,0,25,31,145
31,147,0,0,169,0,0,169,31,147
31,150,0,0,324,0,0,324,31,150
31,151,49,0,0,0,0,49,31,151
31,152,0,0,346,0,0,346,31,152
31,153,348,0,0,0,0,348,31,153
31,154,0,0,498,0,0,498,31,154
31,155,0,0,122,290,0,412,31,155
31,156,73,0,0,0,0,73,31,156
31,158,0,0,1036,0,0,1036,31,158
31,159,0,0,1487,0,0,1487,31,159
31,160,0,0,1081,0,0,1081,31,160
31,165,32,0,0,0,0,32,31,165
31,167,0,0,158,0,0,158,31,167
31,168,128,0,479,0,0,607,31,168
31,170,0,0,295,0,0,295,31,170
31,173,0,0,215,0,0,215,31,173
31,180,0,0,1018,0,0,1018,31,180
31,185,0,0,351,0,0,351,31,185
31,193,0,0,151,0,0,151,31,193
31,198,0,0,246,0,0,246,31,198
31,200,0,0,218,0,0,218,31,200
31,201,78,0,372,0,0,450,31,201
31,203,0,0,249,0,0,249,31,203
31,204,0,0,758,0,0,758,31,204
31,208,0,0,348,0,0,348,31,208
31,214,0,0,124,0,0,124,31,214
31,216,0,0,439,0,0,439,31,216
31,218,0,0,747,0,0,747,31,218
31,229,0,0,365,0,0,365,31,229
31,231,0,0,303,0,0,303,31,231
31,236,41,0,47,0,0,88,31,236
31,238,78,0,293,0,0,371,31,238
31,240,0,0,100,0,0,100,31,240
31,243,282,0,0,0,0,282,31,243
31,245,0,0,594,0,0,594,31,245
31,247,0,0,725,0,0,725,31,247
31,249,0,0,332,0,0,332,31,249
31,250,288,0,0,0,0,288,31,250
31,251,200,0,0,0,0,200,31,251
31,254,0,0,712,0,0,712,31,254
31,262,0,0,30,0,0,30,31,262
31,264,0,0,1131,0,0,1131,31,264
31,265,0,0,828,0,0,828,31,265
31,267,0,0,275,0,0,275,31,267
31,268,79,0,43,43,0,165,31,268
31,269,236,0,0,0,0,236,31,269
31,270,484,0,0,0,0,484,31,270
31,271,30,0,0,64,0,94,31,271
31,274,196,0,0,0,0,196,31,274
31,276,0,0,699,0,0,699,31,276
31,277,0,0,860,0,0,860,31,277
31,280,106,0,122,0,0,228,31,280
31,281,0,0,631,0,0,631,31,281
31,285,0,0,1395,0,0,1395,31,285
31,290,0,0,302,0,0,302,31,290
31,300,154,0,128,0,0,282,31,300
31,301,0,0,86,0,0,86,31,301
31,303,86,0,29,0,0,115,31,303
31,311,0,0,0,438,0,438,31,311
31,314,0,0,724,0,0,724,31,314
31,316,235,0,283,0,0,518,31,316
31,317,15,0,28,0,0,43,31,317
31,318,0,0,124,0,0,124,31,318
31,319,79,0,114,12,0,205,31,319
31,321,304,0,0,0,0,304,31,321
31,327,27,0,38,0,0,65,31,327
31,329,0,0,457,0,0,457,31,329
31,332,0,0,669,0,0,669,31,332
31,335,0,0,66,0,0,66,31,335
31,336,0,0,324,0,0,324,31,336
31,339,0,0,437,0,0,437,31,339
31,340,30,0,748,0,0,778,31,340
31,341,0,0,40,0,0,40,31,341
32,1,21,55,49,0,0,125,32,1
32,3,0,0,466,0,0,466,32,3
32,4,43,498,357,0,0,898,32,4
32,5,0,172,753,0,0,925,32,5
32,6,0,0,488,0,0,488,32,6
32,7,0,0,234,0,0,234,32,7
32,10,0,0,18,0,0,18,32,10
32,12,0,0,100,0,0,100,32,12
32,14,0,0,32,0,0,32,32,14
32,15,157,0,0,0,0,157,32,15
32,17,21,0,20,0,0,41,32,17
32,18,0,192,101,0,0,293,32,18
32,19,0,0,339,0,0,339,32,19
32,20,76,0,0,0,0,76,32,20
32,21,110,0,599,0,0,709,32,21
32,22,0,0,668,0,0,668,32,22
32,23,0,0,63,0,0,63,32,23
32,24,120,0,79,39,0,238,32,24
32,25,0,21,98,0,0,119,32,25
32,26,21,93,0,0,0,114,32,26
32,27,186,301,146,79,0,712,32,27
32,28,64,474,60,96,0,694,32,28
32,29,101,2400,25,11,49,2586,32,29
32,30,64,956,140,127,0,1287,32,30
32,31,229,1188,607,43,0,2067,32,31
32,32,231,16139,0,0,0,16370,32,32
32,33,46,705,0,0,0,751,32,33
32,34,183,248,120,77,0,628,32,34
32,35,0,0,516,0,0,516,32,35
32,36,255,22,624,0,0,901,32,36
32,42,0,0,81,0,0,81,32,42
32,43,180,0,715,0,0,895,32,43
32,44,43,0,127,0,0,170,32,44
32,47,0,0,290,0,0,290,32,47
32,49,0,0,48,0,0,48,32,49
32,50,21,0,0,0,0,21,32,50
32,52,0,0,387,0,0,387,32,52
32,53,339,0,21,0,0,360,32,53
32,55,240,0,164,0,0,404,32,55
32,56,0,0,348,0,0,348,32,56
32,57,0,213,137,0,0,350,32,57
32,59,0,0,647,0,0,647,32,59
32,60,0,0,21,327,0,348,32,60
32,61,0,0,342,21,0,363,32,61
32,62,308,77,0,26,0,411,32,62
32,63,23,0,47,0,0,70,32,63
32,64,60,0,0,0,0,60,32,64
32,65,785,0,0,0,0,785,32,65
32,66,58,0,0,0,0,58,32,66
32,67,0,0,91,0,0,91,32,67
32,68,143,0,253,160,0,556,32,68
32,69,210,0,250,0,0,460,32,69
32,70,84,0,331,0,21,436,32,70
32,72,0,0,60,0,0,60,32,72
32,73,21,0,66,0,0,87,32,73
32,74,35,983,58,87,0,1163,32,74
32,75,168,56,96,187,0,507,32,75
32,76,36,0,680,0,21,737,32,76
32,77,58,376,576,80,0,1090,32,77
32,78,262,879,289,160,0,1590,32,78
32,79,287,5370,145,0,0,5802,32,79
32,80,180,0,180,0,0,360,32,80
32,81,218,0,206,0,0,424,32,81
32,82,21,0,122,21,0,164,32,82
32,83,167,69,1827,49,0,2112,32,83
32,84,344,0,101,230,0,675,32,84
32,85,118,21,139,122,0,400,32,85
32,86,163,0,39,36,0,238,32,86
32,87,131,0,633,0,0,764,32,87
32,88,737,0,463,0,0,1200,32,88
32,89,0,0,48,168,0,216,32,89
32,90,0,0,79,0,0,79,32,90
32,91,10,0,0,0,0,10,32,91
32,92,93,0,4,0,0,97,32,92
32,93,0,0,75,27,0,102,32,93
32,94,332,0,223,0,0,555,32,94
32,95,0,0,204,0,0,204,32,95
32,96,0,0,89,0,0,89,32,96
32,97,304,0,35,0,0,339,32,97
32,100,35,0,503,0,0,538,32,100
32,104,21,0,0,0,0,21,32,104
32,106,43,0,56,0,0,99,32,106
32,107,99,0,108,0,0,207,32,107
32,108,0,0,25,0,0,25,32,108
32,109,0,0,1962,0,0,1962,32,109
32,110,21,0,301,0,0,322,32,110
32,111,0,0,463,0,0,463,32,111
32,113,15,0,90,0,0,105,32,113
32,116,0,0,363,0,0,363,32,116
32,118,0,0,87,0,0,87,32,118
32,119,0,0,1281,0,0,1281,32,119
32,124,507,0,552,0,0,1059,32,124
32,125,528,0,0,0,0,528,32,125
32,127,320,0,101,0,0,421,32,127
32,128,10,0,0,0,31,41,32,128
32,129,0,0,98,0,0,98,32,129
32,131,0,0,162,0,0,162,32,131
32,132,21,0,0,0,0,21,32,132
32,133,0,0,725,0,0,725,32,133
32,134,0,0,233,0,0,233,32,134
32,137,0,0,673,0,0,673,32,137
32,138,24,0,0,0,0,24,32,138
32,140,0,0,799,0,0,799,32,140
32,144,212,0,0,0,0,212,32,144
32,145,0,0,25,0,0,25,32,145
32,148,0,0,95,0,0,95,32,148
32,152,0,0,549,0,0,549,32,152
32,153,73,0,303,0,0,376,32,153
32,156,0,0,543,0,0,543,32,156
32,158,0,0,1058,0,0,1058,32,158
32,163,0,0,336,0,0,336,32,163
32,165,0,0,247,0,0,247,32,165
32,166,0,0,294,0,0,294,32,166
32,168,0,0,239,0,0,239,32,168
32,169,21,0,0,0,0,21,32,169
32,173,0,0,487,0,0,487,32,173
32,177,0,0,46,0,0,46,32,177
32,178,0,0,21,0,0,21,32,178
32,180,0,0,458,0,0,458,32,180
32,181,105,0,0,0,0,105,32,181
32,185,0,0,671,0,0,671,32,185
32,190,105,0,0,0,0,105,32,190
32,194,121,0,394,0,0,515,32,194
32,195,0,0,367,0,0,367,32,195
32,198,0,0,144,0,0,144,32,198
32,200,0,0,109,0,0,109,32,200
32,201,0,0,191,0,0,191,32,201
32,202,0,0,47,0,0,47,32,202
32,203,0,0,307,0,0,307,32,203
32,210,0,0,782,0,0,782,32,210
32,212,0,0,403,0,0,403,32,212
32,219,0,0,269,0,0,269,32,219
32,221,0,0,263,0,0,263,32,221
32,222,0,0,202,0,0,202,32,222
32,226,0,0,521,0,0,521,32,226
32,228,21,0,0,0,0,21,32,228
32,229,0,0,1388,0,0,1388,32,229
32,231,93,0,199,0,0,292,32,231
32,236,129,0,207,0,0,336,32,236
32,237,47,0,83,0,0,130,32,237
32,238,0,0,381,0,0,381,32,238
32,239,0,0,374,0,0,374,32,239
32,240,0,93,15,0,0,108,32,240
32,243,635,0,0,0,0,635,32,243
32,245,0,0,310,0,0,310,32,245
32,250,0,0,0,123,0,123,32,250
32,254,0,0,582,0,0,582,32,254
32,256,0,0,295,0,0,295,32,256
32,262,0,0,841,0,0,841,32,262
32,267,0,0,153,0,0,153,32,267
32,268,125,0,0,0,0,125,32,268
32,269,0,0,38,0,0,38,32,269
32,270,0,0,64,0,0,64,32,270
32,274,0,0,21,0,0,21,32,274
32,275,21,0,0,0,0,21,32,275
32,281,159,0,0,0,0,159,32,281
32,283,0,0,0,70,0,70,32,283
32,286,0,0,147,50,0,197,32,286
32,290,0,0,231,0,0,231,32,290
32,291,0,0,248,0,0,248,32,291
32,294,0,0,663,0,0,663,32,294
32,298,0,0,371,0,0,371,32,298
32,300,124,0,15,0,0,139,32,300
32,301,0,0,21,0,0,21,32,301
32,302,0,0,170,0,0,170,32,302
32,304,0,0,606,0,0,606,32,304
32,305,0,0,790,0,0,790,32,305
32,307,0,0,649,0,0,649,32,307
32,313,0,0,250,0,0,250,32,313
32,315,0,0,678,0,0,678,32,315
32,316,87,0,93,0,165,345,32,316
32,317,28,0,0,0,0,28,32,317
32,318,0,0,205,0,0,205,32,318
32,319,33,0,17,0,0,50,32,319
32,321,485,0,0,0,0,485,32,321
32,323,0,0,539,0,0,539,32,323
32,324,0,0,1373,0,0,1373,32,324
32,325,0,0,395,0,0,395,32,325
32,326,0,0,78,0,0,78,32,326
32,327,55,0,0,0,0,55,32,327
32,329,86,0,0,50,0,136,32,329
32,330,317,0,267,0,0,584,32,330
32,331,0,0,503,0,0,503,32,331
32,332,0,0,405,0,0,405,32,332
32,333,0,0,282,0,0,282,32,333
32,338,0,0,218,0,0,218,32,338
32,339,15,0,134,0,0,149,32,339
32,340,218,0,121,0,0,339,32,340
32,341,0,0,230,0,0,230,32,341
32,342,0,0,322,0,0,322,32,342
33,2,15,0,15,0,0,30,33,2
33,3,31,0,0,0,0,31,33,3
33,4,0,0,8,0,0,8,33,4
33,5,7,0,0,15,0,22,33,5
33,23,0,0,56,0,0,56,33,23
33,24,0,0,0,6,0,6,33,24
33,27,38,0,0,0,0,38,33,27
33,28,0,0,8,0,0,8,33,28
33,29,15,0,21,38,0,74,33,29
33,30,31,62,25,219,0,337,33,30
33,31,15,6,24,0,0,45,33,31
33,32,46,689,0,15,31,781,33,32
33,33,32,98,0,0,0,130,33,33
33,34,0,22,0,53,0,75,33,34
33,35,0,0,0,129,0,129,33,35
33,37,18,0,15,0,0,33,33,37
33,43,0,0,22,0,0,22,33,43
33,49,0,0,27,0,0,27,33,49
33,50,15,0,0,0,0,15,33,50
33,55,22,0,0,0,0,22,33,55
33,56,0,0,0,6,0,6,33,56
33,57,0,0,15,0,0,15,33,57
33,58,15,0,0,0,0,15,33,58
33,61,15,0,0,0,0,15,33,61
33,65,37,0,0,0,0,37,33,65
33,68,14,0,6,0,0,20,33,68
33,72,89,0,0,0,0,89,33,72
33,73,45,0,0,0,0,45,33,73
33,74,7,0,0,0,0,7,33,74
33,76,38,0,0,0,0,38,33,76
33,77,13,15,42,57,0,127,33,77
33,79,45,202,25,16,0,288,33,79
33,80,15,6,48,0,0,69,33,80
33,81,31,0,0,0,0,31,33,81
33,82,15,0,15,6,0,36,33,82
33,83,77,0,0,0,0,77,33,83
33,84,31,51,72,7,0,161,33,84
33,85,70,112,0,0,0,182,33,85
33,86,0,47,44,0,0,91,33,86
33,87,0,0,0,132,0,132,33,87
33,88,112,0,0,0,0,112,33,88
33,91,0,0,24,0,0,24,33,91
33,93,58,0,8,0,0,66,33,93
33,94,7,0,0,0,0,7,33,94
33,95,16,0,0,15,0,31,33,95
33,96,37,0,0,0,0,37,33,96
33,100,0,0,8,0,0,8,33,100
33,102,35,128,0,0,0,163,33,102
33,111,0,0,0,32,0,32,33,111
33,125,0,0,457,0,0,457,33,125
33,133,15,0,0,0,0,15,33,133
33,166,15,0,0,0,0,15,33,166
33,173,0,0,272,0,0,272,33,173
33,178,15,0,0,0,0,15,33,178
33,188,0,0,181,0,0,181,33,188
33,193,0,0,72,0,0,72,33,193
33,215,0,0,22,0,0,22,33,215
33,268,0,0,0,132,0,132,33,268
33,294,0,0,0,542,0,542,33,294
33,300,15,0,0,0,0,15,33,300
33,306,0,0,808,0,0,808,33,306
33,321,15,0,0,0,0,15,33,321
33,339,53,0,12,0,22,87,33,339
34,1,23,0,166,0,0,189,34,1
34,2,0,0,39,39,0,78,34,2
34,3,39,0,0,0,0,39,34,3
34,4,0,77,42,0,43,162,34,4
34,5,373,0,39,39,0,451,34,5
34,6,0,0,67,0,0,67,34,6
34,7,0,0,0,62,0,62,34,7
34,9,0,0,134,0,0,134,34,9
34,17,23,0,0,0,0,23,34,17
34,18,23,0,0,0,0,23,34,18
34,21,119,0,0,0,0,119,34,21
34,24,0,0,63,39,0,102,34,24
34,26,30,0,0,39,0,69,34,26
34,27,60,0,30,0,0,90,34,27
34,28,23,0,0,0,0,23,34,28
34,29,39,0,32,47,0,118,34,29
34,30,413,1579,0,179,0,2171,34,30
34,31,217,410,32,206,0,865,34,31
34,32,139,841,120,107,0,1207,34,32
34,33,0,22,0,53,0,75,34,33
34,34,226,2993,0,39,0,3258,34,34
34,35,221,297,0,0,0,518,34,35
34,36,1411,631,0,23,0,2065,34,36
34,37,92,0,0,39,0,131,34,37
34,38,35,0,32,0,0,67,34,38
34,43,23,0,0,0,0,23,34,43
34,45,0,0,156,0,0,156,34,45
34,46,39,0,0,0,0,39,34,46
34,48,121,0,0,0,0,121,34,48
34,52,0,0,42,0,0,42,34,52
34,54,0,0,59,50,0,109,34,54
34,56,86,0,61,0,0,147,34,56
34,57,0,0,0,77,0,77,34,57
34,61,0,0,30,0,0,30,34,61
34,62,0,0,32,0,56,88,34,62
34,63,0,0,0,11,0,11,34,63
34,64,240,0,42,0,0,282,34,64
34,66,23,0,0,0,0,23,34,66
34,68,39,0,72,30,0,141,34,68
34,69,39,0,38,0,0,77,34,69
34,70,0,0,0,17,0,17,34,70
34,72,39,0,0,0,0,39,34,72
34,73,156,0,32,0,0,188,34,73
34,74,175,0,0,0,0,175,34,74
34,75,95,0,0,0,0,95,34,75
34,76,39,0,42,0,0,81,34,76
34,77,0,0,135,0,0,135,34,77
34,78,174,0,61,0,0,235,34,78
34,79,181,0,0,0,0,181,34,79
34,80,178,0,178,0,0,356,34,80
34,81,146,0,351,47,0,544,34,81
34,82,47,0,100,53,0,200,34,82
34,83,227,0,64,77,0,368,34,83
34,84,464,149,32,191,0,836,34,84
34,85,390,73,0,88,0,551,34,85
34,86,136,0,0,0,0,136,34,86
34,87,61,0,92,0,0,153,34,87
34,88,277,0,0,0,0,277,34,88
34,89,224,0,79,0,0,303,34,89
34,90,123,0,0,67,0,190,34,90
34,93,117,23,0,39,0,179,34,93
34,95,112,0,0,39,0,151,34,95
34,96,133,0,0,0,0,133,34,96
34,97,98,0,0,35,0,133,34,97
34,99,58,0,0,0,0,58,34,99
34,100,39,0,25,0,56,120,34,100
34,102,0,0,42,0,0,42,34,102
34,103,0,0,11,0,0,11,34,103
34,105,39,0,0,0,0,39,34,105
34,106,0,0,18,0,0,18,34,106
34,107,118,0,128,0,0,246,34,107
34,112,0,0,312,0,0,312,34,112
34,116,0,0,348,0,0,348,34,116
34,134,39,0,0,0,0,39,34,134
34,136,39,0,0,0,0,39,34,136
34,140,0,0,426,0,0,426,34,140
34,150,460,0,0,0,0,460,34,150
34,151,0,0,277,0,0,277,34,151
34,161,39,0,0,0,0,39,34,161
34,163,2876,0,0,0,0,2876,34,163
34,165,0,0,0,39,0,39,34,165
34,167,716,0,30,0,0,746,34,167
34,170,0,0,39,0,0,39,34,170
34,182,403,0,0,0,0,403,34,182
34,195,0,0,317,0,0,317,34,195
34,225,0,0,268,0,0,268,34,225
34,234,0,0,264,0,0,264,34,234
34,251,39,0,0,39,0,78,34,251
34,257,0,0,255,0,0,255,34,257
34,268,0,0,43,0,0,43,34,268
34,269,59,0,0,0,0,59,34,269
34,272,136,0,0,0,0,136,34,272
34,281,655,0,0,0,0,655,34,281
34,300,167,0,30,39,0,236,34,300
34,301,0,0,39,0,0,39,34,301
34,302,0,0,89,0,0,89,34,302
34,309,0,0,153,0,0,153,34,309
34,315,0,0,185,0,0,185,34,315
34,317,39,0,0,29,0,68,34,317
34,321,457,0,0,0,0,457,34,321
34,330,39,0,42,0,0,81,34,330
34,339,129,0,0,0,0,129,34,339
35,1,0,0,1824,0,0,1824,35,1
35,2,0,0,0,40,0,40,35,2
35,4,612,744,1565,0,0,2921,35,4
35,5,0,2874,2060,0,234,5168,35,5
35,6,0,5280,592,0,0,5872,35,6
35,7,47,1355,0,0,0,1402,35,7
35,8,587,2276,154,0,0,3017,35,8
35,9,0,71,43,0,0,114,35,9
35,10,0,11,0,0,0,11,35,10
35,14,0,0,29,0,0,29,35,14
35,16,291,129,2057,0,0,2477,35,16
35,18,0,254,0,852,0,1106,35,18
35,21,0,0,210,0,160,370,35,21
35,22,0,0,268,0,0,268,35,22
35,23,0,0,442,0,0,442,35,23
35,24,0,0,181,0,0,181,35,24
35,26,227,0,0,0,0,227,35,26
35,27,60,0,899,0,0,959,35,27
35,28,310,0,91,0,0,401,35,28
35,30,64,3172,0,0,0,3236,35,30
35,31,691,527,0,0,0,1218,35,31
35,32,0,0,516,0,0,516,35,32
35,34,221,78,0,0,0,299,35,34
35,35,42,21131,0,527,0,21700,35,35
35,36,2613,5305,1857,801,0,10576,35,36
35,37,0,0,173,0,0,173,35,37
35,40,18,0,18,18,0,54,35,40
35,43,0,0,21,0,0,21,35,43
35,44,0,0,665,0,0,665,35,44
35,49,0,0,478,0,0,478,35,49
35,50,0,0,157,0,0,157,35,50
35,54,0,0,527,0,0,527,35,54
35,57,120,0,75,0,0,195,35,57
35,61,0,0,0,23,0,23,35,61
35,62,3204,0,292,0,0,3496,35,62
35,63,0,0,376,0,0,376,35,63
35,65,231,0,116,0,0,347,35,65
35,67,0,0,268,0,0,268,35,67
35,68,162,0,0,0,0,162,35,68
35,69,73,0,87,0,0,160,35,69
35,71,0,0,473,0,0,473,35,71
35,73,268,0,818,0,0,1086,35,73
35,76,28,0,0,0,0,28,35,76
35,77,135,0,473,0,0,608,35,77
35,78,102,0,0,0,0,102,35,78
35,79,41,0,0,0,0,41,35,79
35,80,0,0,553,44,0,597,35,80
35,81,56,0,0,291,0,347,35,81
35,82,55,0,0,0,0,55,35,82
35,83,0,0,53,0,0,53,35,83
35,84,147,0,292,51,0,490,35,84
35,85,24,0,107,0,0,131,35,85
35,87,33,0,142,0,0,175,35,87
35,89,48,0,124,0,0,172,35,89
35,91,0,0,62,0,0,62,35,91
35,92,4,493,0,0,0,497,35,92
35,93,0,0,291,40,0,331,35,93
35,94,0,0,29,0,0,29,35,94
35,95,102,0,0,0,0,102,35,95
35,97,0,0,64,0,0,64,35,97
35,101,0,0,181,0,0,181,35,101
35,102,0,0,69,0,0,69,35,102
35,104,0,0,27,0,0,27,35,104
35,105,0,0,242,0,0,242,35,105
35,106,0,0,65,0,0,65,35,106
35,109,0,0,527,0,0,527,35,109
35,110,0,0,439,0,0,439,35,110
35,113,33,0,0,0,0,33,35,113
35,115,266,0,0,0,0,266,35,115
35,116,0,0,342,0,0,342,35,116
35,118,0,0,141,0,0,141,35,118
35,122,0,0,364,0,0,364,35,122
35,123,0,0,1423,0,0,1423,35,123
35,127,527,0,0,0,0,527,35,127
35,129,35,0,527,0,0,562,35,129
35,133,162,0,0,0,0,162,35,133
35,134,39,0,292,0,0,331,35,134
35,135,0,0,170,0,0,170,35,135
35,136,0,0,1531,0,0,1531,35,136
35,137,1299,0,0,0,0,1299,35,137
35,140,0,0,979,0,0,979,35,140
35,141,0,0,861,0,0,861,35,141
35,142,0,0,368,0,0,368,35,142
35,145,33,0,67,0,0,100,35,145
35,151,571,0,0,0,0,571,35,151
35,157,0,0,292,0,0,292,35,157
35,159,787,0,787,0,0,1574,35,159
35,163,621,0,0,0,0,621,35,163
35,166,0,0,247,0,0,247,35,166
35,168,408,0,134,0,0,542,35,168
35,170,0,0,98,0,0,98,35,170
35,171,0,0,526,0,0,526,35,171
35,174,0,0,277,0,0,277,35,174
35,188,0,0,133,0,0,133,35,188
35,198,0,0,144,0,0,144,35,198
35,208,0,0,560,0,0,560,35,208
35,209,986,0,195,0,0,1181,35,209
35,225,0,0,268,0,0,268,35,225
35,226,0,0,521,0,0,521,35,226
35,227,0,0,618,0,0,618,35,227
35,240,206,0,0,0,0,206,35,240
35,243,0,0,574,0,0,574,35,243
35,247,0,0,725,0,0,725,35,247
35,255,758,0,805,0,0,1563,35,255
35,259,0,0,417,0,0,417,35,259
35,267,285,0,0,0,0,285,35,267
35,268,0,0,268,0,0,268,35,268
35,272,38,0,0,0,0,38,35,272
35,273,0,0,632,0,0,632,35,273
35,274,0,0,196,0,0,196,35,274
35,275,0,0,169,0,0,169,35,275
35,276,0,0,601,0,0,601,35,276
35,280,0,0,312,0,0,312,35,280
35,283,0,0,54,0,0,54,35,283
35,286,0,0,325,0,0,325,35,286
35,296,0,0,15,0,0,15,35,296
35,300,511,0,0,0,0,511,35,300
35,302,85,0,0,0,0,85,35,302
35,305,0,0,621,0,0,621,35,305
35,314,0,0,724,0,0,724,35,314
35,315,0,0,196,0,0,196,35,315
35,316,0,0,99,0,0,99,35,316
35,322,121,0,0,0,0,121,35,322
35,325,0,0,409,0,0,409,35,325
35,333,0,0,89,0,0,89,35,333
35,337,132,0,0,0,0,132,35,337
35,338,0,0,109,0,0,109,35,338
35,339,34,0,527,0,0,561,35,339
35,340,0,0,37,0,0,37,35,340
35,341,77,0,125,0,0,202,35,341
35,342,0,0,808,0,0,808,35,342
36,1,0,0,752,0,0,752,36,1
36,2,0,0,226,0,0,226,36,2
36,3,0,0,156,0,0,156,36,3
36,4,0,0,466,0,0,466,36,4
36,5,622,448,1115,95,34,2314,36,5
36,6,0,0,587,0,649,1236,36,6
36,7,95,131,0,448,0,674,36,7
36,8,262,0,120,0,0,382,36,8
36,9,0,0,109,0,0,109,36,9
36,14,131,0,0,0,0,131,36,14
36,15,0,0,79,0,0,79,36,15
36,17,0,0,89,0,0,89,36,17
36,21,0,0,466,0,0,466,36,21
36,22,109,0,131,0,0,240,36,22
36,23,33,0,154,0,0,187,36,23
36,24,0,0,788,0,0,788,36,24
36,25,333,0,0,0,285,618,36,25
36,26,466,0,0,0,0,466,36,26
36,27,162,0,834,0,0,996,36,27
36,28,102,0,0,38,89,229,36,28
36,29,262,0,118,0,0,380,36,29
36,30,1768,1627,51,95,0,3541,36,30
36,31,972,320,920,730,0,2942,36,31
36,32,337,22,143,0,0,502,36,32
36,34,1694,620,0,23,0,2337,36,34
36,35,3188,6136,1857,456,0,11637,36,35
36,36,1381,15503,974,812,83,18753,36,36
36,37,491,0,0,12,0,503,36,37
36,38,0,0,35,0,0,35,36,38
36,39,0,0,78,131,0,209,36,39
36,40,0,0,121,0,0,121,36,40
36,43,0,0,281,0,0,281,36,43
36,44,131,0,0,0,0,131,36,44
36,54,131,0,310,0,0,441,36,54
36,55,0,0,125,0,0,125,36,55
36,56,381,0,186,0,0,567,36,56
36,57,131,0,338,0,0,469,36,57
36,58,0,0,100,0,0,100,36,58
36,59,0,0,527,0,0,527,36,59
36,61,1270,0,204,0,0,1474,36,61
36,62,131,0,0,0,0,131,36,62
36,68,252,0,0,131,0,383,36,68
36,69,412,0,448,0,0,860,36,69
36,71,193,0,0,321,0,514,36,71
36,72,0,0,176,0,0,176,36,72
36,73,131,0,428,95,0,654,36,73
36,74,284,0,143,0,0,427,36,74
36,75,0,0,61,0,0,61,36,75
36,76,466,0,252,0,0,718,36,76
36,77,0,0,0,232,0,232,36,77
36,78,102,0,160,88,0,350,36,78
36,79,0,0,420,0,0,420,36,79
36,80,492,0,195,131,0,818,36,80
36,81,131,0,0,0,0,131,36,81
36,82,131,0,559,0,0,690,36,82
36,83,423,0,300,805,0,1528,36,83
36,84,752,479,835,121,0,2187,36,84
36,85,57,476,24,11,0,568,36,85
36,86,71,0,0,45,0,116,36,86
36,87,89,0,0,24,49,162,36,87
36,88,492,0,150,131,0,773,36,88
36,89,0,0,31,48,0,79,36,89
36,90,0,0,487,0,0,487,36,90
36,91,191,0,0,0,0,191,36,91
36,92,30,95,417,0,0,542,36,92
36,93,1369,1400,3545,77,0,6391,36,93
36,94,464,445,389,0,0,1298,36,94
36,95,95,0,0,0,0,95,36,95
36,97,166,0,0,0,0,166,36,97
36,100,48,0,0,0,0,48,36,100
36,101,62,0,0,0,0,62,36,101
36,102,9,0,0,0,0,9,36,102
36,104,9,0,100,0,0,109,36,104
36,105,0,0,0,50,0,50,36,105
36,106,131,0,0,0,0,131,36,106
36,111,0,0,769,0,0,769,36,111
36,113,0,0,329,0,0,329,36,113
36,116,0,0,599,0,0,599,36,116
36,121,406,0,0,0,0,406,36,121
36,123,0,0,706,0,0,706,36,123
36,126,455,0,94,0,0,549,36,126
36,127,274,0,0,0,0,274,36,127
36,129,44,0,0,0,0,44,36,129
36,130,0,0,45,0,0,45,36,130
36,131,0,0,0,95,0,95,36,131
36,132,191,0,0,0,0,191,36,132
36,133,131,0,1126,0,0,1257,36,133
36,134,0,0,208,0,0,208,36,134
36,136,218,0,79,0,0,297,36,136
36,137,0,0,143,0,0,143,36,137
36,141,131,0,0,0,0,131,36,141
36,144,501,0,0,0,0,501,36,144
36,145,0,0,91,0,0,91,36,145
36,147,63,0,0,0,0,63,36,147
36,151,0,0,851,0,0,851,36,151
36,152,0,0,193,0,0,193,36,152
36,153,0,0,73,0,0,73,36,153
36,156,0,0,141,0,0,141,36,156
36,166,0,0,531,0,0,531,36,166
36,167,0,0,466,0,0,466,36,167
36,170,0,0,295,0,0,295,36,170
36,171,0,0,131,0,0,131,36,171
36,174,0,0,389,0,0,389,36,174
36,175,0,0,247,0,0,247,36,175
36,187,0,0,202,0,0,202,36,187
36,190,0,0,120,0,0,120,36,190
36,195,0,0,451,0,0,451,36,195
36,196,0,0,102,0,0,102,36,196
36,197,0,0,428,0,0,428,36,197
36,198,0,0,246,0,0,246,36,198
36,206,0,0,95,0,0,95,36,206
36,207,0,0,361,0,0,361,36,207
36,209,0,0,131,0,0,131,36,209
36,210,0,0,131,0,0,131,36,210
36,212,0,0,653,0,0,653,36,212
36,232,0,0,314,0,0,314,36,232
36,237,0,0,72,0,0,72,36,237
36,240,0,0,196,0,0,196,36,240
36,242,0,0,186,0,0,186,36,242
36,250,0,0,102,0,0,102,36,250
36,251,466,0,0,0,0,466,36,251
36,269,0,0,40,0,0,40,36,269
36,271,131,0,0,0,0,131,36,271
36,273,0,0,640,0,0,640,36,273
36,274,131,0,0,0,0,131,36,274
36,275,0,0,131,0,0,131,36,275
36,291,0,0,854,0,0,854,36,291
36,294,0,0,575,0,0,575,36,294
36,295,0,0,1059,0,0,1059,36,295
36,298,0,0,301,0,0,301,36,298
36,300,0,0,104,412,0,516,36,300
36,305,0,0,570,0,0,570,36,305
36,307,0,0,875,0,0,875,36,307
36,310,0,0,885,0,0,885,36,310
36,317,69,0,0,0,0,69,36,317
36,318,0,0,101,0,0,101,36,318
36,321,111,0,0,0,0,111,36,321
36,329,0,0,20,0,0,20,36,329
36,333,0,0,418,0,0,418,36,333
36,334,131,0,1111,0,0,1242,36,334
36,339,131,0,1245,0,0,1376,36,339
36,340,155,0,70,0,0,225,36,340
36,341,0,0,140,0,0,140,36,341
37,1,0,0,257,0,0,257,37,1
37,2,0,0,93,0,0,93,37,2
37,5,18,0,90,0,0,108,37,5
37,6,0,0,704,0,0,704,37,6
37,7,98,83,97,0,94,372,37,7
37,8,0,993,151,0,232,1376,37,8
37,9,18,92,441,0,0,551,37,9
37,11,0,0,49,23,0,72,37,11
37,12,0,0,70,0,441,511,37,12
37,13,0,0,18,0,0,18,37,13
37,14,18,0,0,0,0,18,37,14
37,16,0,0,130,0,0,130,37,16
37,18,212,0,0,0,0,212,37,18
37,21,0,0,83,0,0,83,37,21
37,24,0,0,447,0,0,447,37,24
37,27,0,0,18,0,0,18,37,27
37,29,0,0,55,0,0,55,37,29
37,30,238,0,0,82,0,320,37,30
37,31,18,0,125,0,0,143,37,31
37,33,32,0,0,0,0,32,37,33
37,34,130,0,0,0,0,130,37,34
37,36,461,18,0,12,0,491,37,36
37,37,36,3053,0,0,0,3089,37,37
37,43,0,0,63,0,0,63,37,43
37,49,0,0,85,0,0,85,37,49
37,54,36,0,0,0,0,36,37,54
37,55,0,0,186,0,0,186,37,55
37,57,497,0,0,0,225,722,37,57
37,62,65,0,15,0,0,80,37,62
37,64,120,0,0,0,0,120,37,64
37,67,80,0,0,0,0,80,37,67
37,68,0,0,72,0,0,72,37,68
37,73,0,0,18,0,0,18,37,73
37,74,0,0,37,0,0,37,37,74
37,76,0,0,41,0,0,41,37,76
37,77,348,0,0,0,45,393,37,77
37,78,19,0,102,0,0,121,37,78
37,80,0,0,0,18,0,18,37,80
37,82,0,0,31,0,0,31,37,82
37,83,0,0,0,37,0,37,37,83
37,84,69,0,0,0,0,69,37,84
37,85,11,0,0,24,0,35,37,85
37,88,138,0,222,0,0,360,37,88
37,90,72,0,83,0,0,155,37,90
37,91,71,0,62,0,0,133,37,91
37,92,52,574,0,0,0,626,37,92
37,93,85,149,0,0,0,234,37,93
37,94,151,83,0,0,0,234,37,94
37,95,0,0,81,0,0,81,37,95
37,99,0,0,70,0,0,70,37,99
37,100,379,0,166,0,0,545,37,100
37,103,0,0,11,0,0,11,37,103
37,104,0,0,117,0,0,117,37,104
37,106,0,0,0,0,50,50,37,106
37,108,53,0,0,0,0,53,37,108
37,112,287,0,0,0,0,287,37,112
37,115,0,0,569,0,0,569,37,115
37,116,0,0,1922,0,0,1922,37,116
37,119,0,0,0,417,0,417,37,119
37,121,0,0,442,0,0,442,37,121
37,124,807,0,316,0,0,1123,37,124
37,126,725,0,0,0,0,725,37,126
37,127,53,0,0,0,0,53,37,127
37,129,0,0,70,0,0,70,37,129
37,130,0,0,0,30,0,30,37,130
37,133,0,0,20,0,94,114,37,133
37,135,69,0,14,25,0,108,37,135
37,136,782,0,0,178,0,960,37,136
37,141,43,0,20,0,0,63,37,141
37,144,0,0,1339,0,0,1339,37,144
37,155,290,0,0,0,0,290,37,155
37,181,0,0,447,0,0,447,37,181
37,202,0,0,0,451,0,451,37,202
37,229,0,0,398,0,0,398,37,229
37,249,0,0,114,0,0,114,37,249
37,254,600,0,0,61,0,661,37,254
37,261,0,0,268,0,0,268,37,261
37,272,1575,0,0,0,0,1575,37,272
37,274,0,0,18,0,0,18,37,274
37,275,0,0,274,0,0,274,37,275
37,288,18,0,0,0,0,18,37,288
37,289,0,0,505,0,0,505,37,289
37,298,0,0,672,0,0,672,37,298
37,314,0,0,0,527,0,527,37,314
37,329,18,0,0,0,0,18,37,329
37,338,18,0,93,0,0,111,37,338
37,339,65,0,0,0,0,65,37,339
38,1,0,0,29,0,0,29,38,1
38,2,0,0,0,35,0,35,38,2
38,3,0,0,35,0,0,35,38,3
38,5,35,0,0,0,0,35,38,5
38,7,71,35,32,0,0,138,38,7
38,8,0,0,0,35,0,35,38,8
38,10,0,18,0,84,0,102,38,10
38,11,22,442,0,69,0,533,38,11
38,12,112,212,122,0,0,446,38,12
38,13,0,18,0,0,0,18,38,13
38,14,0,35,0,0,0,35,38,14
38,15,0,18,0,0,0,18,38,15
38,18,35,0,0,0,0,35,38,18
38,26,0,0,38,0,0,38,38,26
38,30,35,64,64,0,0,163,38,30
38,34,65,0,0,0,0,65,38,34
38,36,0,0,35,0,0,35,38,36
38,38,0,1074,0,84,0,1158,38,38
38,39,78,374,77,52,0,581,38,39
38,41,0,29,38,0,0,67,38,41
38,42,141,544,102,113,0,900,38,42
38,43,0,0,82,0,0,82,38,43
38,44,0,0,0,42,0,42,38,44
38,45,0,0,38,0,0,38,38,45
38,54,0,0,38,0,0,38,38,54
38,57,0,0,62,0,0,62,38,57
38,62,18,0,0,0,0,18,38,62
38,63,0,0,32,0,0,32,38,63
38,68,35,0,0,0,0,35,38,68
38,73,70,0,38,0,0,108,38,73
38,79,88,0,0,0,0,88,38,79
38,81,0,0,35,0,0,35,38,81
38,128,0,0,38,0,0,38,38,128
38,129,70,0,0,0,0,70,38,129
38,133,162,0,0,0,0,162,38,133
38,138,0,0,18,0,0,18,38,138
38,139,0,0,285,0,0,285,38,139
38,151,35,0,32,0,0,67,38,151
38,160,35,0,0,0,0,35,38,160
38,162,345,78,39,0,0,462,38,162
38,163,0,18,58,0,0,76,38,163
38,164,0,1751,0,22,0,1773,38,164
38,168,70,0,0,0,0,70,38,168
38,170,106,0,32,0,0,138,38,170
38,177,0,0,50,0,0,50,38,177
38,188,18,0,0,0,0,18,38,188
38,193,53,0,0,0,0,53,38,193
38,205,0,0,845,0,0,845,38,205
38,208,0,0,19,35,0,54,38,208
38,236,112,0,0,0,0,112,38,236
38,250,0,0,0,18,0,18,38,250
38,262,0,0,0,317,0,317,38,262
38,265,0,0,373,0,0,373,38,265
38,302,0,0,29,0,0,29,38,302
38,339,0,0,29,0,0,29,38,339
38,340,0,0,29,0,0,29,38,340
39,1,0,0,181,0,0,181,39,1
39,2,0,0,310,0,0,310,39,2
39,8,0,0,52,0,0,52,39,8
39,10,0,0,51,0,7,58,39,10
39,11,91,11,0,0,0,102,39,11
39,15,0,0,85,0,0,85,39,15
39,16,0,0,51,0,0,51,39,16
39,17,0,0,122,0,0,122,39,17
39,18,249,0,122,0,0,371,39,18
39,24,78,0,47,0,0,125,39,24
39,29,0,0,78,0,0,78,39,29
39,31,87,0,0,0,0,87,39,31
39,36,0,0,78,131,0,209,39,36
39,38,78,444,0,52,0,574,39,38
39,39,0,1686,171,0,0,1857,39,39
39,40,18,0,20,0,0,38,39,40
39,41,254,1466,0,286,0,2006,39,41
39,42,0,153,81,309,0,543,39,42
39,43,209,0,131,420,0,760,39,43
39,44,223,0,0,0,0,223,39,44
39,45,332,0,0,0,0,332,39,45
39,47,0,0,112,0,0,112,39,47
39,48,446,0,0,0,0,446,39,48
39,49,175,0,0,0,0,175,39,49
39,54,0,0,285,0,0,285,39,54
39,65,111,0,135,0,0,246,39,65
39,69,73,0,0,0,0,73,39,69
39,73,0,0,47,0,0,47,39,73
39,75,0,0,0,78,0,78,39,75
39,77,78,0,0,0,0,78,39,77
39,84,0,0,152,0,0,152,39,84
39,93,40,0,0,0,0,40,39,93
39,99,78,0,0,0,0,78,39,99
39,100,150,0,0,0,0,150,39,100
39,123,594,0,0,0,0,594,39,123
39,126,261,0,0,0,0,261,39,126
39,129,0,0,81,0,0,81,39,129
39,130,0,0,45,0,0,45,39,130
39,133,0,0,177,0,0,177,39,133
39,145,0,0,34,0,0,34,39,145
39,147,0,0,87,0,0,87,39,147
39,151,0,0,784,0,0,784,39,151
39,153,166,0,0,0,0,166,39,153
39,156,0,0,317,0,0,317,39,156
39,159,0,0,481,0,0,481,39,159
39,161,547,0,0,0,0,547,39,161
39,162,0,0,110,0,0,110,39,162
39,163,0,0,1828,0,0,1828,39,163
39,164,221,0,64,0,0,285,39,164
39,165,0,87,0,0,0,87,39,165
39,166,0,0,85,47,0,132,39,166
39,168,144,0,429,128,0,701,39,168
39,169,0,0,86,0,0,86,39,169
39,171,0,0,292,0,0,292,39,171
39,175,0,0,244,0,0,244,39,175
39,176,0,0,57,0,0,57,39,176
39,177,284,0,0,0,0,284,39,177
39,186,0,0,0,97,0,97,39,186
39,208,360,0,0,0,0,360,39,208
39,210,78,0,0,0,0,78,39,210
39,211,0,0,85,0,0,85,39,211
39,214,34,0,47,0,0,81,39,214
39,217,0,0,241,0,0,241,39,217
39,218,0,0,639,0,0,639,39,218
39,220,136,0,0,0,0,136,39,220
39,222,0,0,95,0,0,95,39,222
39,223,0,0,120,0,0,120,39,223
39,226,0,0,450,0,0,450,39,226
39,232,0,0,499,0,0,499,39,232
39,258,0,0,454,0,0,454,39,258
39,263,0,0,634,0,0,634,39,263
39,271,124,0,0,0,0,124,39,271
39,273,0,0,276,0,0,276,39,273
39,274,94,0,47,0,0,141,39,274
39,291,0,0,162,0,0,162,39,291
39,293,0,0,38,0,0,38,39,293
39,300,285,0,134,0,0,419,39,300
40,1,64,0,69,0,0,133,40,1
40,2,0,0,156,0,0,156,40,2
40,4,0,0,18,0,0,18,40,4
40,5,0,0,18,0,0,18,40,5
40,7,9,0,0,0,0,9,40,7
40,11,649,0,0,0,0,649,40,11
40,12,0,0,20,0,0,20,40,12
40,15,0,0,120,0,0,120,40,15
40,16,18,9,10,63,0,100,40,16
40,17,0,0,0,24,0,24,40,17
40,18,27,0,124,0,0,151,40,18
40,20,0,0,130,0,0,130,40,20
40,22,0,0,18,0,0,18,40,22
40,23,0,0,37,0,0,37,40,23
40,26,0,0,175,0,0,175,40,26
40,29,0,0,138,0,0,138,40,29
40,31,0,0,9,0,0,9,40,31
40,35,18,0,0,18,0,36,40,35
40,36,0,0,121,0,0,121,40,36
40,39,106,0,20,0,0,126,40,39
40,40,586,8457,0,141,54,9238,40,40
40,41,684,1187,163,350,0,2384,40,41
40,42,0,0,23,0,0,23,40,42
40,43,586,949,0,275,0,1810,40,43
40,44,536,0,0,0,0,536,40,44
40,45,263,0,70,0,0,333,40,45
40,46,0,0,440,0,0,440,40,46
40,47,107,0,0,0,0,107,40,47
40,48,37,174,21,77,0,309,40,48
40,49,0,0,18,0,0,18,40,49
40,53,0,0,9,0,0,9,40,53
40,57,0,0,46,0,0,46,40,57
40,60,102,0,0,0,0,102,40,60
40,62,27,0,0,0,0,27,40,62
40,64,37,0,18,0,0,55,40,64
40,67,0,0,28,0,0,28,40,67
40,68,0,0,18,0,0,18,40,68
40,77,0,0,10,0,0,10,40,77
40,79,0,0,18,0,0,18,40,79
40,80,0,0,60,0,0,60,40,80
40,82,0,0,0,27,0,27,40,82
40,84,51,0,0,0,0,51,40,84
40,85,24,0,0,0,0,24,40,85
40,92,18,0,0,0,0,18,40,92
40,93,18,0,18,0,0,36,40,93
40,103,35,0,0,0,0,35,40,103
40,106,18,0,0,0,0,18,40,106
40,112,18,0,0,0,0,18,40,112
40,124,18,0,0,0,0,18,40,124
40,148,0,0,241,0,0,241,40,148
40,150,0,0,342,0,0,342,40,150
40,160,0,0,630,0,0,630,40,160
40,161,643,0,0,0,0,643,40,161
40,162,120,0,10,0,0,130,40,162
40,163,18,0,0,0,0,18,40,163
40,164,0,0,80,0,27,107,40,164
40,165,0,0,27,0,0,27,40,165
40,166,70,0,279,0,0,349,40,166
40,167,333,28,101,65,0,527,40,167
40,168,0,0,381,0,0,381,40,168
40,169,120,0,37,0,0,157,40,169
40,170,295,0,0,0,0,295,40,170
40,171,0,0,896,0,0,896,40,171
40,172,0,0,121,0,0,121,40,172
40,173,0,0,18,0,0,18,40,173
40,177,0,0,103,0,0,103,40,177
40,181,0,0,114,0,0,114,40,181
40,182,0,0,912,0,0,912,40,182
40,183,0,0,329,0,0,329,40,183
40,184,0,0,193,0,0,193,40,184
40,186,0,0,97,0,0,97,40,186
40,191,0,0,10,0,0,10,40,191
40,193,0,0,27,0,0,27,40,193
40,195,0,0,263,0,0,263,40,195
40,196,0,0,126,0,0,126,40,196
40,202,0,0,754,0,0,754,40,202
40,203,0,0,1500,0,0,1500,40,203
40,208,537,0,455,0,0,992,40,208
40,210,247,0,40,0,0,287,40,210
40,211,0,0,40,0,0,40,40,211
40,215,0,0,120,0,0,120,40,215
40,216,0,0,60,0,0,60,40,216
40,217,0,0,523,0,0,523,40,217
40,220,0,0,331,0,0,331,40,220
40,222,202,0,516,0,0,718,40,222
40,227,0,0,674,0,0,674,40,227
40,228,0,0,531,0,0,531,40,228
40,230,0,0,1651,0,0,1651,40,230
40,231,0,0,152,0,0,152,40,231
40,233,0,0,259,0,0,259,40,233
40,236,123,0,0,0,0,123,40,236
40,252,0,0,620,0,0,620,40,252
40,253,0,0,15,0,0,15,40,253
40,254,37,0,20,10,0,67,40,254
40,258,18,0,0,0,0,18,40,258
40,259,0,0,626,0,0,626,40,259
40,260,0,0,856,0,0,856,40,260
40,261,426,0,213,0,0,639,40,261
40,262,0,0,20,0,0,20,40,262
40,263,0,0,419,0,0,419,40,263
40,267,0,0,338,0,0,338,40,267
40,268,0,0,35,0,0,35,40,268
40,271,0,0,20,0,0,20,40,271
40,274,0,0,0,27,0,27,40,274
40,277,488,0,0,0,0,488,40,277
40,300,0,0,18,0,0,18,40,300
40,303,0,0,27,0,0,27,40,303
40,328,27,0,0,0,0,27,40,328
40,329,0,0,27,0,0,27,40,329
41,1,0,0,657,0,0,657,41,1
41,2,1364,26,61,0,0,1451,41,2
41,4,121,0,0,0,0,121,41,4
41,5,0,0,55,0,0,55,41,5
41,6,0,0,404,0,0,404,41,6
41,7,11,0,0,0,0,11,41,7
41,12,202,0,0,0,0,202,41,12
41,13,17,0,18,0,0,35,41,13
41,14,180,59,137,0,0,376,41,14
41,15,175,1110,263,439,99,2086,41,15
41,16,0,0,68,0,98,166,41,16
41,17,0,0,151,0,0,151,41,17
41,18,121,0,0,0,0,121,41,18
41,20,0,0,62,0,0,62,41,20
41,23,0,0,43,121,0,164,41,23
41,25,121,0,0,0,0,121,41,25
41,27,26,0,0,0,0,26,41,27
41,29,26,0,373,0,0,399,41,29
41,31,1036,0,263,49,0,1348,41,31
41,36,9,0,0,0,0,9,41,36
41,38,0,29,38,0,0,67,41,38
41,39,228,1202,0,364,0,1794,41,39
41,40,602,1270,163,350,0,2385,41,40
41,41,3202,21652,689,589,0,26132,41,41
41,42,156,672,192,0,0,1020,41,42
41,43,886,1904,1132,52,0,3974,41,43
41,44,684,0,26,0,0,710,41,44
41,45,121,0,327,332,0,780,41,45
41,46,0,0,28,0,0,28,41,46
41,48,0,0,41,175,0,216,41,48
41,49,0,0,48,0,0,48,41,49
41,51,0,0,26,0,0,26,41,51
41,58,0,0,63,0,0,63,41,58
41,61,0,0,121,0,0,121,41,61
41,65,109,0,0,0,0,109,41,65
41,68,0,0,140,0,0,140,41,68
41,69,0,0,121,0,0,121,41,69
41,70,121,0,121,0,0,242,41,70
41,73,72,0,347,0,0,419,41,73
41,76,0,0,26,0,0,26,41,76
41,77,0,0,1046,0,0,1046,41,77
41,78,121,0,60,0,0,181,41,78
41,79,23,0,26,0,0,49,41,79
41,82,0,0,494,0,0,494,41,82
41,83,234,0,0,0,0,234,41,83
41,88,138,0,0,0,0,138,41,88
41,91,26,0,0,0,0,26,41,91
41,95,0,0,30,0,0,30,41,95
41,97,45,0,0,0,0,45,41,97
41,98,0,0,53,0,0,53,41,98
41,99,0,0,53,0,0,53,41,99
41,105,50,0,0,0,0,50,41,105
41,107,198,0,0,0,0,198,41,107
41,115,0,0,91,0,0,91,41,115
41,116,0,0,537,0,0,537,41,116
41,129,0,0,169,0,0,169,41,129
41,130,0,0,30,0,0,30,41,130
41,133,0,0,11,0,0,11,41,133
41,135,0,0,0,301,0,301,41,135
41,136,0,0,28,0,0,28,41,136
41,144,26,0,0,0,0,26,41,144
41,151,1476,0,121,0,0,1597,41,151
41,155,0,0,28,0,0,28,41,155
41,160,0,0,910,0,0,910,41,160
41,162,417,0,257,0,0,674,41,162
41,163,650,0,0,0,0,650,41,163
41,166,242,0,0,0,0,242,41,166
41,167,0,0,269,52,0,321,41,167
41,168,665,121,241,99,0,1126,41,168
41,170,11,0,0,0,0,11,41,170
41,174,0,0,372,0,0,372,41,174
41,177,44,0,0,0,0,44,41,177
41,178,0,0,30,0,0,30,41,178
41,180,0,0,33,0,0,33,41,180
41,181,447,0,0,0,0,447,41,181
41,188,513,0,0,0,0,513,41,188
41,189,0,0,26,0,0,26,41,189
41,192,0,0,573,0,0,573,41,192
41,193,0,0,57,0,0,57,41,193
41,194,127,0,298,0,0,425,41,194
41,195,0,0,461,0,0,461,41,195
41,198,0,0,275,0,0,275,41,198
41,200,0,0,26,0,0,26,41,200
41,203,0,0,868,0,0,868,41,203
41,205,0,0,592,0,0,592,41,205
41,208,0,0,0,204,0,204,41,208
41,210,0,0,491,371,0,862,41,210
41,211,623,0,0,0,0,623,41,211
41,213,143,0,431,0,0,574,41,213
41,215,0,0,242,0,0,242,41,215
41,217,0,0,430,0,0,430,41,217
41,218,0,0,695,0,0,695,41,218
41,219,0,0,173,0,0,173,41,219
41,221,364,0,436,0,0,800,41,221
41,222,0,0,220,0,0,220,41,222
41,225,0,0,165,0,0,165,41,225
41,226,0,0,1014,0,0,1014,41,226
41,228,0,0,560,0,0,560,41,228
41,230,0,0,418,0,0,418,41,230
41,231,0,0,152,0,0,152,41,231
41,232,0,0,314,0,0,314,41,232
41,233,0,0,888,0,0,888,41,233
41,247,281,0,0,0,0,281,41,247
41,250,156,0,0,0,0,156,41,250
41,254,0,0,320,0,0,320,41,254
41,257,121,0,0,0,0,121,41,257
41,259,0,0,182,0,0,182,41,259
41,260,0,0,431,0,0,431,41,260
41,261,0,0,464,0,0,464,41,261
41,262,0,0,317,0,0,317,41,262
41,267,0,0,299,0,0,299,41,267
41,272,0,0,0,38,0,38,41,272
41,281,121,0,0,0,0,121,41,281
41,300,121,0,139,0,0,260,41,300
41,301,26,0,121,0,0,147,41,301
41,332,172,0,0,0,0,172,41,332
41,335,0,0,121,0,0,121,41,335
41,339,0,0,52,0,0,52,41,339
41,340,0,0,170,0,0,170,41,340
42,2,0,24,443,0,0,467,42,2
42,5,0,0,0,360,0,360,42,5
42,6,0,0,511,0,0,511,42,6
42,7,0,0,81,0,0,81,42,7
42,10,0,8,0,5,0,13,42,10
42,11,79,11,10,27,0,127,42,11
42,12,457,803,0,0,0,1260,42,12
42,13,0,168,0,0,0,168,42,13
42,14,0,1722,98,37,0,1857,42,14
42,15,74,593,0,56,154,877,42,15
42,16,0,0,0,68,118,186,42,16
42,17,0,48,209,0,107,364,42,17
42,18,66,0,20,0,0,86,42,18
42,24,244,0,66,0,0,310,42,24
42,32,0,0,81,0,0,81,42,32
42,38,74,611,102,113,0,900,42,38
42,39,112,319,498,0,0,929,42,39
42,40,0,0,23,0,0,23,42,40
42,41,196,584,120,0,0,900,42,41
42,42,143,1353,0,0,0,1496,42,42
42,43,198,24,188,0,0,410,42,43
42,45,656,0,0,0,0,656,42,45
42,51,0,0,81,0,0,81,42,51
42,68,0,0,23,0,0,23,42,68
42,74,0,0,21,0,0,21,42,74
42,75,0,0,0,35,0,35,42,75
42,79,24,0,0,0,0,24,42,79
42,82,0,0,21,0,0,21,42,82
42,85,24,0,0,0,0,24,42,85
42,91,0,0,81,0,0,81,42,91
42,147,0,0,432,0,0,432,42,147
42,154,0,0,401,0,0,401,42,154
42,161,74,0,0,0,0,74,42,161
42,162,0,0,72,0,342,414,42,162
42,164,55,0,153,0,0,208,42,164
42,165,124,0,26,0,0,150,42,165
42,168,0,0,57,0,0,57,42,168
42,169,0,0,0,24,0,24,42,169
42,174,0,0,300,0,0,300,42,174
42,180,0,0,818,0,0,818,42,180
42,187,0,0,249,0,0,249,42,187
42,198,0,0,246,0,0,246,42,198
42,203,0,0,234,0,0,234,42,203
42,205,1577,0,0,0,0,1577,42,205
42,208,0,0,81,0,0,81,42,208
42,212,403,0,0,0,0,403,42,212
42,219,711,0,0,0,0,711,42,219
42,220,0,0,296,0,0,296,42,220
42,221,26,0,0,0,0,26,42,221
42,227,0,0,295,0,0,295,42,227
42,228,0,0,560,0,0,560,42,228
42,229,0,0,398,0,0,398,42,229
42,230,0,0,333,0,0,333,42,230
42,231,0,0,382,0,0,382,42,231
42,233,0,0,338,0,0,338,42,233
42,241,202,0,0,0,0,202,42,241
42,243,0,0,703,0,0,703,42,243
42,246,369,0,0,0,0,369,42,246
42,254,0,0,57,0,0,57,42,254
42,255,885,0,825,0,0,1710,42,255
42,256,0,0,0,48,0,48,42,256
42,259,0,0,417,0,0,417,42,259
42,264,0,0,488,0,0,488,42,264
42,267,0,0,26,0,0,26,42,267
42,276,0,0,849,0,0,849,42,276
42,277,0,0,168,0,0,168,42,277
42,300,24,0,0,0,0,24,42,300
42,327,0,0,23,0,0,23,42,327
42,329,51,0,443,0,0,494,42,329
43,1,160,0,480,0,0,640,43,1
43,2,63,0,243,0,0,306,43,2
43,3,126,0,238,63,0,427,43,3
43,4,0,0,323,0,0,323,43,4
43,5,126,0,194,0,0,320,43,5
43,6,63,0,1287,69,0,1419,43,6
43,7,167,0,500,45,0,712,43,7
43,8,0,0,90,0,0,90,43,8
43,9,0,71,0,324,0,395,43,9
43,10,0,0,63,0,0,63,43,10
43,13,0,0,13,0,0,13,43,13
43,14,315,0,45,63,0,423,43,14
43,15,421,113,247,52,0,833,43,15
43,16,403,0,89,0,0,492,43,16
43,17,176,0,0,0,0,176,43,17
43,18,0,162,370,0,0,532,43,18
43,19,0,0,0,70,0,70,43,19
43,20,63,0,0,0,0,63,43,20
43,21,167,0,0,0,0,167,43,21
43,22,96,0,0,0,0,96,43,22
43,23,63,0,455,0,0,518,43,23
43,26,0,0,63,0,0,63,43,26
43,27,0,0,393,0,0,393,43,27
43,28,0,0,84,0,0,84,43,28
43,29,63,0,169,0,0,232,43,29
43,30,0,0,129,0,0,129,43,30
43,31,136,0,357,0,0,493,43,31
43,32,180,0,84,0,0,264,43,32
43,33,0,0,22,0,0,22,43,33
43,34,23,0,63,0,0,86,43,34
43,35,0,0,581,0,0,581,43,35
43,37,0,0,63,0,0,63,43,37
43,38,35,0,82,0,0,117,43,38
43,39,209,0,209,264,0,682,43,39
43,40,559,854,149,315,0,1877,43,40
43,41,886,1716,741,52,0,3395,43,41
43,42,198,24,188,0,0,410,43,42
43,43,1163,10537,727,0,0,12427,43,43
43,44,1228,350,681,258,433,2950,43,44
43,45,978,2258,1295,344,0,4875,43,45
43,46,0,0,586,0,0,586,43,46
43,47,850,1460,1115,296,141,3862,43,47
43,48,768,728,241,96,0,1833,43,48
43,49,86,0,0,0,0,86,43,49
43,50,74,0,0,0,0,74,43,50
43,51,104,0,0,0,0,104,43,51
43,52,0,0,63,0,0,63,43,52
43,53,0,0,146,0,0,146,43,53
43,54,98,0,0,0,0,98,43,54
43,55,168,0,217,0,0,385,43,55
43,56,83,0,0,0,0,83,43,56
43,59,0,0,393,0,0,393,43,59
43,60,0,0,345,0,0,345,43,60
43,64,0,0,106,0,0,106,43,64
43,65,0,0,111,0,0,111,43,65
43,67,0,0,0,162,0,162,43,67
43,68,121,0,98,98,0,317,43,68
43,69,0,0,167,0,0,167,43,69
43,70,90,0,0,0,0,90,43,70
43,73,63,0,98,0,0,161,43,73
43,74,132,0,0,0,0,132,43,74
43,75,0,0,35,0,0,35,43,75
43,77,0,0,98,0,0,98,43,77
43,78,126,0,170,98,0,394,43,78
43,79,126,0,138,63,0,327,43,79
43,80,0,0,45,0,0,45,43,80
43,81,0,0,0,102,0,102,43,81
43,82,37,0,0,0,0,37,43,82
43,83,0,0,247,0,0,247,43,83
43,84,0,0,55,0,0,55,43,84
43,86,0,0,41,0,0,41,43,86
43,87,100,0,0,0,0,100,43,87
43,91,0,0,9,0,0,9,43,91
43,92,0,0,73,0,0,73,43,92
43,93,47,0,78,0,59,184,43,93
43,94,0,0,62,0,0,62,43,94
43,96,0,0,98,0,0,98,43,96
43,97,153,0,40,0,0,193,43,97
43,99,0,0,98,0,0,98,43,99
43,100,0,0,642,0,0,642,43,100
43,102,0,0,114,0,0,114,43,102
43,106,0,0,35,0,0,35,43,106
43,110,0,0,683,0,0,683,43,110
43,116,0,0,63,0,0,63,43,116
43,127,0,0,98,0,0,98,43,127
43,131,0,0,8,11,0,19,43,131
43,133,167,0,0,0,0,167,43,133
43,135,63,0,0,0,0,63,43,135
43,136,0,0,555,63,0,618,43,136
43,137,333,0,0,0,0,333,43,137
43,138,0,0,44,0,0,44,43,138
43,144,0,0,555,100,0,655,43,144
43,147,0,0,569,0,0,569,43,147
43,151,55,0,45,0,0,100,43,151
43,153,98,0,0,0,0,98,43,153
43,156,0,0,338,0,0,338,43,156
43,157,0,0,214,0,0,214,43,157
43,160,205,0,0,0,0,205,43,160
43,161,158,0,0,0,0,158,43,161
43,163,98,0,876,0,0,974,43,163
43,165,0,0,106,0,0,106,43,165
43,166,739,0,0,0,0,739,43,166
43,167,859,0,212,278,0,1349,43,167
43,168,298,333,277,51,0,959,43,168
43,169,0,0,35,0,0,35,43,169
43,170,0,0,654,0,0,654,43,170
43,171,175,0,0,0,0,175,43,171
43,172,0,0,476,0,0,476,43,172
43,173,0,0,430,0,0,430,43,173
43,175,0,0,677,0,0,677,43,175
43,176,394,0,0,0,0,394,43,176
43,177,0,0,0,0,66,66,43,177
43,183,0,0,393,0,0,393,43,183
43,184,0,0,556,0,0,556,43,184
43,189,0,0,397,0,0,397,43,189
43,191,63,0,68,0,0,131,43,191
43,193,0,0,260,0,0,260,43,193
43,194,0,0,540,0,0,540,43,194
43,195,0,0,163,0,0,163,43,195
43,196,0,0,319,0,0,319,43,196
43,197,45,0,146,0,0,191,43,197
43,198,144,0,0,0,0,144,43,198
43,201,0,0,0,633,0,633,43,201
43,203,190,0,190,0,0,380,43,203
43,204,0,0,677,0,0,677,43,204
43,207,63,0,0,0,0,63,43,207
43,209,63,0,507,0,0,570,43,209
43,210,252,98,966,0,0,1316,43,210
43,211,0,0,677,0,0,677,43,211
43,212,350,0,0,0,0,350,43,212
43,213,0,0,165,0,0,165,43,213
43,214,0,0,1001,0,0,1001,43,214
43,215,74,0,794,0,0,868,43,215
43,216,45,0,1079,0,0,1124,43,216
43,217,0,0,467,0,0,467,43,217
43,218,0,0,738,0,0,738,43,218
43,219,0,0,508,0,0,508,43,219
43,221,0,0,375,0,0,375,43,221
43,222,775,0,681,0,0,1456,43,222
43,225,0,0,391,0,0,391,43,225
43,226,493,0,0,0,0,493,43,226
43,228,0,0,631,0,0,631,43,228
43,229,0,0,2640,0,0,2640,43,229
43,230,0,0,1289,0,0,1289,43,230
43,231,0,0,165,0,0,165,43,231
43,233,0,0,436,0,0,436,43,233
43,234,0,0,684,0,0,684,43,234
43,235,0,0,482,0,0,482,43,235
43,236,0,0,58,0,0,58,43,236
43,240,63,0,68,0,0,131,43,240
43,241,0,0,49,0,0,49,43,241
43,242,0,0,586,0,0,586,43,242
43,243,63,0,0,0,0,63,43,243
43,244,0,0,0,1317,0,1317,43,244
43,245,255,0,0,0,0,255,43,245
43,250,108,0,0,0,0,108,43,250
43,253,0,0,58,0,0,58,43,253
43,254,160,0,1433,0,0,1593,43,254
43,255,258,0,939,0,0,1197,43,255
43,256,0,0,707,0,0,707,43,256
43,257,447,0,616,0,0,1063,43,257
43,258,63,0,749,0,0,812,43,258
43,264,0,0,667,0,0,667,43,264
43,265,0,0,1920,0,0,1920,43,265
43,268,43,0,0,0,0,43,43,268
43,269,63,0,0,0,0,63,43,269
43,272,0,0,56,0,0,56,43,272
43,273,38,0,696,0,0,734,43,273
43,275,0,0,337,0,0,337,43,275
43,284,63,0,0,0,0,63,43,284
43,285,0,0,68,0,0,68,43,285
43,289,82,0,0,0,0,82,43,289
43,292,0,0,344,0,0,344,43,292
43,300,126,0,63,0,0,189,43,300
43,305,304,0,202,0,0,506,43,305
43,320,0,0,0,630,0,630,43,320
43,321,0,0,152,0,0,152,43,321
43,323,0,0,584,0,0,584,43,323
43,329,0,0,55,0,0,55,43,329
43,333,48,0,293,0,0,341,43,333
43,334,0,0,287,0,0,287,43,334
43,336,0,0,298,0,0,298,43,336
43,337,0,0,45,0,0,45,43,337
43,339,0,0,45,0,0,45,43,339
43,340,98,0,63,0,0,161,43,340
44,1,0,0,244,0,0,244,44,1
44,2,455,0,165,0,0,620,44,2
44,5,42,0,0,0,0,42,44,5
44,7,0,0,534,0,0,534,44,7
44,9,56,0,0,0,0,56,44,9
44,12,0,0,61,0,0,61,44,12
44,14,0,0,0,37,0,37,44,14
44,15,68,464,0,86,0,618,44,15
44,16,0,250,199,63,0,512,44,16
44,17,0,0,330,0,0,330,44,17
44,18,0,0,326,743,433,1502,44,18
44,23,0,0,127,0,0,127,44,23
44,29,0,0,152,0,0,152,44,29
44,31,0,0,81,0,0,81,44,31
44,32,43,0,127,0,0,170,44,32
44,35,0,0,665,0,0,665,44,35
44,36,131,0,0,0,0,131,44,36
44,38,0,0,0,42,0,42,44,38
44,39,301,0,0,0,0,301,44,39
44,40,536,0,0,0,0,536,44,40
44,41,684,0,0,0,0,684,44,41
44,42,56,0,26,37,0,119,44,42
44,43,1157,838,403,258,0,2656,44,43
44,44,950,6477,330,117,0,7874,44,44
44,45,1812,2134,276,1185,0,5407,44,45
44,46,951,0,440,210,0,1601,44,46
44,47,880,1367,0,200,0,2447,44,47
44,48,56,247,162,0,0,465,44,48
44,51,104,0,0,0,0,104,44,51
44,54,11,0,152,0,0,163,44,54
44,55,56,0,0,72,0,128,44,55
44,58,0,0,671,0,0,671,44,58
44,60,0,0,102,0,0,102,44,60
44,62,0,0,174,0,0,174,44,62
44,66,58,0,0,0,0,58,44,66
44,68,302,0,0,0,0,302,44,68
44,73,152,0,0,0,0,152,44,73
44,74,0,0,152,0,0,152,44,74
44,75,47,0,0,0,0,47,44,75
44,85,0,0,11,0,0,11,44,85
44,87,0,0,33,0,0,33,44,87
44,92,0,0,47,0,0,47,44,92
44,99,34,0,0,0,0,34,44,99
44,103,16,0,0,0,0,16,44,103
44,106,0,0,56,0,0,56,44,106
44,125,131,0,0,0,0,131,44,125
44,140,0,0,152,0,0,152,44,140
44,147,0,0,0,63,0,63,44,147
44,148,0,0,241,0,0,241,44,148
44,152,380,0,0,0,0,380,44,152
44,159,56,0,0,0,0,56,44,159
44,167,214,0,0,0,0,214,44,167
44,168,0,0,225,0,0,225,44,168
44,169,607,0,0,0,0,607,44,169
44,171,621,0,0,0,0,621,44,171
44,172,0,0,0,129,0,129,44,172
44,189,0,0,331,0,0,331,44,189
44,194,0,0,255,0,0,255,44,194
44,201,0,0,742,0,0,742,44,201
44,202,0,0,1856,0,0,1856,44,202
44,206,486,0,0,0,0,486,44,206
44,208,268,0,0,0,0,268,44,208
44,209,0,0,190,0,0,190,44,209
44,210,117,0,0,0,0,117,44,210
44,211,0,0,677,0,0,677,44,211
44,212,248,0,0,0,0,248,44,212
44,214,124,0,0,0,0,124,44,214
44,216,739,0,0,0,0,739,44,216
44,218,482,0,0,0,0,482,44,218
44,219,0,0,378,0,0,378,44,219
44,220,484,0,239,0,0,723,44,220
44,221,512,0,0,0,0,512,44,221
44,223,0,0,168,0,0,168,44,223
44,225,0,0,146,0,0,146,44,225
44,227,0,0,830,0,0,830,44,227
44,228,0,0,560,0,0,560,44,228
44,232,0,0,601,0,0,601,44,232
44,236,567,0,0,0,0,567,44,236
44,237,26,0,35,47,0,108,44,237
44,238,0,0,135,0,0,135,44,238
44,239,0,0,67,0,0,67,44,239
44,241,48,391,0,0,0,439,44,241
44,242,339,0,0,0,0,339,44,242
44,244,0,0,600,0,0,600,44,244
44,253,0,0,14,22,0,36,44,253
44,254,1560,0,138,0,0,1698,44,254
44,255,931,0,0,0,0,931,44,255
44,256,0,0,284,886,0,1170,44,256
44,258,0,0,2041,0,0,2041,44,258
44,259,0,0,227,0,0,227,44,259
44,260,0,0,856,225,0,1081,44,260
44,263,582,0,0,0,0,582,44,263
44,265,386,0,373,0,0,759,44,265
44,274,152,0,0,0,0,152,44,274
44,275,549,0,0,0,0,549,44,275
44,280,0,0,56,0,0,56,44,280
44,283,0,0,70,0,0,70,44,283
44,287,42,0,0,0,0,42,44,287
44,293,0,0,0,484,0,484,44,293
44,318,0,0,152,0,0,152,44,318
44,329,101,0,0,0,0,101,44,329
44,332,0,0,426,0,0,426,44,332
44,338,0,0,295,0,0,295,44,338
45,1,0,0,442,0,0,442,45,1
45,2,240,0,1300,0,0,1540,45,2
45,3,247,0,0,0,0,247,45,3
45,4,0,0,246,0,0,246,45,4
45,5,240,0,483,166,0,889,45,5
45,9,0,0,754,0,0,754,45,9
45,11,46,0,0,0,0,46,45,11
45,13,0,0,11,0,0,11,45,13
45,14,166,0,0,0,0,166,45,14
45,15,240,24,0,0,0,264,45,15
45,16,81,126,359,129,0,695,45,16
45,17,24,0,553,226,0,803,45,17
45,18,379,187,0,80,0,646,45,18
45,19,0,0,0,236,0,236,45,19
45,20,0,0,180,0,0,180,45,20
45,21,0,0,83,321,0,404,45,21
45,23,240,0,180,0,0,420,45,23
45,24,0,0,222,0,0,222,45,24
45,27,449,0,447,0,0,896,45,27
45,28,0,0,306,0,0,306,45,28
45,29,22,0,240,0,0,262,45,29
45,32,166,0,0,0,0,166,45,32
45,34,0,0,156,0,0,156,45,34
45,36,0,0,121,0,0,121,45,36
45,38,0,0,38,0,0,38,45,38
45,39,332,0,0,0,0,332,45,39
45,40,263,0,70,0,0,333,45,40
45,41,121,0,327,332,0,780,45,41
45,42,56,0,0,0,0,56,45,42
45,43,864,2407,1395,344,0,5010,45,43
45,44,2229,2526,931,1185,0,6871,45,44
45,45,1340,19463,867,240,0,21910,45,45
45,46,0,0,786,0,0,786,45,46
45,47,279,107,180,134,155,855,45,47
45,48,69,0,0,299,155,523,45,48
45,49,166,0,0,0,0,166,45,49
45,52,115,0,0,0,0,115,45,52
45,56,0,0,240,0,0,240,45,56
45,57,0,0,156,0,0,156,45,57
45,59,0,0,607,0,0,607,45,59
45,60,69,0,0,0,0,69,45,60
45,62,27,0,0,0,0,27,45,62
45,64,120,0,104,120,0,344,45,64
45,69,172,0,0,0,0,172,45,69
45,72,0,0,61,0,0,61,45,72
45,73,0,0,226,0,0,226,45,73
45,76,204,0,0,0,0,204,45,76
45,77,0,0,0,140,0,140,45,77
45,78,268,0,0,0,0,268,45,78
45,80,496,0,0,0,0,496,45,80
45,86,0,0,166,0,0,166,45,86
45,91,0,0,0,660,0,660,45,91
45,108,240,0,0,0,0,240,45,108
45,124,0,0,725,0,0,725,45,124
45,128,19,0,0,0,0,19,45,128
45,131,240,0,0,0,0,240,45,131
45,132,0,0,541,0,0,541,45,132
45,136,162,0,118,0,0,280,45,136
45,137,237,0,0,0,0,237,45,137
45,142,0,0,541,0,0,541,45,142
45,150,1286,0,0,0,0,1286,45,150
45,153,0,0,240,0,0,240,45,153
45,155,279,0,0,0,0,279,45,155
45,162,73,0,49,0,0,122,45,162
45,166,1306,0,551,0,0,1857,45,166
45,167,0,0,416,0,0,416,45,167
45,168,199,0,0,0,0,199,45,168
45,169,756,0,388,0,0,1144,45,169
45,171,0,0,578,0,0,578,45,171
45,174,0,0,389,0,0,389,45,174
45,184,0,0,201,0,0,201,45,184
45,187,311,0,799,0,0,1110,45,187
45,188,0,0,98,0,0,98,45,188
45,189,0,0,397,0,0,397,45,189
45,190,0,0,106,0,0,106,45,190
45,193,0,0,278,0,0,278,45,193
45,196,0,0,90,0,0,90,45,196
45,197,63,0,0,0,0,63,45,197
45,204,0,0,758,0,0,758,45,204
45,208,0,0,1321,0,0,1321,45,208
45,210,326,0,0,0,0,326,45,210
45,211,0,0,812,0,0,812,45,211
45,213,256,0,431,0,0,687,45,213
45,215,0,0,496,0,0,496,45,215
45,219,0,0,227,0,0,227,45,219
45,220,0,0,466,0,0,466,45,220
45,221,0,0,0,299,0,299,45,221
45,225,0,0,292,0,0,292,45,225
45,226,1042,0,0,0,0,1042,45,226
45,229,0,0,1092,0,0,1092,45,229
45,231,0,0,236,0,0,236,45,231
45,233,0,0,0,436,0,436,45,233
45,235,484,0,696,0,0,1180,45,235
45,236,0,0,50,0,0,50,45,236
45,237,194,0,0,0,0,194,45,237
45,239,240,0,0,0,0,240,45,239
45,240,206,0,224,0,0,430,45,240
45,241,0,92,58,0,77,227,45,241
45,242,0,0,97,339,258,694,45,242
45,246,0,0,519,0,0,519,45,246
45,250,254,0,0,0,0,254,45,250
45,251,0,0,0,1168,0,1168,45,251
45,253,189,259,393,23,34,898,45,253
45,254,1657,293,519,807,0,3276,45,254
45,255,758,0,0,0,1100,1858,45,255
45,257,433,0,0,0,0,433,45,257
45,258,834,0,0,0,0,834,45,258
45,259,576,0,0,0,0,576,45,259
45,261,0,0,472,0,0,472,45,261
45,263,0,0,1206,0,0,1206,45,263
45,266,0,0,82,0,0,82,45,266
45,268,435,0,0,0,0,435,45,268
45,271,0,0,261,0,0,261,45,271
45,273,428,0,0,0,0,428,45,273
45,274,696,0,0,0,0,696,45,274
45,299,0,0,88,0,0,88,45,299
45,308,240,0,0,0,0,240,45,308
45,318,166,0,0,0,0,166,45,318
45,319,422,0,0,0,0,422,45,319
45,321,95,0,0,0,0,95,45,321
45,322,77,0,0,0,0,77,45,322
45,338,295,0,0,0,0,295,45,338
46,1,0,0,440,0,0,440,46,1
46,6,0,0,280,0,0,280,46,6
46,17,0,0,210,0,0,210,46,17
46,18,0,0,786,0,0,786,46,18
46,23,0,0,0,420,0,420,46,23
46,30,629,0,0,0,0,629,46,30
46,31,0,0,404,0,0,404,46,31
46,34,39,0,0,0,0,39,46,34
46,40,0,0,440,0,0,440,46,40
46,41,0,0,28,0,0,28,46,41
46,43,0,0,210,0,0,210,46,43
46,44,925,0,440,210,0,1575,46,44
46,45,0,0,786,0,0,786,46,45
46,46,3547,19543,898,3425,0,27413,46,46
46,47,1323,2438,210,0,0,3971,46,47
46,48,697,360,0,1781,0,2838,46,48
46,66,0,0,189,0,0,189,46,66
46,79,0,0,345,0,0,345,46,79
46,81,0,0,345,0,0,345,46,81
46,91,0,0,193,0,0,193,46,91
46,99,0,0,193,0,0,193,46,99
46,105,50,0,0,0,0,50,46,105
46,128,26,0,0,0,0,26,46,128
46,148,95,0,0,0,0,95,46,148
46,162,404,0,0,0,0,404,46,162
46,166,0,0,440,521,0,961,46,166
46,167,433,345,230,0,0,1008,46,167
46,168,0,0,225,0,0,225,46,168
46,169,0,0,0,126,0,126,46,169
46,170,0,0,228,0,0,228,46,170
46,186,73,0,73,0,0,146,46,186
46,187,0,0,222,0,0,222,46,187
46,190,0,0,421,0,0,421,46,190
46,191,0,0,404,0,0,404,46,191
46,203,0,0,234,0,0,234,46,203
46,209,0,0,0,761,0,761,46,209
46,210,391,0,0,0,0,391,46,210
46,211,1431,2676,439,1687,0,6233,46,211
46,213,396,0,440,0,0,836,46,213
46,214,0,0,0,0,434,434,46,214
46,217,0,0,363,0,0,363,46,217
46,222,0,0,202,0,0,202,46,222
46,225,199,0,0,0,0,199,46,225
46,232,0,0,212,0,0,212,46,232
46,233,616,0,689,0,0,1305,46,233
46,239,0,0,465,0,0,465,46,239
46,240,0,0,410,0,0,410,46,240
46,243,722,0,0,0,0,722,46,243
46,253,404,24,0,0,0,428,46,253
46,254,214,882,1014,0,0,2110,46,254
46,255,1423,0,0,0,0,1423,46,255
46,256,138,0,0,0,0,138,46,256
46,257,2307,0,545,0,0,2852,46,257
46,258,0,0,310,0,0,310,46,258
46,259,0,0,504,0,0,504,46,259
46,260,0,259,0,0,0,259,46,260
46,261,0,268,1564,0,0,1832,46,261
46,262,0,0,572,0,0,572,46,262
46,263,338,0,0,0,0,338,46,263
46,339,0,0,205,0,0,205,46,339
47,1,0,0,383,0,0,383,47,1
47,5,0,0,107,0,0,107,47,5
47,6,0,0,107,0,0,107,47,6
47,10,21,0,0,0,0,21,47,10
47,15,106,0,0,0,0,106,47,15
47,18,0,125,0,372,0,497,47,18
47,19,0,0,117,0,0,117,47,19
47,20,724,0,0,0,0,724,47,20
47,22,0,0,107,0,0,107,47,22
47,26,0,0,113,0,0,113,47,26
47,32,0,0,183,0,0,183,47,32
47,39,0,0,112,0,0,112,47,39
47,40,107,0,0,0,0,107,47,40
47,41,0,0,536,0,0,536,47,41
47,43,1515,1076,460,296,141,3488,47,43
47,44,817,1367,0,200,0,2384,47,44
47,45,279,241,180,0,311,1011,47,45
47,46,1359,2035,210,0,0,3604,47,46
47,47,704,7397,0,0,0,8101,47,47
47,48,3185,2765,0,352,0,6302,47,48
47,58,97,0,0,0,0,97,47,58
47,62,0,0,352,0,0,352,47,62
47,63,11,0,0,0,0,11,47,63
47,64,107,0,0,0,0,107,47,64
47,73,0,0,0,214,0,214,47,73
47,74,352,0,0,0,0,352,47,74
47,77,55,0,0,0,0,55,47,77
47,82,0,0,107,0,0,107,47,82
47,88,101,0,0,0,0,101,47,88
47,91,107,0,134,0,0,241,47,91
47,94,0,0,107,0,0,107,47,94
47,126,123,0,0,0,0,123,47,126
47,132,352,0,0,0,0,352,47,132
47,160,551,0,0,0,0,551,47,160
47,166,2215,0,0,0,0,2215,47,166
47,167,440,0,233,0,0,673,47,167
47,168,107,0,0,0,0,107,47,168
47,169,107,0,0,0,0,107,47,169
47,189,0,0,111,0,0,111,47,189
47,196,0,0,705,0,0,705,47,196
47,200,0,0,109,0,0,109,47,200
47,202,0,0,444,0,0,444,47,202
47,204,0,0,0,758,0,758,47,204
47,213,0,0,200,0,0,200,47,213
47,214,0,0,40,0,0,40,47,214
47,215,193,0,0,0,0,193,47,215
47,218,107,0,0,0,0,107,47,218
47,240,0,0,117,0,0,117,47,240
47,254,474,184,776,214,0,1648,47,254
47,255,220,0,0,0,0,220,47,255
47,256,0,0,102,0,0,102,47,256
47,261,0,0,464,0,0,464,47,261
47,262,107,0,915,0,0,1022,47,262
47,263,0,0,259,0,0,259,47,263
47,264,0,0,563,0,0,563,47,264
47,275,106,0,0,0,0,106,47,275
47,333,0,0,107,0,0,107,47,333
47,339,0,0,183,0,0,183,47,339
48,1,0,0,445,0,0,445,48,1
48,2,247,0,269,0,0,516,48,2
48,4,247,0,0,0,0,247,48,4
48,7,0,0,269,0,0,269,48,7
48,11,23,0,0,0,0,23,48,11
48,16,247,0,0,0,0,247,48,16
48,17,164,0,0,0,0,164,48,17
48,18,368,0,254,247,0,869,48,18
48,22,0,0,36,0,0,36,48,22
48,34,121,0,0,0,0,121,48,34
48,39,446,0,0,0,0,446,48,39
48,40,37,174,21,77,0,309,48,40
48,41,0,0,41,175,0,216,48,41
48,43,768,1112,162,96,0,2138,48,43
48,44,56,247,162,0,0,465,48,44
48,45,69,0,0,299,0,368,48,45
48,46,697,360,0,1781,0,2838,48,46
48,47,3185,1978,438,352,155,6108,48,47
48,48,989,3756,0,1028,0,5773,48,48
48,53,0,0,194,0,0,194,48,53
48,56,0,0,0,0,359,359,48,56
48,57,0,0,157,0,0,157,48,57
48,59,607,0,298,0,0,905,48,59
48,65,0,0,269,0,0,269,48,65
48,68,193,0,0,0,0,193,48,68
48,71,321,0,0,0,0,321,48,71
48,73,0,0,567,0,0,567,48,73
48,79,0,0,247,0,0,247,48,79
48,81,0,0,191,0,0,191,48,81
48,91,0,0,186,0,0,186,48,91
48,93,0,0,49,0,0,49,48,93
48,102,0,0,0,114,0,114,48,102
48,136,497,0,0,0,0,497,48,136
48,140,247,0,0,0,0,247,48,140
48,160,0,0,546,0,0,546,48,160
48,161,73,0,0,0,0,73,48,161
48,162,0,0,162,0,0,162,48,162
48,164,922,0,0,0,0,922,48,164
48,166,0,498,318,0,0,816,48,166
48,167,285,463,818,0,0,1566,48,167
48,168,121,0,107,0,0,228,48,168
48,169,0,0,162,0,0,162,48,169
48,171,0,0,0,126,0,126,48,171
48,173,0,0,180,0,0,180,48,173
48,177,0,0,103,0,0,103,48,177
48,190,0,0,307,0,0,307,48,190
48,191,0,0,292,0,0,292,48,191
48,193,0,0,140,0,0,140,48,193
48,208,579,0,318,0,0,897,48,208
48,209,547,0,0,0,0,547,48,209
48,210,469,2272,131,0,0,2872,48,210
48,211,0,0,1716,0,0,1716,48,211
48,215,0,0,162,0,0,162,48,215
48,216,0,0,439,0,0,439,48,216
48,218,247,0,424,0,0,671,48,218
48,221,0,0,858,0,0,858,48,221
48,225,0,0,172,0,0,172,48,225
48,232,0,0,866,0,0,866,48,232
48,241,716,0,0,0,0,716,48,241
48,244,0,0,149,0,0,149,48,244
48,251,316,0,0,0,0,316,48,251
48,254,562,0,162,0,0,724,48,254
48,255,758,0,0,0,0,758,48,255
48,256,267,0,0,0,0,267,48,256
48,257,700,0,942,0,0,1642,48,257
48,313,0,0,108,0,0,108,48,313
48,321,111,0,0,0,0,111,48,321
49,1,0,0,156,0,0,156,49,1
49,2,0,0,251,0,0,251,49,2
49,3,0,0,439,244,0,683,49,3
49,5,74,0,570,0,0,644,49,5
49,7,0,0,74,0,0,74,49,7
49,14,0,0,31,0,0,31,49,14
49,15,0,0,24,0,0,24,49,15
49,16,0,0,88,0,0,88,49,16
49,17,0,0,74,0,0,74,49,17
49,18,0,0,325,80,0,405,49,18
49,19,274,256,128,0,0,658,49,19
49,20,1123,50,785,151,0,2109,49,20
49,21,668,376,168,76,0,1288,49,21
49,22,0,885,0,0,107,992,49,22
49,23,155,1409,449,0,0,2013,49,23
49,24,0,0,349,0,0,349,49,24
49,25,0,48,74,32,0,154,49,25
49,26,0,513,266,0,0,779,49,26
49,27,74,214,206,0,0,494,49,27
49,28,129,0,265,0,0,394,49,28
49,29,0,34,40,0,0,74,49,29
49,31,158,0,206,0,0,364,49,31
49,32,0,0,48,0,0,48,49,32
49,33,0,0,6,0,0,6,49,33
49,34,39,0,0,0,0,39,49,34
49,35,0,0,514,0,0,514,49,35
49,37,0,0,85,0,0,85,49,37
49,39,175,0,0,0,0,175,49,39
49,40,0,0,18,0,0,18,49,40
49,41,0,0,48,0,0,48,49,41
49,42,0,0,8,0,0,8,49,42
49,43,74,0,86,0,0,160,49,43
49,45,166,0,0,0,0,166,49,45
49,49,427,5729,0,110,0,6266,49,49
49,50,74,0,119,126,0,319,49,50
49,51,147,0,0,97,0,244,49,51
49,52,0,627,386,181,0,1194,49,52
49,53,94,121,200,269,0,684,49,53
49,54,565,0,98,26,0,689,49,54
49,55,0,279,0,80,0,359,49,55
49,56,468,1218,0,99,0,1785,49,56
49,57,815,488,0,80,0,1383,49,57
49,58,50,0,127,108,0,285,49,58
49,59,0,393,1017,0,0,1410,49,59
49,60,0,0,164,0,0,164,49,60
49,61,26,0,298,0,0,324,49,61
49,62,258,53,52,0,0,363,49,62
49,63,147,0,54,0,0,201,49,63
49,64,194,0,104,0,0,298,49,64
49,65,227,0,153,0,0,380,49,65
49,66,119,0,0,0,0,119,49,66
49,67,83,0,0,0,0,83,49,67
49,68,0,0,81,0,0,81,49,68
49,69,248,0,0,153,0,401,49,69
49,70,0,0,0,35,0,35,49,70
49,72,0,0,80,48,0,128,49,72
49,73,80,0,156,0,0,236,49,73
49,74,98,388,203,0,0,689,49,74
49,75,0,0,56,0,0,56,49,75
49,76,0,0,38,0,0,38,49,76
49,78,512,0,10,222,104,848,49,78
49,79,0,0,256,0,0,256,49,79
49,81,219,0,32,0,0,251,49,81
49,82,0,0,172,0,0,172,49,82
49,83,0,0,74,39,0,113,49,83
49,84,93,0,48,0,0,141,49,84
49,86,18,0,0,0,0,18,49,86
49,87,0,0,127,0,0,127,49,87
49,88,0,0,291,0,0,291,49,88
49,89,0,0,255,0,0,255,49,89
49,90,0,0,72,0,0,72,49,90
49,93,0,0,419,0,0,419,49,93
49,96,50,0,50,0,0,100,49,96
49,97,0,0,50,0,0,50,49,97
49,99,38,0,0,0,0,38,49,99
49,100,0,0,161,0,0,161,49,100
49,101,0,0,328,0,0,328,49,101
49,102,0,0,58,0,0,58,49,102
49,103,0,0,10,10,0,20,49,103
49,104,0,0,36,0,0,36,49,104
49,108,74,0,0,0,0,74,49,108
49,113,0,0,577,0,0,577,49,113
49,121,0,0,74,0,0,74,49,121
49,127,0,0,391,0,0,391,49,127
49,128,0,0,30,0,0,30,49,128
49,129,74,0,85,0,0,159,49,129
49,131,0,0,50,0,0,50,49,131
49,132,76,0,0,0,0,76,49,132
49,139,74,0,0,0,0,74,49,139
49,144,0,0,50,0,0,50,49,144
49,145,0,0,25,0,0,25,49,145
49,163,0,0,0,50,0,50,49,163
49,164,0,0,55,0,0,55,49,164
49,166,147,0,105,0,0,252,49,166
49,167,158,0,0,0,0,158,49,167
49,168,0,0,333,0,0,333,49,168
49,186,0,0,101,0,0,101,49,186
49,188,0,0,569,0,0,569,49,188
49,189,0,0,531,0,0,531,49,189
49,191,73,0,694,0,0,767,49,191
49,195,0,0,74,0,0,74,49,195
49,197,0,0,74,0,0,74,49,197
49,198,144,0,0,0,0,144,49,198
49,219,0,0,894,0,0,894,49,219
49,229,0,0,474,0,0,474,49,229
49,230,0,0,625,0,0,625,49,230
49,236,47,0,0,0,0,47,49,236
49,237,0,0,171,0,0,171,49,237
49,238,0,0,74,147,72,293,49,238
49,239,0,0,241,0,0,241,49,239
49,240,352,0,224,0,0,576,49,240
49,241,0,0,121,0,0,121,49,241
49,243,0,0,50,0,0,50,49,243
49,246,0,0,588,0,0,588,49,246
49,247,0,0,90,0,0,90,49,247
49,248,122,0,0,0,0,122,49,248
49,255,404,0,0,0,0,404,49,255
49,261,0,0,426,0,0,426,49,261
49,268,0,0,141,36,0,177,49,268
49,269,139,0,92,0,0,231,49,269
49,270,0,0,123,0,0,123,49,270
49,272,48,0,0,0,0,48,49,272
49,273,0,0,292,0,0,292,49,273
49,274,0,0,618,0,0,618,49,274
49,275,122,0,76,0,0,198,49,275
49,276,601,0,74,0,0,675,49,276
49,280,74,0,0,0,0,74,49,280
49,282,0,0,75,0,0,75,49,282
49,295,0,0,0,59,0,59,49,295
49,300,74,0,0,0,0,74,49,300
49,301,204,0,52,50,0,306,49,301
49,305,0,0,409,0,0,409,49,305
49,307,0,0,0,710,0,710,49,307
49,312,74,0,0,0,0,74,49,312
49,316,44,0,0,88,0,132,49,316
49,319,48,0,12,0,0,60,49,319
49,324,0,0,502,0,0,502,49,324
49,325,48,0,0,0,0,48,49,325
49,328,0,0,267,0,0,267,49,328
49,329,0,0,51,0,0,51,49,329
49,330,0,0,425,0,0,425,49,330
49,339,0,0,112,0,0,112,49,339
49,340,0,0,74,0,0,74,49,340
49,341,0,0,0,74,0,74,49,341
50,1,0,0,24,0,0,24,50,1
50,2,0,0,98,74,0,172,50,2
50,3,0,0,412,0,0,412,50,3
50,5,74,0,0,0,0,74,50,5
50,6,0,0,74,0,0,74,50,6
50,9,32,0,74,0,0,106,50,9
50,10,35,0,0,0,0,35,50,10
50,11,0,0,62,0,0,62,50,11
50,14,0,0,62,0,0,62,50,14
50,17,148,0,0,0,0,148,50,17
50,18,425,62,38,0,0,525,50,18
50,19,697,339,180,0,0,1216,50,19
50,20,749,0,0,192,0,941,50,20
50,22,0,0,38,0,0,38,50,22
50,24,0,0,163,0,0,163,50,24
50,26,0,0,38,0,0,38,50,26
50,27,0,0,32,0,0,32,50,27
50,29,55,0,0,0,0,55,50,29
50,32,21,0,0,0,0,21,50,32
50,35,0,0,157,0,0,157,50,35
50,49,130,0,119,108,0,357,50,49
50,50,989,960,0,299,286,2534,50,50
50,51,840,870,0,274,0,1984,50,51
50,52,115,286,38,0,0,439,50,52
50,53,356,125,62,0,0,543,50,53
50,54,0,0,0,37,0,37,50,54
50,56,221,0,0,99,0,320,50,56
50,59,0,0,196,0,0,196,50,59
50,61,152,0,0,0,0,152,50,61
50,62,74,0,0,74,0,148,50,62
50,64,0,0,38,0,0,38,50,64
50,66,38,0,0,70,0,108,50,66
50,70,35,0,0,156,0,191,50,70
50,73,273,0,0,136,0,409,50,73
50,74,0,0,0,62,0,62,50,74
50,76,70,0,0,0,0,70,50,76
50,79,0,0,38,0,0,38,50,79
50,80,74,0,0,0,0,74,50,80
50,82,0,0,74,0,0,74,50,82
50,93,0,0,32,0,0,32,50,93
50,94,74,0,0,0,0,74,50,94
50,95,15,0,74,0,0,89,50,95
50,96,76,0,0,0,0,76,50,96
50,101,74,0,0,0,0,74,50,101
50,108,74,0,0,0,0,74,50,108
50,138,0,0,74,0,0,74,50,138
50,153,74,0,0,0,0,74,50,153
50,193,0,0,178,0,0,178,50,193
50,229,0,0,398,0,0,398,50,229
50,236,41,0,80,94,0,215,50,236
50,239,55,110,132,0,0,297,50,239
50,240,712,35,106,120,0,973,50,240
50,241,136,0,0,0,0,136,50,241
50,242,0,0,528,0,0,528,50,242
50,251,183,0,0,0,0,183,50,251
50,272,136,0,0,0,0,136,50,272
50,275,0,0,98,0,0,98,50,275
50,286,0,0,74,0,0,74,50,286
50,300,55,0,169,0,0,224,50,300
50,317,0,0,28,0,0,28,50,317
50,335,0,0,38,0,0,38,50,335
50,339,0,0,30,0,0,30,50,339
51,1,297,0,327,0,0,624,51,1
51,2,104,0,93,0,0,197,51,2
51,5,0,0,456,104,0,560,51,5
51,6,0,0,104,0,0,104,51,6
51,9,0,0,80,0,0,80,51,9
51,10,0,0,104,0,0,104,51,10
51,16,0,0,104,0,0,104,51,16
51,17,0,0,104,0,0,104,51,17
51,18,104,0,0,0,0,104,51,18
51,19,184,330,0,104,0,618,51,19
51,21,0,155,714,0,0,869,51,21
51,22,455,0,104,0,0,559,51,22
51,24,0,0,274,0,0,274,51,24
51,28,0,0,87,0,126,213,51,28
51,29,0,0,93,0,0,93,51,29
51,30,0,0,94,0,0,94,51,30
51,31,197,0,0,0,0,197,51,31
51,41,0,0,26,0,0,26,51,41
51,42,0,0,81,0,0,81,51,42
51,43,104,0,0,0,0,104,51,43
51,44,104,0,0,0,0,104,51,44
51,49,147,0,0,97,0,244,51,49
51,50,675,870,0,274,0,1819,51,50
51,51,1217,2785,0,193,0,4195,51,51
51,52,475,629,0,0,0,1104,51,52
51,53,162,0,344,0,0,506,51,53
51,54,245,130,210,0,0,585,51,54
51,55,311,262,84,104,0,761,51,55
51,56,277,493,0,248,0,1018,51,56
51,57,75,0,318,0,0,393,51,57
51,58,352,0,201,0,0,553,51,58
51,59,482,0,87,0,0,569,51,59
51,60,102,0,0,150,0,252,51,60
51,62,193,0,0,0,0,193,51,62
51,66,58,0,0,0,0,58,51,66
51,67,104,0,0,0,0,104,51,67
51,68,174,0,0,0,0,174,51,68
51,69,197,0,0,0,0,197,51,69
51,70,208,0,0,0,0,208,51,70
51,73,104,0,0,0,0,104,51,73
51,74,0,0,104,0,0,104,51,74
51,77,104,0,104,0,0,208,51,77
51,79,178,0,0,0,0,178,51,79
51,80,104,0,0,0,0,104,51,80
51,82,87,0,0,0,0,87,51,82
51,84,93,0,0,89,0,182,51,84
51,85,0,0,24,0,0,24,51,85
51,92,0,0,1,0,0,1,51,92
51,99,0,0,161,0,0,161,51,99
51,129,0,0,89,0,0,89,51,129
51,191,0,0,93,0,0,93,51,191
51,218,559,0,0,0,0,559,51,218
51,236,180,0,0,0,0,180,51,236
51,238,239,0,0,0,0,239,51,238
51,239,1174,288,366,0,0,1828,51,239
51,240,185,0,0,0,0,185,51,240
51,241,193,0,0,0,0,193,51,241
51,243,123,0,0,0,0,123,51,243
51,244,0,0,532,0,0,532,51,244
51,250,0,0,0,248,0,248,51,250
51,251,0,0,28,0,0,28,51,251
51,254,0,0,448,600,0,1048,51,254
51,265,208,0,0,0,0,208,51,265
51,276,0,0,601,0,0,601,51,276
51,300,289,0,289,0,0,578,51,300
51,305,0,0,202,0,0,202,51,305
51,307,0,0,282,0,0,282,51,307
51,308,0,0,220,0,0,220,51,308
51,311,0,0,438,0,0,438,51,311
51,315,0,0,321,0,0,321,51,315
51,317,104,0,0,0,0,104,51,317
51,318,104,0,0,0,0,104,51,318
51,322,121,0,0,0,0,121,51,322
51,326,0,0,498,0,0,498,51,326
51,339,0,0,93,0,0,93,51,339
51,340,37,0,0,0,0,37,51,340
51,341,0,0,56,0,0,56,51,341
52,1,61,0,61,0,0,122,52,1
52,3,0,0,124,0,0,124,52,3
52,5,0,0,121,0,0,121,52,5
52,9,353,0,0,0,0,353,52,9
52,18,184,0,0,0,0,184,52,18
52,19,507,0,170,0,0,677,52,19
52,20,0,0,60,0,0,60,52,20
52,21,468,439,0,0,0,907,52,21
52,22,61,0,76,0,0,137,52,22
52,23,0,0,208,0,0,208,52,23
52,24,240,0,92,0,0,332,52,24
52,27,162,0,0,152,0,314,52,27
52,28,0,0,371,0,0,371,52,28
52,29,0,0,325,0,0,325,52,29
52,31,0,0,325,0,0,325,52,31
52,32,0,0,387,0,0,387,52,32
52,34,0,0,42,0,0,42,52,34
52,43,0,0,63,0,0,63,52,43
52,45,115,0,0,0,0,115,52,45
52,49,0,627,361,181,0,1169,52,49
52,50,176,286,38,0,0,500,52,50
52,51,653,709,0,0,0,1362,52,51
52,52,61,2227,0,0,0,2288,52,52
52,53,115,1460,105,118,0,1798,52,53
52,54,59,0,66,0,0,125,52,54
52,55,552,0,0,0,0,552,52,55
52,56,635,148,228,0,0,1011,52,56
52,57,276,61,569,0,0,906,52,57
52,58,0,306,229,0,0,535,52,58
52,61,0,0,567,0,0,567,52,61
52,62,0,0,27,0,0,27,52,62
52,64,0,0,131,0,0,131,52,64
52,65,0,0,121,0,0,121,52,65
52,68,42,0,0,0,0,42,52,68
52,69,185,0,0,0,0,185,52,69
52,72,0,0,60,0,0,60,52,72
52,73,42,0,66,0,0,108,52,73
52,74,62,0,387,0,0,449,52,74
52,75,0,0,112,0,0,112,52,75
52,77,220,0,140,0,0,360,52,77
52,79,61,0,251,0,0,312,52,79
52,80,0,0,0,180,0,180,52,80
52,81,98,0,61,0,0,159,52,81
52,83,0,0,61,0,0,61,52,83
52,87,0,0,160,0,0,160,52,87
52,91,0,0,89,0,0,89,52,91
52,92,0,0,42,0,0,42,52,92
52,94,0,0,62,0,0,62,52,94
52,95,0,0,150,75,0,225,52,95
52,99,0,0,34,0,0,34,52,99
52,107,0,0,313,0,0,313,52,107
52,109,0,0,123,0,0,123,52,109
52,111,128,0,0,0,0,128,52,111
52,127,0,0,912,0,0,912,52,127
52,128,0,0,25,0,0,25,52,128
52,136,0,0,849,0,0,849,52,136
52,144,0,0,1912,0,0,1912,52,144
52,157,0,0,228,0,0,228,52,157
52,164,0,0,32,0,0,32,52,164
52,166,103,0,185,0,0,288,52,166
52,169,0,0,42,0,0,42,52,169
52,181,0,0,447,0,0,447,52,181
52,196,0,0,338,0,0,338,52,196
52,197,0,0,61,0,0,61,52,197
52,210,371,0,0,0,0,371,52,210
52,216,0,0,341,0,0,341,52,216
52,237,0,0,26,0,0,26,52,237
52,239,148,0,0,0,0,148,52,239
52,240,42,206,0,0,0,248,52,240
52,241,185,0,0,0,0,185,52,241
52,247,0,537,0,0,0,537,52,247
52,257,0,0,486,0,0,486,52,257
52,268,0,0,40,0,0,40,52,268
52,270,76,0,0,0,0,76,52,270
52,274,0,0,705,0,0,705,52,274
52,277,679,0,0,0,0,679,52,277
52,279,0,0,938,0,0,938,52,279
52,280,0,0,179,0,0,179,52,280
52,284,0,0,384,0,0,384,52,284
52,288,0,0,272,0,0,272,52,288
52,292,61,0,0,0,0,61,52,292
52,293,0,0,657,0,0,657,52,293
52,300,0,0,556,0,0,556,52,300
52,303,0,0,371,0,0,371,52,303
52,305,0,0,1994,0,0,1994,52,305
52,314,0,0,424,0,0,424,52,314
52,316,0,0,208,0,0,208,52,316
52,320,0,0,597,0,0,597,52,320
52,322,77,0,0,0,0,77,52,322
52,325,0,0,364,0,0,364,52,325
52,335,0,0,418,0,0,418,52,335
52,336,0,0,306,0,0,306,52,336
52,339,42,0,42,0,0,84,52,339
53,1,0,0,136,0,0,136,53,1
53,2,0,0,58,0,0,58,53,2
53,4,0,0,233,0,0,233,53,4
53,5,0,0,519,267,0,786,53,5
53,6,0,0,58,0,0,58,53,6
53,10,0,0,11,0,0,11,53,10
53,17,0,0,20,0,0,20,53,17
53,19,0,0,170,79,0,249,53,19
53,21,0,0,261,0,0,261,53,21
53,22,0,0,274,0,0,274,53,22
53,23,0,0,56,0,0,56,53,23
53,24,0,0,292,0,0,292,53,24
53,26,0,0,201,0,0,201,53,26
53,27,93,0,259,45,0,397,53,27
53,28,429,0,41,0,0,470,53,28
53,29,0,0,564,58,0,622,53,29
53,31,128,0,88,0,0,216,53,31
53,32,339,0,21,0,0,360,53,32
53,40,0,0,9,0,0,9,53,40
53,43,0,0,146,0,0,146,53,43
53,49,121,121,200,269,0,711,53,49
53,50,0,17,62,0,0,79,53,50
53,51,162,0,344,0,0,506,53,51
53,52,115,1145,45,118,0,1423,53,52
53,53,931,4073,0,0,0,5004,53,53
53,54,566,1742,175,26,0,2509,53,54
53,55,1184,1051,72,601,0,2908,53,55
53,56,428,594,681,0,0,1703,53,56
53,57,45,0,282,0,0,327,53,57
53,58,306,1133,205,416,0,2060,53,58
53,59,665,0,1385,158,0,2208,53,59
53,60,284,0,0,0,0,284,53,60
53,61,1167,175,0,277,0,1619,53,61
53,62,111,58,0,0,0,169,53,62
53,63,263,0,71,74,0,408,53,63
53,64,255,0,63,0,0,318,53,64
53,65,116,0,0,0,0,116,53,65
53,66,451,0,0,0,0,451,53,66
53,67,0,0,55,0,0,55,53,67
53,68,121,0,519,109,0,749,53,68
53,69,0,0,101,0,0,101,53,69
53,73,588,0,0,0,292,880,53,73
53,74,0,0,201,0,168,369,53,74
53,75,0,0,118,35,0,153,53,75
53,76,93,38,77,0,0,208,53,76
53,77,58,0,0,0,0,58,53,77
53,78,0,0,72,0,0,72,53,78
53,79,41,0,111,0,0,152,53,79
53,80,44,0,533,0,0,577,53,80
53,82,0,0,58,53,0,111,53,82
53,84,0,0,89,0,0,89,53,84
53,87,33,0,0,0,0,33,53,87
53,88,0,0,254,0,0,254,53,88
53,97,0,0,35,0,0,35,53,97
53,104,21,0,0,0,0,21,53,104
53,106,0,0,219,0,0,219,53,106
53,107,0,0,58,0,0,58,53,107
53,109,0,0,180,0,0,180,53,109
53,110,379,0,267,0,0,646,53,110
53,121,0,0,666,0,0,666,53,121
53,128,0,0,128,0,0,128,53,128
53,138,0,0,62,0,0,62,53,138
53,144,0,0,58,0,0,58,53,144
53,150,0,0,934,0,0,934,53,150
53,151,201,0,0,0,0,201,53,151
53,152,0,0,45,0,0,45,53,152
53,166,330,0,166,0,0,496,53,166
53,167,0,0,33,0,0,33,53,167
53,170,0,0,238,0,0,238,53,170
53,181,0,0,277,0,0,277,53,181
53,187,0,0,796,0,0,796,53,187
53,190,0,0,345,0,0,345,53,190
53,192,0,0,315,0,0,315,53,192
53,196,0,0,108,0,0,108,53,196
53,204,0,0,678,0,0,678,53,204
53,211,45,0,0,0,0,45,53,211
53,213,143,0,194,0,0,337,53,213
53,214,0,0,323,0,0,323,53,214
53,222,0,0,315,0,0,315,53,222
53,227,0,0,261,0,0,261,53,227
53,228,0,0,631,0,0,631,53,228
53,230,0,0,625,0,0,625,53,230
53,231,0,0,152,0,0,152,53,231
53,234,0,0,684,0,0,684,53,234
53,237,201,0,70,58,0,329,53,237
53,239,304,39,406,0,0,749,53,239
53,240,159,0,86,0,0,245,53,240
53,241,53,0,0,0,0,53,53,241
53,242,0,0,408,0,0,408,53,242
53,243,288,0,370,0,0,658,53,243
53,247,0,0,894,0,0,894,53,247
53,249,275,157,0,0,0,432,53,249
53,250,179,0,975,0,0,1154,53,250
53,251,200,0,85,359,0,644,53,251
53,254,248,0,107,0,0,355,53,254
53,260,0,0,259,0,0,259,53,260
53,262,0,0,841,0,0,841,53,262
53,269,0,0,238,0,0,238,53,269
53,270,139,0,113,0,0,252,53,270
53,272,0,0,176,136,0,312,53,272
53,273,482,0,0,0,0,482,53,273
53,274,0,0,208,0,0,208,53,274
53,275,0,0,169,0,0,169,53,275
53,277,0,0,642,0,0,642,53,277
53,278,395,0,390,0,0,785,53,278
53,280,0,0,168,0,0,168,53,280
53,285,0,0,1221,0,0,1221,53,285
53,293,0,0,323,0,0,323,53,293
53,294,0,0,0,467,0,467,53,294
53,300,0,0,296,0,0,296,53,300
53,301,0,0,86,79,0,165,53,301
53,302,0,0,140,0,0,140,53,302
53,311,0,0,462,0,0,462,53,311
53,317,21,0,0,0,0,21,53,317
53,318,58,0,144,0,0,202,53,318
53,319,61,0,58,0,0,119,53,319
53,320,0,0,270,0,0,270,53,320
53,321,347,0,0,0,0,347,53,321
53,322,515,0,0,0,0,515,53,322
53,325,0,0,107,0,0,107,53,325
53,326,0,0,598,0,0,598,53,326
53,328,319,0,0,0,0,319,53,328
53,339,0,0,84,0,0,84,53,339
54,1,0,0,149,52,0,201,54,1
54,2,0,0,89,0,0,89,54,2
54,3,0,0,37,0,0,37,54,3
54,5,0,0,37,0,0,37,54,5
54,6,0,0,125,0,0,125,54,6
54,9,37,0,0,0,0,37,54,9
54,11,0,0,0,11,0,11,54,11
54,16,0,0,74,0,0,74,54,16
54,17,0,0,0,0,35,35,54,17
54,19,37,0,15,0,0,52,54,19
54,21,240,0,0,0,0,240,54,21
54,22,0,0,36,0,0,36,54,22
54,23,0,0,246,56,0,302,54,23
54,24,14,0,526,0,0,540,54,24
54,25,0,0,14,0,0,14,54,25
54,26,37,0,125,0,0,162,54,26
54,27,41,0,992,0,0,1033,54,27
54,28,26,46,64,0,0,136,54,28
54,29,0,0,195,0,0,195,54,29
54,30,0,0,44,26,0,70,54,30
54,31,0,0,28,0,0,28,54,31
54,34,0,0,59,14,0,73,54,34
54,35,0,0,723,0,0,723,54,35
54,36,262,0,132,0,0,394,54,36
54,37,18,0,0,0,0,18,54,37
54,38,0,0,38,0,0,38,54,38
54,39,0,0,87,0,0,87,54,39
54,43,171,0,0,0,0,171,54,43
54,44,0,0,152,0,0,152,54,44
54,49,267,0,35,124,0,426,54,49
54,50,74,0,0,0,0,74,54,50
54,51,184,130,210,0,0,524,54,51
54,52,61,0,132,0,0,193,54,52
54,53,1050,1137,220,201,0,2608,54,53
54,54,603,13222,436,74,0,14335,54,54
54,55,731,1131,0,37,0,1899,54,55
54,56,376,981,469,74,0,1900,54,56
54,57,0,0,101,0,0,101,54,57
54,58,37,849,524,0,0,1410,54,58
54,59,37,37,2334,0,0,2408,54,59
54,60,1187,0,284,284,0,1755,54,60
54,61,632,1724,69,415,0,2840,54,61
54,62,126,196,29,112,0,463,54,62
54,63,137,739,83,59,0,1018,54,63
54,64,300,0,261,308,0,869,54,64
54,65,116,0,374,0,0,490,54,65
54,66,52,0,105,0,0,157,54,66
54,67,66,0,60,161,0,287,54,67
54,68,74,0,276,0,0,350,54,68
54,69,110,0,87,211,0,408,54,69
54,70,118,0,37,78,0,233,54,70
54,71,153,0,15,0,53,221,54,71
54,72,61,0,66,0,0,127,54,72
54,73,0,0,122,0,0,122,54,73
54,74,0,0,85,0,0,85,54,74
54,75,0,0,153,0,0,153,54,75
54,76,114,0,0,38,0,152,54,76
54,77,14,0,177,0,0,191,54,77
54,78,88,0,173,0,0,261,54,78
54,79,313,0,0,14,0,327,54,79
54,80,37,0,0,0,0,37,54,80
54,81,56,0,97,56,0,209,54,81
54,82,37,0,0,0,0,37,54,82
54,83,37,0,117,0,0,154,54,83
54,85,0,0,35,0,0,35,54,85
54,87,0,0,142,0,0,142,54,87
54,88,391,0,0,0,0,391,54,88
54,90,14,0,0,0,0,14,54,90
54,91,0,0,0,37,0,37,54,91
54,92,0,0,18,0,0,18,54,92
54,93,40,0,14,0,0,54,54,93
54,94,0,0,35,0,0,35,54,94
54,95,37,0,75,0,0,112,54,95
54,96,0,0,59,66,0,125,54,96
54,97,35,0,0,0,0,35,54,97
54,100,294,0,37,0,0,331,54,100
54,101,37,0,0,0,0,37,54,101
54,102,0,0,97,0,0,97,54,102
54,103,10,0,18,0,0,28,54,103
54,105,50,0,242,0,0,292,54,105
54,107,37,0,0,0,0,37,54,107
54,116,0,0,599,0,0,599,54,116
54,119,541,0,0,0,0,541,54,119
54,123,0,0,706,0,0,706,54,123
54,127,37,0,0,0,0,37,54,127
54,128,0,0,10,0,0,10,54,128
54,131,0,0,15,0,0,15,54,131
54,132,14,0,0,0,0,14,54,132
54,133,0,0,229,0,0,229,54,133
54,136,0,0,497,0,0,497,54,136
54,137,0,0,497,0,0,497,54,137
54,141,0,0,792,0,0,792,54,141
54,144,37,0,0,0,0,37,54,144
54,145,0,0,29,0,0,29,54,145
54,148,0,0,30,0,0,30,54,148
54,154,0,0,226,0,0,226,54,154
54,157,0,0,154,0,0,154,54,157
54,158,524,0,0,0,0,524,54,158
54,166,63,0,0,0,0,63,54,166
54,167,416,0,0,0,0,416,54,167
54,176,66,0,0,0,0,66,54,176
54,180,66,0,71,0,0,137,54,180
54,181,14,0,0,0,0,14,54,181
54,189,269,0,0,0,0,269,54,189
54,196,0,0,239,0,0,239,54,196
54,203,0,0,429,0,0,429,54,203
54,207,0,0,878,0,0,878,54,207
54,213,0,0,396,0,0,396,54,213
54,216,0,0,168,0,0,168,54,216
54,217,0,0,341,0,0,341,54,217
54,226,0,0,349,0,0,349,54,226
54,236,112,0,122,0,0,234,54,236
54,237,51,0,51,0,0,102,54,237
54,238,172,0,0,0,0,172,54,238
54,239,146,0,157,0,0,303,54,239
54,240,37,0,0,0,0,37,54,240
54,244,0,0,0,337,0,337,54,244
54,245,0,0,255,0,0,255,54,245
54,246,0,0,1269,372,0,1641,54,246
54,247,563,0,0,0,0,563,54,247
54,250,23,0,118,396,0,537,54,250
54,251,0,0,618,0,0,618,54,251
54,252,11,0,137,0,0,148,54,252
54,253,0,0,22,0,0,22,54,253
54,254,14,0,0,0,0,14,54,254
54,256,93,0,0,0,0,93,54,256
54,259,0,0,463,0,0,463,54,259
54,260,0,0,282,0,0,282,54,260
54,262,661,0,1824,0,0,2485,54,262
54,264,1036,0,683,0,0,1719,54,264
54,268,36,0,0,0,0,36,54,268
54,269,165,0,28,0,0,193,54,269
54,271,0,0,0,37,0,37,54,271
54,272,0,0,148,0,0,148,54,272
54,273,0,0,1006,0,0,1006,54,273
54,274,1056,0,92,0,0,1148,54,274
54,275,14,0,443,0,0,457,54,275
54,276,1660,0,2357,0,0,4017,54,276
54,277,627,0,0,0,0,627,54,277
54,278,251,0,172,0,0,423,54,278
54,279,1573,0,0,0,0,1573,54,279
54,281,0,0,220,0,0,220,54,281
54,282,0,0,30,0,0,30,54,282
54,284,353,0,0,0,0,353,54,284
54,286,37,0,0,0,0,37,54,286
54,288,0,0,573,0,0,573,54,288
54,289,0,0,446,0,0,446,54,289
54,295,0,0,349,0,0,349,54,295
54,296,0,0,16,0,0,16,54,296
54,298,0,0,853,0,0,853,54,298
54,300,0,0,40,0,0,40,54,300
54,301,0,0,15,0,0,15,54,301
54,302,37,0,673,0,0,710,54,302
54,303,0,0,40,0,0,40,54,303
54,304,0,0,912,0,848,1760,54,304
54,305,0,0,220,0,0,220,54,305
54,307,0,0,325,0,0,325,54,307
54,309,0,0,166,0,0,166,54,309
54,310,0,0,278,0,0,278,54,310
54,311,0,0,462,0,0,462,54,311
54,314,0,0,899,0,0,899,54,314
54,315,0,0,350,0,0,350,54,315
54,316,72,0,0,0,0,72,54,316
54,317,37,0,0,0,0,37,54,317
54,318,0,0,101,0,0,101,54,318
54,319,186,0,0,42,0,228,54,319
54,325,0,0,37,0,0,37,54,325
54,327,37,0,0,0,0,37,54,327
54,329,37,0,0,0,0,37,54,329
54,331,114,0,0,503,0,617,54,331
54,336,0,0,194,0,0,194,54,336
54,337,508,0,0,0,0,508,54,337
54,338,0,0,14,0,0,14,54,338
54,339,14,0,14,0,0,28,54,339
54,342,0,0,0,558,0,558,54,342
55,3,0,0,168,0,0,168,55,3
55,4,0,0,0,72,0,72,55,4
55,5,0,0,72,0,0,72,55,5
55,6,0,0,168,0,0,168,55,6
55,9,0,0,168,0,0,168,55,9
55,11,0,0,45,0,0,45,55,11
55,19,161,0,0,712,0,873,55,19
55,21,690,111,0,949,0,1750,55,21
55,24,128,0,0,72,0,200,55,24
55,26,0,0,102,0,0,102,55,26
55,27,60,0,263,0,256,579,55,27
55,28,0,0,201,0,0,201,55,28
55,29,0,0,434,0,0,434,55,29
55,30,117,0,0,72,0,189,55,30
55,31,168,0,396,0,0,564,55,31
55,32,261,0,53,0,0,314,55,32
55,33,22,0,0,0,0,22,55,33
55,35,56,0,0,0,0,56,55,35
55,37,0,0,186,0,0,186,55,37
55,43,168,0,0,0,0,168,55,43
55,44,56,0,217,0,0,273,55,44
55,49,0,146,48,212,0,406,55,49
55,50,0,0,32,0,0,32,55,50
55,51,208,366,84,104,0,762,55,51
55,52,552,185,0,0,0,737,55,52
55,53,1137,1051,72,0,0,2260,55,53
55,54,673,1369,0,37,0,2079,55,54
55,55,0,957,0,0,0,957,55,55
55,56,1375,1158,239,36,0,2808,55,56
55,57,497,297,230,240,0,1264,55,57
55,58,336,0,387,0,0,723,55,58
55,59,422,0,561,138,0,1121,55,59
55,60,936,0,0,190,0,1126,55,60
55,61,761,498,0,72,0,1331,55,61
55,62,53,307,183,0,0,543,55,62
55,63,57,0,0,0,0,57,55,63
55,64,0,0,438,120,0,558,55,64
55,65,11,0,0,0,0,11,55,65
55,66,0,0,80,0,0,80,55,66
55,67,251,0,0,0,0,251,55,67
55,68,168,0,311,0,0,479,55,68
55,69,75,0,214,0,0,289,55,69
55,70,211,0,0,0,0,211,55,70
55,71,0,0,0,95,0,95,55,71
55,72,89,0,0,0,0,89,55,72
55,75,0,0,0,35,0,35,55,75
55,77,0,0,238,0,0,238,55,77
55,78,480,0,61,0,0,541,55,78
55,79,0,0,72,0,0,72,55,79
55,80,0,0,541,0,64,605,55,80
55,81,0,0,0,46,0,46,55,81
55,82,0,0,541,0,0,541,55,82
55,83,0,0,196,0,0,196,55,83
55,84,98,0,0,0,0,98,55,84
55,85,0,0,0,20,0,20,55,85
55,86,20,0,0,0,0,20,55,86
55,87,0,0,436,0,0,436,55,87
55,88,0,0,125,0,0,125,55,88
55,91,0,0,192,0,0,192,55,91
55,93,0,0,28,0,0,28,55,93
55,94,168,0,35,0,0,203,55,94
55,95,102,0,0,0,0,102,55,95
55,96,66,0,0,0,0,66,55,96
55,100,126,0,126,0,0,252,55,100
55,102,49,0,128,0,0,177,55,102
55,104,21,0,0,0,0,21,55,104
55,115,0,0,462,0,0,462,55,115
55,117,1431,0,0,0,0,1431,55,117
55,125,21,0,0,0,0,21,55,125
55,126,100,0,0,0,0,100,55,126
55,128,38,0,0,0,0,38,55,128
55,129,58,0,0,0,0,58,55,129
55,130,0,0,6,0,0,6,55,130
55,144,824,0,0,0,0,824,55,144
55,145,0,0,31,0,0,31,55,145
55,161,0,0,270,0,0,270,55,161
55,169,202,0,0,0,0,202,55,169
55,196,168,0,0,0,0,168,55,196
55,202,47,0,0,0,0,47,55,202
55,203,0,0,249,0,0,249,55,203
55,210,117,0,97,0,0,214,55,210
55,215,0,0,285,0,0,285,55,215
55,221,0,0,671,0,0,671,55,221
55,223,0,0,130,0,0,130,55,223
55,237,0,0,217,0,0,217,55,237
55,239,0,0,514,0,0,514,55,239
55,243,0,0,275,0,0,275,55,243
55,244,0,0,829,0,0,829,55,244
55,250,87,0,0,0,0,87,55,250
55,254,0,0,0,1312,0,1312,55,254
55,257,0,0,633,0,0,633,55,257
55,264,0,0,518,0,0,518,55,264
55,265,114,0,343,0,0,457,55,265
55,268,0,0,40,0,0,40,55,268
55,270,0,0,59,0,0,59,55,270
55,273,1379,0,0,0,0,1379,55,273
55,274,196,0,0,0,0,196,55,274
55,275,168,0,0,0,0,168,55,275
55,276,0,0,0,601,0,601,55,276
55,279,0,0,299,0,0,299,55,279
55,284,72,0,602,0,0,674,55,284
55,295,0,0,321,0,0,321,55,295
55,296,0,0,16,0,0,16,55,296
55,299,0,0,96,0,0,96,55,299
55,300,168,0,0,0,0,168,55,300
55,301,168,0,0,0,0,168,55,301
55,303,0,0,139,0,0,139,55,303
55,305,0,0,220,0,0,220,55,305
55,316,0,0,173,0,0,173,55,316
55,319,203,0,12,0,0,215,55,319
55,320,72,0,299,0,0,371,55,320
55,321,210,0,0,0,0,210,55,321
55,327,38,0,35,0,0,73,55,327
55,335,0,0,305,0,0,305,55,335
55,336,179,0,0,0,0,179,55,336
55,339,0,0,128,0,0,128,55,339
55,342,0,0,287,0,0,287,55,342
56,1,0,0,148,0,0,148,56,1
56,2,0,381,0,0,0,381,56,2
56,4,0,0,0,453,0,453,56,4
56,5,1250,0,148,107,0,1505,56,5
56,6,0,0,542,0,0,542,56,6
56,7,0,0,440,0,0,440,56,7
56,9,92,0,107,0,0,199,56,9
56,14,296,0,0,0,0,296,56,14
56,17,0,0,107,0,0,107,56,17
56,18,169,0,0,167,0,336,56,18
56,19,38,226,0,128,0,392,56,19
56,20,0,0,154,0,0,154,56,20
56,21,420,121,0,0,0,541,56,21
56,22,690,402,0,63,0,1155,56,22
56,23,63,0,199,0,0,262,56,23
56,24,0,0,60,0,0,60,56,24
56,26,0,0,161,0,0,161,56,26
56,27,254,0,82,676,0,1012,56,27
56,28,64,0,293,0,0,357,56,28
56,29,83,0,461,0,0,544,56,29
56,30,272,0,0,0,0,272,56,30
56,31,119,0,572,0,0,691,56,31
56,32,76,0,338,0,0,414,56,32
56,33,0,0,17,6,0,23,56,33
56,34,68,0,57,0,0,125,56,34
56,36,0,0,398,0,0,398,56,36
56,37,18,0,0,0,0,18,56,37
56,43,83,0,0,0,0,83,56,43
56,45,148,0,240,0,0,388,56,45
56,48,0,0,0,0,359,359,56,48
56,49,650,1817,35,99,0,2601,56,49
56,50,221,0,0,99,0,320,56,50
56,51,277,493,0,248,0,1018,56,51
56,52,521,0,228,268,0,1017,56,52
56,53,536,594,652,0,0,1782,56,53
56,54,89,1049,435,74,0,1647,56,54
56,55,689,1319,161,596,0,2765,56,55
56,56,1889,8464,0,0,0,10353,56,56
56,57,441,2691,212,2358,0,5702,56,57
56,58,0,408,454,381,0,1243,56,58
56,59,0,0,413,107,0,520,56,59
56,60,0,0,338,0,0,338,56,60
56,61,528,152,31,0,0,711,56,61
56,62,238,674,0,0,0,912,56,62
56,63,51,0,6,107,0,164,56,63
56,64,268,0,131,0,0,399,56,64
56,66,116,0,0,0,0,116,56,66
56,68,255,0,90,0,0,345,56,68
56,69,0,0,38,0,0,38,56,69
56,70,84,0,0,0,0,84,56,70
56,72,0,0,0,0,256,256,56,72
56,73,379,0,554,0,0,933,56,73
56,74,0,0,496,0,0,496,56,74
56,75,56,0,38,276,81,451,56,75
56,76,283,104,161,143,0,691,56,76
56,77,0,0,38,0,215,253,56,77
56,79,0,0,123,0,0,123,56,79
56,80,0,0,178,0,0,178,56,80
56,82,83,0,89,148,0,320,56,82
56,83,0,0,231,0,0,231,56,83
56,84,0,0,51,0,0,51,56,84
56,86,0,0,45,32,0,77,56,86
56,88,0,0,101,0,0,101,56,88
56,89,48,0,0,0,0,48,56,89
56,91,35,0,173,0,0,208,56,91
56,92,0,0,148,0,0,148,56,92
56,93,381,0,0,0,0,381,56,93
56,94,35,0,0,0,0,35,56,94
56,95,0,0,0,75,0,75,56,95
56,100,0,0,126,0,0,126,56,100
56,102,0,0,83,0,0,83,56,102
56,103,10,0,10,0,0,20,56,103
56,104,0,0,53,0,0,53,56,104
56,107,0,0,99,0,0,99,56,107
56,123,0,0,713,0,0,713,56,123
56,127,838,0,320,0,0,1158,56,127
56,129,0,0,22,0,0,22,56,129
56,133,162,0,517,0,0,679,56,133
56,137,0,0,0,83,0,83,56,137
56,152,0,0,375,0,0,375,56,152
56,167,73,0,0,0,0,73,56,167
56,169,76,0,0,0,0,76,56,169
56,171,0,0,572,0,0,572,56,171
56,172,0,0,238,0,0,238,56,172
56,174,0,0,357,0,0,357,56,174
56,180,0,0,546,0,0,546,56,180
56,223,0,0,274,0,0,274,56,223
56,234,1199,0,0,0,0,1199,56,234
56,237,111,0,0,0,0,111,56,237
56,238,0,0,78,0,0,78,56,238
56,239,0,0,536,0,0,536,56,239
56,240,761,0,0,0,0,761,56,240
56,241,61,0,0,0,0,61,56,241
56,242,0,0,339,0,0,339,56,242
56,243,0,0,275,0,0,275,56,243
56,245,176,0,0,0,0,176,56,245
56,251,200,0,200,0,0,400,56,251
56,256,0,0,0,148,0,148,56,256
56,260,0,0,458,0,0,458,56,260
56,268,0,148,0,0,0,148,56,268
56,269,0,0,0,379,0,379,56,269
56,271,0,0,0,148,0,148,56,271
56,274,0,0,437,0,0,437,56,274
56,275,0,0,148,0,0,148,56,275
56,276,0,0,627,0,0,627,56,276
56,278,0,0,1207,0,0,1207,56,278
56,280,0,0,484,0,0,484,56,280
56,282,0,0,253,0,0,253,56,282
56,283,0,0,65,110,0,175,56,283
56,285,0,0,1133,0,0,1133,56,285
56,292,0,0,1475,0,0,1475,56,292
56,296,0,0,301,0,0,301,56,296
56,298,0,0,584,0,0,584,56,298
56,300,1051,0,0,0,0,1051,56,300
56,305,0,0,1030,0,0,1030,56,305
56,311,0,0,462,0,0,462,56,311
56,312,0,0,281,0,0,281,56,312
56,315,0,0,699,0,0,699,56,315
56,316,0,0,0,94,0,94,56,316
56,319,0,0,0,11,0,11,56,319
56,320,226,0,0,0,0,226,56,320
56,321,111,0,0,95,0,206,56,321
56,327,22,0,35,0,0,57,56,327
56,329,355,0,0,0,0,355,56,329
56,331,0,0,503,0,0,503,56,331
56,339,0,0,166,0,0,166,56,339
56,340,0,0,74,0,0,74,56,340
57,1,0,0,425,0,0,425,57,1
57,2,0,0,171,0,0,171,57,2
57,3,165,0,199,240,0,604,57,3
57,4,0,0,248,447,0,695,57,4
57,5,173,0,521,155,0,849,57,5
57,7,155,0,0,0,0,155,57,7
57,9,0,0,30,0,0,30,57,9
57,14,0,0,37,0,0,37,57,14
57,16,0,0,126,0,0,126,57,16
57,19,0,0,130,0,0,130,57,19
57,20,254,0,1037,0,0,1291,57,20
57,21,119,0,0,0,0,119,57,21
57,22,1018,197,0,0,0,1215,57,22
57,23,0,29,0,155,0,184,57,23
57,24,183,0,0,88,76,347,57,24
57,25,0,481,717,0,0,1198,57,25
57,26,493,340,89,0,0,922,57,26
57,27,641,3005,0,183,0,3829,57,27
57,28,26,1470,210,697,0,2403,57,28
57,29,138,0,419,0,0,557,57,29
57,30,64,0,119,64,0,247,57,30
57,31,594,0,823,0,0,1417,57,31
57,32,91,213,98,0,0,402,57,32
57,34,0,0,0,39,0,39,57,34
57,35,120,0,75,0,0,195,57,35
57,36,510,0,619,0,0,1129,57,36
57,37,0,0,0,0,225,225,57,37
57,38,0,0,62,0,0,62,57,38
57,40,0,0,46,0,0,46,57,40
57,43,0,0,355,0,0,355,57,43
57,44,0,0,0,72,0,72,57,44
57,45,75,0,156,0,0,231,57,45
57,48,0,0,157,0,0,157,57,48
57,49,904,608,0,80,0,1592,57,49
57,51,75,0,318,0,0,393,57,51
57,52,276,61,435,0,0,772,57,52
57,53,45,0,75,0,0,120,57,53
57,54,0,0,0,44,0,44,57,54
57,55,794,75,183,168,256,1476,57,55
57,56,441,2620,212,1977,0,5250,57,56
57,57,3830,14799,338,530,0,19497,57,57
57,58,0,63,324,0,0,387,57,58
57,59,41,0,313,0,0,354,57,59
57,60,0,0,102,205,0,307,57,60
57,61,0,0,852,309,0,1161,57,61
57,62,762,1280,169,0,78,2289,57,62
57,63,11,0,0,0,0,11,57,63
57,65,347,0,126,282,0,755,57,65
57,66,58,0,143,0,0,201,57,66
57,68,479,0,63,0,0,542,57,68
57,69,348,0,87,0,0,435,57,69
57,71,131,0,210,514,0,855,57,71
57,73,339,0,416,0,0,755,57,73
57,74,872,1628,215,239,284,3238,57,74
57,75,615,952,38,112,0,1717,57,75
57,76,410,644,0,0,0,1054,57,76
57,77,497,0,0,0,0,497,57,77
57,78,50,102,182,248,0,582,57,78
57,79,330,387,505,193,0,1415,57,79
57,80,0,0,263,0,0,263,57,80
57,81,201,0,63,62,0,326,57,81
57,82,230,0,218,0,0,448,57,82
57,83,0,0,96,0,0,96,57,83
57,84,90,0,284,311,74,759,57,84
57,85,0,0,17,0,0,17,57,85
57,86,0,0,45,0,0,45,57,86
57,87,0,0,256,97,0,353,57,87
57,88,276,0,0,253,0,529,57,88
57,89,96,0,0,0,0,96,57,89
57,91,0,0,156,0,0,156,57,91
57,93,155,0,0,0,0,155,57,93
57,95,102,0,0,0,0,102,57,95
57,96,155,0,155,0,0,310,57,96
57,99,58,0,96,0,0,154,57,99
57,103,10,0,0,0,0,10,57,103
57,104,0,0,9,0,0,9,57,104
57,107,0,0,293,99,0,392,57,107
57,108,0,0,56,0,0,56,57,108
57,109,158,0,0,0,0,158,57,109
57,112,0,0,434,0,0,434,57,112
57,118,129,0,0,0,0,129,57,118
57,121,0,0,666,0,0,666,57,121
57,127,360,0,360,137,0,857,57,127
57,129,155,0,0,0,0,155,57,129
57,131,0,0,120,0,0,120,57,131
57,133,162,0,0,90,0,252,57,133
57,134,994,0,0,0,0,994,57,134
57,138,24,0,0,0,0,24,57,138
57,140,0,0,166,0,0,166,57,140
57,141,0,0,578,0,0,578,57,141
57,144,0,0,994,0,0,994,57,144
57,152,498,0,0,0,0,498,57,152
57,154,0,0,226,0,0,226,57,154
57,161,0,0,307,0,0,307,57,161
57,167,0,0,115,0,0,115,57,167
57,168,0,0,204,0,0,204,57,168
57,180,0,0,752,0,0,752,57,180
57,188,0,0,113,0,0,113,57,188
57,190,0,0,244,0,0,244,57,190
57,192,0,0,383,0,0,383,57,192
57,197,0,0,174,0,0,174,57,197
57,205,0,0,788,0,0,788,57,205
57,208,210,0,0,0,0,210,57,208
57,227,0,0,155,0,0,155,57,227
57,229,365,0,0,0,0,365,57,229
57,233,0,0,311,0,0,311,57,233
57,236,0,0,155,0,0,155,57,236
57,237,0,0,51,0,0,51,57,237
57,238,0,0,270,213,0,483,57,238
57,239,110,0,61,0,0,171,57,239
57,240,621,0,131,0,0,752,57,240
57,241,53,0,227,0,0,280,57,241
57,243,0,0,56,0,0,56,57,243
57,244,0,0,337,0,0,337,57,244
57,245,0,0,255,0,0,255,57,245
57,246,114,0,113,0,0,227,57,246
57,250,0,0,359,0,0,359,57,250
57,251,400,0,0,0,0,400,57,251
57,252,62,0,0,0,0,62,57,252
57,253,0,0,24,0,0,24,57,253
57,254,0,0,155,0,0,155,57,254
57,255,1391,0,0,0,0,1391,57,255
57,264,0,0,613,0,0,613,57,264
57,267,0,0,153,0,0,153,57,267
57,268,121,0,0,148,0,269,57,268
57,269,0,0,271,0,0,271,57,269
57,272,38,0,0,0,0,38,57,272
57,274,196,0,0,0,0,196,57,274
57,275,155,0,0,0,0,155,57,275
57,276,0,0,627,0,0,627,57,276
57,277,0,0,276,0,0,276,57,277
57,281,155,0,0,0,0,155,57,281
57,285,0,0,1395,0,0,1395,57,285
57,287,0,0,128,0,0,128,57,287
57,289,0,0,386,0,0,386,57,289
57,290,143,0,0,0,0,143,57,290
57,291,0,0,1277,0,0,1277,57,291
57,292,0,0,192,0,0,192,57,292
57,298,0,0,1162,0,0,1162,57,298
57,300,75,0,730,155,0,960,57,300
57,301,195,0,0,0,0,195,57,301
57,302,0,0,75,0,0,75,57,302
57,303,0,0,1653,0,0,1653,57,303
57,304,0,0,636,0,0,636,57,304
57,305,202,0,1234,0,0,1436,57,305
57,314,0,0,978,0,0,978,57,314
57,316,72,0,0,0,0,72,57,316
57,319,29,0,0,0,0,29,57,319
57,320,0,0,299,0,0,299,57,320
57,321,0,0,406,0,0,406,57,321
57,322,77,0,0,0,0,77,57,322
57,326,313,0,419,0,0,732,57,326
57,327,99,0,0,28,0,127,57,327
57,329,217,0,127,0,0,344,57,329
57,334,0,0,88,0,0,88,57,334
57,336,683,0,0,0,0,683,57,336
57,339,177,0,63,0,0,240,57,339
57,340,0,0,21,0,0,21,57,340
58,1,0,0,500,0,0,500,58,1
58,2,100,0,615,0,0,715,58,2
58,3,0,0,200,0,0,200,58,3
58,4,0,0,455,0,0,455,58,4
58,5,0,0,100,0,0,100,58,5
58,7,37,0,0,0,0,37,58,7
58,9,0,0,92,0,0,92,58,9
58,18,100,0,0,0,0,100,58,18
58,19,674,0,0,100,0,774,58,19
58,21,100,0,0,0,0,100,58,21
58,22,77,0,178,0,0,255,58,22
58,23,309,0,0,0,0,309,58,23
58,24,0,0,97,0,0,97,58,24
58,25,0,0,379,0,0,379,58,25
58,26,0,0,127,0,0,127,58,26
58,27,0,0,46,0,0,46,58,27
58,28,22,0,53,0,0,75,58,28
58,29,100,0,0,0,0,100,58,29
58,30,0,0,100,0,0,100,58,30
58,31,0,0,100,0,0,100,58,31
58,33,15,0,0,0,0,15,58,33
58,36,0,0,100,0,0,100,58,36
58,41,0,0,63,0,0,63,58,41
58,43,0,0,297,0,0,297,58,43
58,44,0,0,671,0,0,671,58,44
58,47,97,0,0,0,0,97,58,47
58,49,50,0,226,108,0,384,58,49
58,51,352,0,201,0,0,553,58,51
58,52,0,306,229,0,0,535,58,52
58,53,306,1080,205,416,0,2007,58,53
58,54,0,945,524,0,0,1469,58,54
58,55,336,0,249,0,0,585,58,55
58,56,0,556,612,381,0,1549,58,56
58,57,127,63,197,0,0,387,58,57
58,58,800,5769,0,0,0,6569,58,58
58,59,885,1545,1226,0,0,3656,58,59
58,60,200,97,701,468,0,1466,58,60
58,61,664,1989,1032,590,0,4275,58,61
58,62,197,0,29,0,0,226,58,62
58,63,0,0,19,0,0,19,58,63
58,64,240,0,0,100,0,340,58,64
58,65,116,0,0,0,0,116,58,65
58,66,100,0,0,0,0,100,58,66
58,68,97,0,127,0,0,224,58,68
58,70,184,0,0,0,0,184,58,70
58,71,0,0,145,0,0,145,58,71
58,72,100,0,333,0,0,433,58,72
58,73,387,0,0,0,0,387,58,73
58,74,100,0,695,0,0,795,58,74
58,75,126,0,0,0,0,126,58,75
58,77,0,0,331,0,0,331,58,77
58,78,10,0,88,0,0,98,58,78
58,79,0,0,406,0,0,406,58,79
58,80,0,0,100,0,0,100,58,80
58,82,127,0,200,0,0,327,58,82
58,84,0,0,306,0,0,306,58,84
58,86,18,0,0,0,0,18,58,86
58,90,0,0,100,0,0,100,58,90
58,94,100,0,0,0,0,100,58,94
58,96,0,0,284,0,0,284,58,96
58,101,508,0,0,0,0,508,58,101
58,104,0,0,21,0,0,21,58,104
58,106,93,0,0,0,0,93,58,106
58,116,127,0,0,0,0,127,58,116
58,129,0,0,640,0,0,640,58,129
58,131,0,0,306,0,0,306,58,131
58,150,0,0,460,0,0,460,58,150
58,160,78,0,0,0,0,78,58,160
58,165,0,0,100,0,0,100,58,165
58,166,0,0,100,0,0,100,58,166
58,167,0,0,389,0,0,389,58,167
58,169,0,0,100,0,0,100,58,169
58,181,0,0,1264,0,0,1264,58,181
58,201,0,0,372,0,0,372,58,201
58,202,0,0,754,0,0,754,58,202
58,217,0,0,241,0,0,241,58,217
58,238,100,0,0,0,0,100,58,238
58,239,41,0,0,0,0,41,58,239
58,240,97,0,0,0,0,97,58,240
58,241,0,0,109,0,0,109,58,241
58,245,0,0,389,0,0,389,58,245
58,246,100,0,0,114,0,214,58,246
58,249,0,0,620,0,0,620,58,249
58,250,658,783,0,0,145,1586,58,250
58,252,247,200,331,0,0,778,58,252
58,261,0,0,292,0,0,292,58,261
58,269,0,0,109,0,0,109,58,269
58,273,100,0,0,0,0,100,58,273
58,275,0,0,325,0,0,325,58,275
58,276,0,0,389,0,0,389,58,276
58,277,155,0,0,0,0,155,58,277
58,278,395,0,1015,0,0,1410,58,278
58,283,0,0,32,0,0,32,58,283
58,293,0,0,526,0,0,526,58,293
58,300,0,0,306,0,0,306,58,300
58,301,175,0,0,0,0,175,58,301
58,309,0,0,166,0,0,166,58,309
58,315,0,0,202,0,0,202,58,315
58,316,306,0,0,0,0,306,58,316
58,317,0,0,0,14,0,14,58,317
58,327,27,0,27,0,0,54,58,327
58,328,122,0,0,0,0,122,58,328
58,339,127,0,0,0,0,127,58,339
59,1,0,0,317,393,0,710,59,1
59,2,267,0,1213,0,0,1480,59,2
59,3,0,0,789,0,0,789,59,3
59,5,0,0,257,0,0,257,59,5
59,7,234,0,1158,0,0,1392,59,7
59,9,0,0,1213,0,0,1213,59,9
59,19,146,0,0,0,0,146,59,19
59,20,0,0,0,151,0,151,59,20
59,21,551,0,0,0,0,551,59,21
59,22,0,0,882,0,0,882,59,22
59,23,0,0,1173,0,0,1173,59,23
59,24,0,0,523,0,0,523,59,24
59,27,165,0,0,46,0,211,59,27
59,28,0,0,419,0,0,419,59,28
59,29,0,0,660,0,0,660,59,29
59,30,0,0,105,0,0,105,59,30
59,31,0,0,936,0,0,936,59,31
59,32,0,0,647,0,0,647,59,32
59,36,0,0,607,0,0,607,59,36
59,43,0,0,393,0,0,393,59,43
59,45,0,0,607,0,0,607,59,45
59,48,0,0,904,0,0,904,59,48
59,49,0,0,1361,0,0,1361,59,49
59,50,0,0,134,0,0,134,59,50
59,51,208,0,0,0,0,208,59,51
59,53,58,0,2060,158,0,2276,59,53
59,54,37,37,927,0,0,1001,59,54
59,55,422,0,729,0,0,1151,59,55
59,56,0,0,255,107,0,362,59,56
59,57,0,0,313,0,0,313,59,57
59,58,885,1241,1265,0,0,3391,59,58
59,59,3207,38992,313,2186,0,44698,59,59
59,60,4092,2750,969,788,823,9422,59,60
59,61,1078,3343,188,544,0,5153,59,61
59,63,11,0,0,0,0,11,59,63
59,64,402,0,0,0,570,972,59,64
59,66,533,0,0,0,0,533,59,66
59,68,710,0,0,0,0,710,59,68
59,70,0,0,88,0,0,88,59,70
59,72,0,0,0,607,0,607,59,72
59,73,607,0,1053,0,0,1660,59,73
59,77,0,0,886,0,0,886,59,77
59,78,0,0,710,0,0,710,59,78
59,79,41,0,775,0,0,816,59,79
59,82,0,0,607,0,0,607,59,82
59,83,0,0,1597,0,0,1597,59,83
59,84,24,0,0,0,0,24,59,84
59,85,0,0,267,0,0,267,59,85
59,87,0,0,1606,0,0,1606,59,87
59,88,0,0,301,0,0,301,59,88
59,89,127,0,0,57,0,184,59,89
59,93,0,0,588,0,0,588,59,93
59,94,0,0,98,0,0,98,59,94
59,97,245,0,0,0,0,245,59,97
59,102,0,0,49,0,0,49,59,102
59,104,0,0,21,0,0,21,59,104
59,105,0,0,440,0,0,440,59,105
59,109,0,0,818,0,0,818,59,109
59,116,0,0,551,0,0,551,59,116
59,126,0,0,261,0,0,261,59,126
59,131,11,0,0,0,0,11,59,131
59,136,0,0,480,0,0,480,59,136
59,138,0,0,0,267,0,267,59,138
59,140,0,0,152,0,0,152,59,140
59,144,0,0,416,0,0,416,59,144
59,145,0,0,23,0,0,23,59,145
59,154,0,0,710,0,0,710,59,154
59,163,0,0,65,0,0,65,59,163
59,166,628,0,0,0,0,628,59,166
59,168,0,0,267,0,0,267,59,168
59,184,0,0,185,0,0,185,59,184
59,188,0,0,520,0,0,520,59,188
59,201,489,0,0,0,0,489,59,201
59,207,0,0,361,0,0,361,59,207
59,214,0,0,552,0,0,552,59,214
59,221,0,0,425,0,0,425,59,221
59,226,0,0,361,0,0,361,59,226
59,229,0,0,365,0,0,365,59,229
59,232,0,0,314,0,0,314,59,232
59,237,306,0,0,0,0,306,59,237
59,238,298,0,347,0,0,645,59,238
59,239,0,0,245,0,0,245,59,239
59,240,0,0,64,0,0,64,59,240
59,241,0,0,26,0,0,26,59,241
59,243,550,0,604,0,0,1154,59,243
59,244,0,0,1990,0,0,1990,59,244
59,245,254,0,0,0,0,254,59,245
59,246,0,0,641,0,0,641,59,246
59,247,1331,0,2981,0,0,4312,59,247
59,248,0,0,0,173,251,424,59,248
59,249,7356,0,1676,0,880,9912,59,249
59,250,592,771,0,854,0,2217,59,250
59,251,0,0,950,291,0,1241,59,251
59,252,237,0,743,0,0,980,59,252
59,254,0,0,248,0,0,248,59,254
59,256,0,0,138,0,0,138,59,256
59,266,0,0,75,0,0,75,59,266
59,269,168,0,0,0,0,168,59,269
59,270,292,0,83,0,0,375,59,270
59,272,293,0,148,0,114,555,59,272
59,273,436,0,0,0,0,436,59,273
59,274,0,0,1647,0,0,1647,59,274
59,275,0,0,3086,274,0,3360,59,275
59,276,627,0,2198,0,0,2825,59,276
59,277,244,0,0,0,0,244,59,277
59,278,215,0,804,251,0,1270,59,278
59,279,0,0,1437,0,0,1437,59,279
59,280,0,0,173,267,0,440,59,280
59,281,0,0,173,0,0,173,59,281
59,282,49,0,276,0,0,325,59,282
59,283,0,0,70,0,0,70,59,283
59,284,353,0,0,0,0,353,59,284
59,297,25,0,0,0,0,25,59,297
59,300,1141,0,0,0,0,1141,59,300
59,302,601,0,156,0,0,757,59,302
59,303,0,0,254,0,0,254,59,303
59,305,0,0,1901,0,0,1901,59,305
59,307,0,0,325,0,0,325,59,307
59,311,0,0,0,438,0,438,59,311
59,316,0,0,174,0,0,174,59,316
59,317,48,0,0,0,0,48,59,317
59,319,17,0,0,0,0,17,59,319
59,324,0,0,502,0,0,502,59,324
59,326,422,0,0,0,0,422,59,326
59,328,0,0,122,0,0,122,59,328
59,334,0,0,291,0,0,291,59,334
60,1,0,0,977,0,0,977,60,1
60,2,0,0,386,0,0,386,60,2
60,4,214,0,0,0,0,214,60,4
60,5,640,0,0,69,0,709,60,5
60,7,0,0,102,0,0,102,60,7
60,17,0,0,20,0,0,20,60,17
60,20,323,0,0,0,0,323,60,20
60,21,0,0,83,0,0,83,60,21
60,22,69,0,0,0,0,69,60,22
60,24,265,0,379,0,0,644,60,24
60,25,0,0,201,370,0,571,60,25
60,27,102,0,0,0,0,102,60,27
60,28,102,0,26,0,0,128,60,28
60,29,240,0,190,0,0,430,60,29
60,31,0,0,284,0,0,284,60,31
60,32,0,0,21,327,0,348,60,32
60,35,0,0,801,0,0,801,60,35
60,40,102,0,0,0,0,102,60,40
60,43,0,0,696,102,0,798,60,43
60,44,0,0,102,0,0,102,60,44
60,45,69,0,0,0,0,69,60,45
60,49,0,0,173,0,0,173,60,49
60,51,252,0,0,0,0,252,60,51
60,53,284,0,0,0,0,284,60,53
60,54,670,0,592,102,0,1364,60,54
60,55,833,0,190,0,0,1023,60,55
60,56,381,0,190,0,0,571,60,56
60,57,0,0,102,205,0,307,60,57
60,58,300,97,565,100,0,1062,60,58
60,59,5085,2750,660,788,823,10106,60,59
60,60,6928,4421,862,410,0,12621,60,60
60,61,1269,933,59,0,0,2261,60,61
60,62,194,0,0,0,0,194,60,62
60,63,23,0,0,0,0,23,60,63
60,64,1116,547,103,0,0,1766,60,64
60,65,340,0,0,118,0,458,60,65
60,66,788,102,309,0,0,1199,60,66
60,67,137,0,0,0,0,137,60,67
60,68,0,0,0,75,0,75,60,68
60,69,0,0,129,0,0,129,60,69
60,70,0,0,91,0,0,91,60,70
60,71,390,0,0,0,0,390,60,71
60,73,284,0,0,0,0,284,60,73
60,74,0,0,472,0,0,472,60,74
60,75,205,0,0,0,0,205,60,75
60,78,69,0,0,0,0,69,60,78
60,79,41,0,284,0,0,325,60,79
60,81,0,0,0,102,148,250,60,81
60,82,205,0,0,0,0,205,60,82
60,87,67,0,0,0,0,67,60,87
60,88,0,0,414,138,0,552,60,88
60,94,0,0,0,102,0,102,60,94
60,100,0,0,102,0,0,102,60,100
60,102,102,0,0,0,0,102,60,102
60,105,50,0,0,0,0,50,60,105
60,109,0,0,306,0,0,306,60,109
60,113,0,0,372,0,0,372,60,113
60,116,0,0,537,0,0,537,60,116
60,118,129,0,0,0,0,129,60,118
60,132,284,0,0,0,0,284,60,132
60,137,102,0,0,0,0,102,60,137
60,147,0,0,129,0,0,129,60,147
60,166,205,0,0,0,0,205,60,166
60,169,202,0,0,0,0,202,60,169
60,170,274,0,0,0,0,274,60,170
60,172,258,0,0,0,0,258,60,172
60,177,0,0,0,46,0,46,60,177
60,182,0,0,473,0,0,473,60,182
60,205,0,0,384,0,0,384,60,205
60,211,0,0,114,0,0,114,60,211
60,220,0,0,200,0,0,200,60,220
60,236,102,0,0,0,0,102,60,236
60,238,270,0,0,0,0,270,60,238
60,239,0,0,67,0,0,67,60,239
60,240,0,0,221,0,0,221,60,240
60,241,118,0,0,0,0,118,60,241
60,250,102,0,0,0,0,102,60,250
60,251,316,0,0,0,0,316,60,251
60,255,102,0,0,0,0,102,60,255
60,258,0,0,809,0,0,809,60,258
60,268,171,0,62,0,0,233,60,268
60,269,323,0,0,0,0,323,60,269
60,270,54,0,0,76,0,130,60,270
60,272,0,0,356,0,0,356,60,272
60,273,0,0,129,0,0,129,60,273
60,274,529,0,327,102,0,958,60,274
60,275,1040,804,967,0,0,2811,60,275
60,276,1198,0,300,1171,0,2669,60,276
60,277,0,0,102,0,0,102,60,277
60,278,356,0,0,228,0,584,60,278
60,281,318,0,111,0,0,429,60,281
60,282,0,0,709,0,0,709,60,282
60,283,0,0,99,0,0,99,60,283
60,285,0,0,533,0,0,533,60,285
60,287,102,0,0,0,0,102,60,287
60,293,0,0,1890,0,0,1890,60,293
60,294,69,0,0,0,0,69,60,294
60,298,0,0,272,0,0,272,60,298
60,300,671,0,0,0,0,671,60,300
60,301,183,0,0,0,0,183,60,301
60,305,202,0,331,0,0,533,60,305
60,311,0,0,831,0,0,831,60,311
60,318,103,0,0,0,0,103,60,318
60,319,102,0,0,0,0,102,60,319
60,331,0,0,229,0,0,229,60,331
60,337,132,0,0,0,0,132,60,337
60,339,354,0,0,0,0,354,60,339
60,342,373,0,0,0,0,373,60,342
61,1,415,0,586,0,0,1001,61,1
61,3,724,0,0,0,0,724,61,3
61,5,72,0,1429,0,0,1501,61,5
61,6,204,0,966,0,0,1170,61,6
61,7,0,0,312,0,0,312,61,7
61,11,0,0,22,0,0,22,61,11
61,19,0,0,552,0,0,552,61,19
61,21,165,0,0,321,0,486,61,21
61,22,0,67,96,0,0,163,61,22
61,24,181,0,827,0,0,1008,61,24
61,27,282,0,581,0,0,863,61,27
61,29,59,0,412,0,0,471,61,29
61,31,0,0,415,0,0,415,61,31
61,32,0,0,152,0,0,152,61,32
61,33,15,0,0,0,0,15,61,33
61,36,804,0,204,0,0,1008,61,36
61,41,0,0,121,0,0,121,61,41
61,45,0,0,83,0,0,83,61,45
61,49,0,0,345,0,0,345,61,49
61,50,300,0,0,0,0,300,61,50
61,51,274,0,0,0,0,274,61,51
61,52,0,0,415,0,0,415,61,52
61,53,1194,175,0,277,0,1646,61,53
61,54,952,1953,69,415,0,3389,61,54
61,55,0,485,138,72,0,695,61,55
61,56,1142,152,0,0,0,1294,61,56
61,57,0,0,975,309,0,1284,61,57
61,58,917,2293,1349,590,0,5149,61,58
61,59,1263,3161,188,544,0,5156,61,59
61,60,854,933,0,0,0,1787,61,60
61,61,0,8196,0,0,0,8196,61,61
61,62,217,0,0,0,0,217,61,62
61,63,11,0,0,0,0,11,61,63
61,64,1141,0,488,120,0,1749,61,64
61,65,116,0,121,0,0,237,61,65
61,66,619,0,0,0,0,619,61,66
61,68,304,0,0,30,0,334,61,68
61,73,193,0,514,122,0,829,61,73
61,74,513,0,562,0,0,1075,61,74
61,76,38,0,42,0,0,80,61,76
61,77,204,0,0,0,0,204,61,77
61,78,0,0,88,0,0,88,61,78
61,79,0,0,246,0,298,544,61,79
61,80,88,0,0,0,0,88,61,80
61,82,1219,0,33,0,0,1252,61,82
61,83,69,0,0,0,0,69,61,83
61,87,33,0,100,0,0,133,61,87
61,88,0,0,0,253,0,253,61,88
61,90,123,0,123,0,0,246,61,90
61,93,466,0,0,0,0,466,61,93
61,97,98,0,0,0,0,98,61,97
61,102,56,0,0,0,0,56,61,102
61,105,50,0,0,0,0,50,61,105
61,115,0,0,427,0,0,427,61,115
61,126,0,0,261,0,0,261,61,126
61,128,10,0,0,0,0,10,61,128
61,129,0,0,72,0,0,72,61,129
61,132,0,0,415,0,0,415,61,132
61,134,0,0,415,0,0,415,61,134
61,136,0,0,70,0,0,70,61,136
61,138,0,0,24,0,0,24,61,138
61,151,882,0,0,0,0,882,61,151
61,165,0,0,0,21,0,21,61,165
61,169,0,0,360,0,0,360,61,169
61,194,0,0,196,0,0,196,61,194
61,197,0,0,95,0,0,95,61,197
61,207,0,0,516,0,0,516,61,207
61,211,0,0,338,0,0,338,61,211
61,225,537,0,0,0,0,537,61,225
61,237,490,0,51,51,0,592,61,237
61,238,898,0,0,0,0,898,61,238
61,242,0,0,0,339,0,339,61,242
61,244,0,0,2470,0,0,2470,61,244
61,246,0,0,123,0,0,123,61,246
61,247,0,0,893,0,0,893,61,247
61,249,0,0,451,0,0,451,61,249
61,250,254,0,240,254,0,748,61,250
61,254,109,0,0,0,0,109,61,254
61,256,0,0,472,0,0,472,61,256
61,268,0,0,101,0,0,101,61,268
61,269,415,0,0,0,0,415,61,269
61,270,0,0,281,0,0,281,61,270
61,272,38,0,200,55,0,293,61,272
61,275,274,0,349,0,0,623,61,275
61,276,0,0,0,195,0,195,61,276
61,278,753,0,1132,0,0,1885,61,278
61,279,0,0,832,0,0,832,61,279
61,281,204,0,0,0,0,204,61,281
61,282,0,0,210,0,0,210,61,282
61,283,0,0,31,0,0,31,61,283
61,285,0,0,490,0,0,490,61,285
61,293,0,0,526,0,0,526,61,293
61,295,0,0,349,431,0,780,61,295
61,301,172,0,0,0,0,172,61,301
61,302,381,0,0,0,0,381,61,302
61,303,204,0,0,0,0,204,61,303
61,306,246,0,0,0,0,246,61,306
61,308,0,0,560,0,0,560,61,308
61,312,0,0,141,0,0,141,61,312
61,315,0,0,218,0,0,218,61,315
61,319,46,0,0,0,0,46,61,319
61,327,0,0,314,0,0,314,61,327
61,329,443,0,0,0,0,443,61,329
61,332,0,0,451,0,0,451,61,332
61,339,0,0,190,0,0,190,61,339
62,1,49,0,56,0,0,105,62,1
62,2,26,0,0,0,0,26,62,2
62,3,0,0,27,0,0,27,62,3
62,5,81,0,29,0,0,110,62,5
62,7,26,0,29,0,0,55,62,7
62,17,0,0,26,0,0,26,62,17
62,20,0,0,0,254,0,254,62,20
62,21,27,0,0,0,0,27,62,21
62,24,0,0,241,26,0,267,62,24
62,25,0,0,0,26,0,26,62,25
62,26,27,0,0,0,0,27,62,26
62,27,283,381,169,0,0,833,62,27
62,28,0,0,41,0,0,41,62,28
62,29,0,0,29,53,0,82,62,29
62,30,91,0,27,0,0,118,62,30
62,32,112,77,0,26,0,215,62,32
62,34,0,0,32,0,56,88,62,34
62,35,1623,0,292,0,0,1915,62,35
62,36,1054,0,0,0,0,1054,62,36
62,37,65,0,0,0,0,65,62,37
62,38,18,0,0,0,0,18,62,38
62,40,27,0,0,0,0,27,62,40
62,44,0,0,174,0,0,174,62,44
62,45,27,0,0,0,0,27,62,45
62,47,0,0,352,0,0,352,62,47
62,49,258,53,0,0,0,311,62,49
62,50,74,0,80,0,0,154,62,50
62,51,89,0,0,0,0,89,62,51
62,52,0,0,27,0,0,27,62,52
62,53,111,0,63,0,0,174,62,53
62,54,257,0,29,112,0,398,62,54
62,55,53,334,366,0,0,753,62,55
62,56,107,674,0,0,0,781,62,56
62,57,893,1333,0,0,78,2304,62,57
62,58,97,0,29,0,0,126,62,58
62,60,294,0,0,0,0,294,62,60
62,61,217,0,0,0,0,217,62,61
62,62,714,2078,0,0,0,2792,62,62
62,63,0,11,0,0,0,11,62,63
62,64,53,0,0,162,0,215,62,64
62,65,0,0,0,109,0,109,62,65
62,66,53,0,506,0,0,559,62,66
62,67,80,80,0,80,0,240,62,67
62,68,0,0,0,197,0,197,62,68
62,69,213,80,361,0,39,693,62,69
62,70,209,0,0,0,0,209,62,70
62,71,153,0,0,193,0,346,62,71
62,74,223,98,55,26,0,402,62,74
62,75,236,328,29,0,164,757,62,75
62,76,150,296,29,0,81,556,62,76
62,77,27,0,0,27,0,54,62,77
62,78,102,75,0,72,0,249,62,78
62,79,231,41,0,266,0,538,62,79
62,81,27,0,47,0,0,74,62,81
62,82,31,0,53,0,0,84,62,82
62,83,64,0,56,0,0,120,62,83
62,84,77,0,0,0,0,77,62,84
62,85,11,0,17,0,0,28,62,85
62,87,67,0,24,0,0,91,62,87
62,92,527,0,27,27,0,581,62,92
62,94,0,0,27,0,0,27,62,94
62,97,26,0,0,0,0,26,62,97
62,100,11,0,0,0,0,11,62,100
62,102,49,0,0,0,0,49,62,102
62,103,11,0,0,0,0,11,62,103
62,105,0,0,85,0,0,85,62,105
62,107,26,0,0,0,0,26,62,107
62,110,0,0,437,0,0,437,62,110
62,125,0,0,457,0,0,457,62,125
62,127,0,0,137,0,0,137,62,127
62,131,26,0,0,0,0,26,62,131
62,139,0,0,113,0,0,113,62,139
62,140,392,0,0,0,0,392,62,140
62,144,0,0,807,0,0,807,62,144
62,158,0,0,806,0,0,806,62,158
62,165,32,0,0,0,0,32,62,165
62,166,0,0,330,0,0,330,62,166
62,168,0,0,230,0,0,230,62,168
62,169,75,0,27,0,0,102,62,169
62,176,228,0,0,0,0,228,62,176
62,189,269,0,397,0,0,666,62,189
62,190,0,0,27,0,0,27,62,190
62,191,0,0,27,0,0,27,62,191
62,198,0,0,232,0,0,232,62,198
62,209,0,0,116,0,0,116,62,209
62,218,75,0,639,0,0,714,62,218
62,224,0,0,27,0,0,27,62,224
62,226,0,0,394,0,0,394,62,226
62,233,27,0,0,0,0,27,62,233
62,236,41,0,0,0,0,41,62,236
62,238,151,0,0,0,0,151,62,238
62,239,27,0,0,0,0,27,62,239
62,241,0,0,58,0,0,58,62,241
62,247,0,0,973,0,0,973,62,247
62,254,0,0,26,27,0,53,62,254
62,256,0,0,534,0,0,534,62,256
62,259,0,0,236,0,0,236,62,259
62,265,0,0,144,0,0,144,62,265
62,268,71,0,38,0,0,109,62,268
62,269,26,0,130,0,0,156,62,269
62,270,54,0,59,42,0,155,62,270
62,272,115,0,29,38,0,182,62,272
62,273,27,0,1520,0,0,1547,62,273
62,275,169,0,133,0,0,302,62,275
62,276,0,0,654,0,0,654,62,276
62,277,0,0,168,0,0,168,62,277
62,278,0,0,859,0,0,859,62,278
62,281,531,0,0,0,0,531,62,281
62,282,0,0,248,0,0,248,62,282
62,283,91,0,0,0,0,91,62,283
62,286,0,0,93,0,0,93,62,286
62,298,0,0,1255,0,0,1255,62,298
62,300,0,0,27,0,0,27,62,300
62,301,105,0,0,0,0,105,62,301
62,303,0,0,649,0,0,649,62,303
62,304,0,0,1985,0,0,1985,62,304
62,305,570,0,1014,0,0,1584,62,305
62,307,0,0,298,0,0,298,62,307
62,311,0,0,462,0,0,462,62,311
62,319,33,0,0,0,0,33,62,319
62,320,0,0,299,0,0,299,62,320
62,322,154,0,0,0,0,154,62,322
62,323,0,0,475,0,0,475,62,323
62,324,820,0,0,0,0,820,62,324
62,328,0,0,0,326,0,326,62,328
62,329,75,0,0,0,0,75,62,329
62,330,0,0,425,0,0,425,62,330
62,333,0,0,97,0,0,97,62,333
62,336,27,0,0,0,0,27,62,336
62,337,0,0,132,0,0,132,62,337
62,339,123,0,15,0,0,138,62,339
62,340,95,0,0,0,0,95,62,340
63,1,0,0,11,0,0,11,63,1
63,5,62,0,176,0,0,238,63,5
63,10,0,0,8,0,0,8,63,10
63,12,0,0,19,6,0,25,63,12
63,23,11,0,0,0,0,11,63,23
63,27,40,0,232,6,0,278,63,27
63,28,0,0,12,0,0,12,63,28
63,29,35,0,13,0,0,48,63,29
63,30,483,0,0,0,0,483,63,30
63,31,23,0,0,32,0,55,63,31
63,32,23,0,43,11,0,77,63,32
63,35,0,0,376,0,0,376,63,35
63,38,0,0,32,0,0,32,63,38
63,44,11,0,0,0,0,11,63,44
63,47,11,0,0,0,0,11,63,47
63,49,85,0,54,0,0,139,63,49
63,53,263,0,113,74,0,450,63,53
63,54,131,832,1061,23,0,2047,63,54
63,55,57,0,0,0,0,57,63,55
63,56,51,0,6,107,0,164,63,56
63,57,11,0,0,0,0,11,63,57
63,58,0,0,19,0,0,19,63,58
63,59,11,0,0,0,0,11,63,59
63,60,11,0,0,0,0,11,63,60
63,61,11,0,0,59,0,70,63,61
63,62,169,11,0,0,0,180,63,62
63,63,92,295,0,0,0,387,63,63
63,64,669,164,6,234,0,1073,63,64
63,65,334,109,0,23,101,567,63,65
63,66,102,656,59,11,0,828,63,66
63,67,34,216,0,0,0,250,63,67
63,68,127,0,132,0,33,292,63,68
63,69,187,0,0,24,0,211,63,69
63,70,179,0,12,0,0,191,63,70
63,71,25,0,0,542,0,567,63,71
63,72,23,0,0,0,17,40,63,72
63,73,58,0,35,0,0,93,63,73
63,75,23,0,0,0,0,23,63,75
63,77,26,0,518,0,0,544,63,77
63,79,23,0,0,0,0,23,63,79
63,80,11,0,196,0,0,207,63,80
63,81,50,0,0,0,0,50,63,81
63,82,11,0,0,0,0,11,63,82
63,83,73,0,0,0,0,73,63,83
63,84,0,0,13,12,0,25,63,84
63,86,64,0,0,0,0,64,63,86
63,87,6,0,0,0,0,6,63,87
63,91,0,0,0,10,0,10,63,91
63,92,0,0,4,0,0,4,63,92
63,93,23,0,0,0,0,23,63,93
63,94,73,0,0,0,0,73,63,94
63,95,6,0,0,0,0,6,63,95
63,96,76,0,73,0,0,149,63,96
63,104,21,0,0,0,0,21,63,104
63,109,0,0,158,0,0,158,63,109
63,110,0,0,454,0,0,454,63,110
63,116,0,0,584,0,0,584,63,116
63,118,0,0,129,0,0,129,63,118
63,129,0,0,90,0,0,90,63,129
63,133,0,0,456,0,0,456,63,133
63,134,0,0,211,0,0,211,63,134
63,135,0,0,81,0,0,81,63,135
63,137,0,0,618,0,0,618,63,137
63,147,584,0,0,0,0,584,63,147
63,153,0,0,89,0,0,89,63,153
63,162,6,0,0,0,0,6,63,162
63,163,0,0,621,0,0,621,63,163
63,164,0,0,35,0,0,35,63,164
63,166,0,0,25,0,0,25,63,166
63,167,0,0,318,0,0,318,63,167
63,182,0,0,389,0,0,389,63,182
63,189,0,0,223,0,0,223,63,189
63,193,0,0,278,0,0,278,63,193
63,215,0,0,234,6,0,240,63,215
63,225,0,0,134,0,0,134,63,225
63,228,0,0,1080,0,0,1080,63,228
63,229,0,0,365,0,0,365,63,229
63,230,12,0,0,0,0,12,63,230
63,234,726,0,0,0,0,726,63,234
63,237,109,0,0,0,0,109,63,237
63,238,0,0,12,0,0,12,63,238
63,239,11,0,0,0,0,11,63,239
63,240,11,0,0,0,0,11,63,240
63,244,6,0,532,0,0,538,63,244
63,247,0,0,1198,0,0,1198,63,247
63,251,0,0,0,219,0,219,63,251
63,255,927,0,0,0,0,927,63,255
63,256,102,0,0,0,0,102,63,256
63,269,0,0,214,0,0,214,63,269
63,270,80,0,0,0,0,80,63,270
63,272,136,0,0,0,0,136,63,272
63,273,857,0,0,0,0,857,63,273
63,274,641,0,0,0,0,641,63,274
63,275,11,0,169,0,0,180,63,275
63,277,155,0,0,0,0,155,63,277
63,278,11,0,405,0,0,416,63,278
63,282,0,0,1208,0,0,1208,63,282
63,283,0,0,0,59,0,59,63,283
63,285,0,0,533,0,0,533,63,285
63,287,11,0,0,238,0,249,63,287
63,288,0,0,147,0,0,147,63,288
63,291,0,0,270,0,0,270,63,291
63,298,35,0,0,0,0,35,63,298
63,300,52,0,34,0,0,86,63,300
63,301,11,0,12,0,0,23,63,301
63,302,85,0,0,0,0,85,63,302
63,303,31,0,29,0,0,60,63,303
63,305,370,0,71,0,0,441,63,305
63,307,0,0,712,0,0,712,63,307
63,308,0,0,440,0,0,440,63,308
63,309,0,0,332,0,0,332,63,309
63,311,0,0,477,0,0,477,63,311
63,313,0,0,108,0,0,108,63,313
63,317,22,0,0,0,0,22,63,317
63,318,0,0,0,103,0,103,63,318
63,320,0,0,0,274,0,274,63,320
63,323,0,0,306,0,0,306,63,323
63,329,0,0,0,11,0,11,63,329
63,333,0,0,147,0,0,147,63,333
63,339,0,0,13,0,0,13,63,339
63,340,37,0,13,0,0,50,63,340
64,1,0,0,95,0,0,95,64,1
64,2,274,0,0,0,0,274,64,2
64,3,0,0,189,0,0,189,64,3
64,4,0,0,193,0,0,193,64,4
64,5,120,0,0,0,0,120,64,5
64,6,120,0,0,120,0,240,64,6
64,7,0,0,120,0,0,120,64,7
64,8,0,0,167,0,0,167,64,8
64,12,156,0,0,0,0,156,64,12
64,17,95,0,0,0,0,95,64,17
64,21,128,0,0,0,0,128,64,21
64,23,215,0,344,120,0,679,64,23
64,24,369,0,1709,0,0,2078,64,24
64,26,309,0,0,0,0,309,64,26
64,27,119,0,65,0,0,184,64,27
64,28,55,0,41,120,0,216,64,28
64,29,297,0,0,0,0,297,64,29
64,30,274,0,154,64,0,492,64,30
64,31,654,0,599,0,0,1253,64,31
64,34,240,0,42,0,0,282,64,34
64,37,120,0,0,0,0,120,64,37
64,40,37,0,18,0,0,55,64,40
64,43,0,0,106,0,0,106,64,43
64,45,216,0,0,120,0,336,64,45
64,47,107,0,0,0,0,107,64,47
64,49,322,0,0,0,0,322,64,49
64,50,0,0,38,0,0,38,64,50
64,52,0,0,131,0,0,131,64,52
64,53,305,0,63,0,0,368,64,53
64,54,420,0,751,428,0,1599,64,54
64,55,0,0,438,248,0,686,64,55
64,56,375,0,131,0,0,506,64,56
64,58,240,0,0,0,0,240,64,58
64,59,563,0,0,0,570,1133,64,59
64,60,1330,547,103,0,0,1980,64,60
64,61,1250,0,207,120,0,1577,64,61
64,62,177,0,0,0,0,177,64,62
64,63,669,164,6,229,0,1068,64,63
64,64,2723,19778,0,547,605,23653,64,64
64,65,2239,1493,0,950,168,4850,64,65
64,66,2496,1681,189,216,0,4582,64,66
64,67,874,284,0,48,0,1206,64,67
64,68,877,0,0,0,572,1449,64,68
64,69,194,0,0,120,321,635,64,69
64,70,154,154,0,0,102,410,64,70
64,71,385,0,329,0,174,888,64,71
64,72,61,0,104,0,0,165,64,72
64,73,514,0,298,0,0,812,64,73
64,74,120,0,0,0,0,120,64,74
64,75,35,0,0,0,0,35,64,75
64,76,0,0,0,6,0,6,64,76
64,77,149,0,0,0,0,149,64,77
64,78,88,0,0,7,0,95,64,78
64,79,453,0,0,189,0,642,64,79
64,80,0,0,48,0,0,48,64,80
64,81,0,0,261,172,174,607,64,81
64,82,151,0,0,256,276,683,64,82
64,83,0,0,200,0,0,200,64,83
64,86,36,0,0,0,0,36,64,86
64,89,0,0,0,145,0,145,64,89
64,92,0,0,0,120,0,120,64,92
64,96,137,0,0,0,0,137,64,96
64,99,95,0,0,0,0,95,64,99
64,100,120,0,0,0,0,120,64,100
64,101,102,0,321,0,0,423,64,101
64,104,21,0,21,0,0,42,64,104
64,106,240,0,0,0,0,240,64,106
64,107,99,0,0,0,0,99,64,107
64,109,240,0,0,0,0,240,64,109
64,126,188,0,0,0,0,188,64,126
64,153,0,0,93,0,0,93,64,153
64,154,0,0,451,0,0,451,64,154
64,162,95,0,0,0,0,95,64,162
64,169,0,0,457,0,0,457,64,169
64,171,526,0,526,0,0,1052,64,171
64,182,657,0,0,0,0,657,64,182
64,184,0,0,100,0,0,100,64,184
64,188,0,0,331,0,0,331,64,188
64,194,0,0,127,0,0,127,64,194
64,195,0,0,390,0,0,390,64,195
64,203,0,0,858,0,0,858,64,203
64,207,120,0,0,516,0,636,64,207
64,209,120,0,0,0,0,120,64,209
64,238,0,0,0,120,0,120,64,238
64,240,59,0,0,0,0,59,64,240
64,245,267,0,0,0,0,267,64,245
64,247,725,0,0,0,0,725,64,247
64,249,332,0,0,0,0,332,64,249
64,251,200,0,0,0,0,200,64,251
64,261,0,0,0,515,0,515,64,261
64,265,114,0,414,0,0,528,64,265
64,268,301,0,40,100,0,441,64,268
64,269,638,0,0,215,0,853,64,269
64,270,251,54,0,156,0,461,64,270
64,271,0,0,131,0,0,131,64,271
64,272,240,0,214,409,0,863,64,272
64,273,825,0,0,767,0,1592,64,273
64,274,0,0,344,0,0,344,64,274
64,275,669,0,298,0,0,967,64,275
64,277,308,0,0,0,0,308,64,277
64,278,0,0,703,0,0,703,64,278
64,279,0,0,1263,0,0,1263,64,279
64,280,120,0,167,0,0,287,64,280
64,281,537,0,0,0,0,537,64,281
64,282,0,0,314,0,0,314,64,282
64,283,0,0,252,0,0,252,64,283
64,286,0,0,121,0,0,121,64,286
64,287,234,0,0,0,0,234,64,287
64,288,0,0,0,120,0,120,64,288
64,289,0,0,509,0,0,509,64,289
64,292,0,0,1604,0,0,1604,64,292
64,293,0,0,352,0,0,352,64,293
64,294,0,0,1245,0,0,1245,64,294
64,297,0,0,83,0,0,83,64,297
64,298,0,0,1473,0,0,1473,64,298
64,300,712,0,251,0,0,963,64,300
64,301,267,0,131,0,0,398,64,301
64,302,290,0,85,0,0,375,64,302
64,303,106,0,79,0,0,185,64,303
64,305,0,0,1681,0,0,1681,64,305
64,306,0,0,1123,421,0,1544,64,306
64,309,0,0,631,0,0,631,64,309
64,311,0,0,1569,0,0,1569,64,311
64,313,0,0,458,0,0,458,64,313
64,315,0,0,202,0,0,202,64,315
64,316,254,0,0,0,0,254,64,316
64,317,63,0,0,140,0,203,64,317
64,318,103,0,43,0,0,146,64,318
64,319,105,0,16,297,0,418,64,319
64,321,485,0,0,111,0,596,64,321
64,323,0,0,584,0,0,584,64,323
64,324,0,0,686,0,0,686,64,324
64,325,0,0,279,0,0,279,64,325
64,327,233,0,0,0,0,233,64,327
64,329,51,0,0,0,0,51,64,329
64,331,0,0,224,0,0,224,64,331
64,335,195,0,0,0,0,195,64,335
64,339,120,0,0,0,0,120,64,339
65,1,116,0,244,0,0,360,65,1
65,2,0,0,104,0,0,104,65,2
65,4,214,0,0,0,0,214,65,4
65,8,224,0,0,0,0,224,65,8
65,9,0,0,92,0,0,92,65,9
65,15,116,0,0,0,0,116,65,15
65,21,917,0,0,72,0,989,65,21
65,22,116,0,0,0,0,116,65,22
65,24,458,0,0,0,0,458,65,24
65,25,0,0,176,0,0,176,65,25
65,27,386,0,0,0,0,386,65,27
65,28,467,0,0,0,0,467,65,28
65,29,116,0,0,0,0,116,65,29
65,30,0,0,126,0,0,126,65,30
65,31,0,0,121,116,0,237,65,31
65,32,802,0,0,0,0,802,65,32
65,33,37,0,0,0,0,37,65,33
65,35,231,0,116,0,0,347,65,35
65,39,111,0,135,0,0,246,65,39
65,41,109,0,0,0,0,109,65,41
65,44,58,0,0,0,0,58,65,44
65,48,247,0,0,0,0,247,65,48
65,49,116,0,80,0,0,196,65,49
65,52,0,0,121,0,0,121,65,52
65,53,116,0,0,0,0,116,65,53
65,54,229,0,360,0,0,589,65,54
65,55,11,0,249,0,0,260,65,55
65,57,347,0,247,282,0,876,65,57
65,58,116,0,0,0,0,116,65,58
65,60,340,0,0,118,0,458,65,60
65,61,116,0,121,0,0,237,65,61
65,62,0,0,0,109,0,109,65,62
65,63,368,109,0,23,101,601,65,63
65,64,1500,1493,0,1274,168,4435,65,64
65,65,4212,8467,0,439,335,13453,65,65
65,66,1391,573,157,1342,0,3463,65,66
65,67,0,1329,186,568,0,2083,65,67
65,68,1654,316,0,225,0,2195,65,68
65,69,902,451,0,80,0,1433,65,69
65,70,610,646,0,84,0,1340,65,70
65,71,116,0,0,116,0,232,65,71
65,72,116,0,118,0,0,234,65,72
65,73,904,231,0,116,161,1412,65,73
65,74,231,0,0,0,0,231,65,74
65,76,77,0,31,0,0,108,65,76
65,77,116,0,0,0,0,116,65,77
65,78,116,0,0,0,0,116,65,78
65,79,503,0,317,111,0,931,65,79
65,80,116,0,0,0,0,116,65,80
65,81,294,0,50,396,0,740,65,81
65,83,220,0,75,138,0,433,65,83
65,84,227,0,0,116,0,343,65,84
65,85,24,0,0,0,0,24,65,85
65,87,111,0,0,0,0,111,65,87
65,88,139,0,0,0,0,139,65,88
65,93,227,0,0,0,0,227,65,93
65,97,76,0,0,370,0,446,65,97
65,100,0,0,0,229,0,229,65,100
65,102,49,0,0,0,0,49,65,102
65,108,224,0,0,0,0,224,65,108
65,111,213,0,0,0,0,213,65,111
65,125,528,0,0,0,0,528,65,125
65,131,224,0,0,0,0,224,65,131
65,133,116,0,0,0,0,116,65,133
65,136,83,0,0,0,0,83,65,136
65,161,116,0,0,0,0,116,65,161
65,166,116,0,0,0,0,116,65,166
65,167,116,0,0,0,0,116,65,167
65,170,644,0,0,0,0,644,65,170
65,189,116,0,0,0,0,116,65,189
65,190,0,0,364,0,0,364,65,190
65,199,0,0,900,0,0,900,65,199
65,239,231,0,0,0,0,231,65,239
65,247,116,0,0,0,0,116,65,247
65,257,0,0,0,263,0,263,65,257
65,268,0,0,40,0,0,40,65,268
65,269,370,0,151,338,0,859,65,269
65,270,503,0,0,0,0,503,65,270
65,271,318,0,0,224,0,542,65,271
65,272,371,0,0,0,0,371,65,272
65,274,238,0,0,116,0,354,65,274
65,276,0,0,118,601,0,719,65,276
65,278,0,0,923,0,0,923,65,278
65,281,379,0,0,0,0,379,65,281
65,291,0,0,2675,0,0,2675,65,291
65,293,0,0,642,0,0,642,65,293
65,295,0,0,469,0,0,469,65,295
65,299,0,0,96,0,0,96,65,299
65,300,913,0,0,347,0,1260,65,300
65,301,116,0,0,0,0,116,65,301
65,304,0,0,636,0,0,636,65,304
65,305,0,0,220,0,0,220,65,305
65,306,0,0,458,922,0,1380,65,306
65,307,0,0,325,0,0,325,65,307
65,308,0,0,391,0,0,391,65,308
65,309,0,0,985,0,0,985,65,309
65,311,0,0,81,0,0,81,65,311
65,313,0,0,197,0,0,197,65,313
65,314,0,0,573,0,0,573,65,314
65,315,0,0,1147,0,0,1147,65,315
65,316,0,0,78,0,0,78,65,316
65,317,93,0,0,116,0,209,65,317
65,318,0,0,586,0,0,586,65,318
65,319,159,0,0,0,0,159,65,319
65,322,0,0,0,175,0,175,65,322
65,327,0,0,0,27,0,27,65,327
65,329,0,0,0,102,0,102,65,329
65,331,0,0,111,0,0,111,65,331
65,333,0,0,110,0,0,110,65,333
65,339,116,0,14,0,0,130,65,339
65,340,137,0,0,0,31,168,65,340
66,1,0,0,103,0,0,103,66,1
66,2,142,0,0,0,0,142,66,2
66,3,0,0,118,0,0,118,66,3
66,4,0,0,101,0,0,101,66,4
66,5,116,0,0,0,0,116,66,5
66,6,58,0,0,0,0,58,66,6
66,7,0,0,0,58,0,58,66,7
66,17,0,0,0,101,0,101,66,17
66,23,58,0,0,0,0,58,66,23
66,26,0,0,215,0,0,215,66,26
66,27,35,0,63,0,0,98,66,27
66,28,0,0,298,0,0,298,66,28
66,29,143,0,0,0,0,143,66,29
66,30,129,0,0,0,0,129,66,30
66,31,48,0,416,0,0,464,66,31
66,32,58,0,0,0,0,58,66,32
66,34,23,0,0,0,0,23,66,34
66,36,262,0,0,0,0,262,66,36
66,46,0,0,189,0,0,189,66,46
66,49,48,0,80,0,0,128,66,49
66,50,394,0,0,70,0,464,66,50
66,51,58,0,0,0,0,58,66,51
66,53,95,0,0,0,0,95,66,53
66,54,0,0,105,0,0,105,66,54
66,55,21,0,0,0,0,21,66,55
66,56,110,0,0,0,0,110,66,56
66,57,58,0,0,0,0,58,66,57
66,58,100,0,0,0,0,100,66,58
66,59,533,0,0,0,0,533,66,59
66,60,2485,102,309,0,0,2896,66,60
66,61,204,0,0,0,0,204,66,61
66,62,53,0,0,0,0,53,66,62
66,63,53,12,59,11,0,135,66,63
66,64,2395,1216,402,438,0,4451,66,64
66,65,1404,682,38,1292,0,3416,66,65
66,66,507,2615,0,328,125,3575,66,66
66,67,590,0,0,0,0,590,66,67
66,68,407,58,65,0,0,530,66,68
66,69,58,0,0,58,0,116,66,69
66,70,272,445,154,165,0,1036,66,70
66,71,767,0,92,193,0,1052,66,71
66,72,176,0,348,0,0,524,66,72
66,73,192,0,0,0,0,192,66,73
66,75,35,0,61,35,0,131,66,75
66,76,344,0,0,0,0,344,66,76
66,77,137,0,0,0,0,137,66,77
66,78,135,0,0,98,0,233,66,78
66,79,0,0,52,0,0,52,66,79
66,80,116,0,0,0,84,200,66,80
66,81,372,0,205,164,0,741,66,81
66,82,116,0,63,58,0,237,66,82
66,83,58,0,0,0,0,58,66,83
66,84,0,0,82,0,0,82,66,84
66,85,35,0,0,0,0,35,66,85
66,88,58,0,0,0,0,58,66,88
66,90,166,0,0,0,0,166,66,90
66,92,47,0,0,0,0,47,66,92
66,95,0,0,465,0,0,465,66,95
66,99,96,0,0,0,0,96,66,99
66,101,0,0,65,0,0,65,66,101
66,103,10,0,0,0,0,10,66,103
66,106,101,0,0,0,0,101,66,106
66,107,35,0,0,0,0,35,66,107
66,115,60,0,49,0,0,109,66,115
66,122,0,0,0,555,0,555,66,122
66,124,507,0,0,0,0,507,66,124
66,133,106,0,0,0,0,106,66,133
66,135,170,0,0,0,0,170,66,135
66,136,0,0,0,49,0,49,66,136
66,141,58,0,0,0,0,58,66,141
66,165,0,0,0,32,0,32,66,165
66,167,120,0,0,0,0,120,66,167
66,177,46,0,0,0,0,46,66,177
66,178,308,0,0,0,0,308,66,178
66,188,0,0,225,0,0,225,66,188
66,200,0,0,109,0,0,109,66,200
66,211,58,0,0,0,69,127,66,211
66,218,0,0,525,0,0,525,66,218
66,221,0,0,281,0,0,281,66,221
66,229,0,0,818,0,0,818,66,229
66,231,0,0,152,0,0,152,66,231
66,236,41,0,0,58,0,99,66,236
66,237,51,0,26,0,0,77,66,237
66,239,0,0,119,0,0,119,66,239
66,241,204,0,0,0,0,204,66,241
66,244,0,0,212,829,0,1041,66,244
66,246,0,0,405,0,0,405,66,246
66,250,216,0,0,0,0,216,66,250
66,252,0,0,126,0,0,126,66,252
66,267,153,0,0,0,0,153,66,267
66,268,108,0,38,36,0,182,66,268
66,269,424,145,0,0,0,569,66,269
66,270,227,144,0,60,0,431,66,270
66,271,48,0,38,0,0,86,66,271
66,272,77,0,0,0,0,77,66,272
66,273,116,0,0,1840,0,1956,66,273
66,274,543,0,465,0,0,1008,66,274
66,275,549,0,298,0,0,847,66,275
66,276,0,0,0,990,0,990,66,276
66,278,58,0,1091,0,0,1149,66,278
66,279,0,0,326,0,0,326,66,279
66,280,221,0,0,0,0,221,66,280
66,281,425,0,0,0,0,425,66,281
66,282,438,0,218,0,0,656,66,282
66,283,58,0,0,0,0,58,66,283
66,284,0,0,693,0,0,693,66,284
66,285,0,0,533,0,0,533,66,285
66,286,67,0,0,0,0,67,66,286
66,287,0,0,0,43,0,43,66,287
66,288,43,0,0,0,0,43,66,288
66,289,79,0,0,0,0,79,66,289
66,293,0,0,596,0,0,596,66,293
66,296,30,0,0,0,0,30,66,296
66,298,0,0,1508,0,0,1508,66,298
66,300,106,0,234,0,0,340,66,300
66,301,276,0,183,116,0,575,66,301
66,302,58,0,92,0,0,150,66,302
66,303,58,0,677,0,0,735,66,303
66,304,58,0,0,0,0,58,66,304
66,305,657,0,440,0,0,1097,66,305
66,307,0,0,768,0,0,768,66,307
66,308,0,0,220,0,0,220,66,308
66,309,0,0,166,162,0,328,66,309
66,311,95,0,0,0,0,95,66,311
66,312,0,0,541,0,0,541,66,312
66,313,0,0,458,0,0,458,66,313
66,315,0,0,539,0,0,539,66,315
66,316,0,0,95,0,0,95,66,316
66,317,14,0,0,0,0,14,66,317
66,320,322,0,0,0,0,322,66,320
66,321,263,0,0,0,0,263,66,321
66,322,24,0,208,0,0,232,66,322
66,323,0,0,586,0,0,586,66,323
66,325,0,0,228,0,0,228,66,325
66,326,116,0,0,0,0,116,66,326
66,327,55,0,0,0,0,55,66,327
66,329,0,0,0,50,0,50,66,329
66,335,280,0,0,0,0,280,66,335
66,337,0,0,452,0,0,452,66,337
66,339,58,0,169,0,0,227,66,339
66,340,26,0,0,135,0,161,66,340
66,342,0,0,0,430,0,430,66,342
67,1,204,0,60,0,0,264,67,1
67,2,0,0,88,0,0,88,67,2
67,3,0,0,80,80,0,160,67,3
67,4,0,0,583,0,0,583,67,4
67,5,0,0,53,88,0,141,67,5
67,6,80,0,0,0,0,80,67,6
67,7,55,0,0,0,0,55,67,7
67,19,0,0,91,0,0,91,67,19
67,25,0,0,176,0,0,176,67,25
67,27,0,0,88,0,0,88,67,27
67,28,80,0,88,0,0,168,67,28
67,29,55,0,0,0,0,55,67,29
67,31,80,0,140,0,0,220,67,31
67,32,0,0,91,0,0,91,67,32
67,36,0,0,268,0,0,268,67,36
67,37,80,0,0,0,0,80,67,37
67,40,0,0,28,0,0,28,67,40
67,43,0,0,176,0,0,176,67,43
67,47,55,0,0,0,0,55,67,47
67,49,83,0,0,0,0,83,67,49
67,51,104,0,0,0,0,104,67,51
67,53,0,0,55,26,0,81,67,53
67,54,190,0,60,0,0,250,67,54
67,55,251,0,0,0,0,251,67,55
67,59,0,0,88,0,0,88,67,59
67,60,137,0,0,0,0,137,67,60
67,62,0,80,0,80,0,160,67,62
67,63,46,216,0,0,0,262,67,63
67,64,874,201,91,48,0,1214,67,64
67,65,86,1329,186,402,0,2003,67,65
67,66,590,0,0,0,0,590,67,66
67,67,745,3171,0,0,0,3916,67,67
67,68,650,1082,91,281,0,2104,67,68
67,69,460,957,0,0,0,1417,67,69
67,70,446,0,156,0,0,602,67,70
67,73,325,80,0,209,80,694,67,73
67,74,98,0,0,0,0,98,67,74
67,75,71,56,0,0,0,127,67,75
67,76,297,339,60,0,0,696,67,76
67,78,80,0,110,55,0,245,67,78
67,79,0,0,0,189,0,189,67,79
67,81,103,0,0,338,0,441,67,81
67,82,0,0,176,0,80,256,67,82
67,83,193,0,0,0,0,193,67,83
67,84,51,0,0,0,0,51,67,84
67,85,0,0,0,17,0,17,67,85
67,86,18,0,0,0,0,18,67,86
67,87,284,0,0,0,0,284,67,87
67,88,0,0,150,0,0,150,67,88
67,91,0,0,80,0,0,80,67,91
67,93,0,0,88,0,0,88,67,93
67,94,80,0,0,0,0,80,67,94
67,95,200,0,0,0,0,200,67,95
67,98,0,0,8,0,0,8,67,98
67,104,42,0,0,0,0,42,67,104
67,107,0,0,0,99,0,99,67,107
67,127,80,0,0,0,0,80,67,127
67,129,0,0,55,0,0,55,67,129
67,131,0,0,0,80,0,80,67,131
67,136,159,0,173,0,0,332,67,136
67,153,80,0,0,0,0,80,67,153
67,165,0,0,69,0,0,69,67,165
67,167,80,0,0,0,0,80,67,167
67,172,0,0,258,0,0,258,67,172
67,173,0,0,272,0,0,272,67,173
67,221,0,0,727,0,0,727,67,221
67,227,0,0,83,0,0,83,67,227
67,233,0,0,747,0,0,747,67,233
67,236,0,0,122,0,0,122,67,236
67,237,33,0,0,0,0,33,67,237
67,268,36,0,88,0,0,124,67,268
67,269,48,0,111,0,0,159,67,269
67,270,12,0,0,0,0,12,67,270
67,278,0,0,430,0,0,430,67,278
67,279,0,0,326,0,0,326,67,279
67,282,80,0,0,0,0,80,67,282
67,286,0,0,88,0,0,88,67,286
67,289,0,0,587,0,0,587,67,289
67,290,0,0,478,0,0,478,67,290
67,294,0,0,589,0,0,589,67,294
67,298,0,0,272,0,0,272,67,298
67,300,80,0,486,80,0,646,67,300
67,301,209,0,0,0,0,209,67,301
67,302,0,0,92,0,0,92,67,302
67,303,0,0,32,0,0,32,67,303
67,306,0,0,458,0,0,458,67,306
67,307,0,0,1369,0,0,1369,67,307
67,315,898,0,0,0,0,898,67,315
67,317,14,0,0,0,0,14,67,317
67,318,0,0,67,0,0,67,67,318
67,321,111,0,103,0,0,214,67,321
67,322,0,0,495,0,0,495,67,322
67,329,165,0,443,0,0,608,67,329
67,339,55,0,0,0,0,55,67,339
68,1,0,0,396,0,0,396,68,1
68,2,0,0,332,0,0,332,68,2
68,3,0,0,186,0,0,186,68,3
68,4,618,0,215,0,0,833,68,4
68,5,0,0,97,0,0,97,68,5
68,6,0,0,121,0,0,121,68,6
68,7,150,0,100,746,0,996,68,7
68,10,0,0,12,0,0,12,68,10
68,11,0,0,24,0,0,24,68,11
68,14,333,0,0,0,0,333,68,14
68,18,124,0,0,0,0,124,68,18
68,22,134,0,0,0,0,134,68,22
68,23,178,0,61,0,0,239,68,23
68,24,0,0,150,0,263,413,68,24
68,25,0,0,213,208,0,421,68,25
68,26,383,0,97,0,0,480,68,26
68,27,121,0,506,47,0,674,68,27
68,28,76,0,847,182,0,1105,68,28
68,29,468,0,518,90,0,1076,68,29
68,30,193,0,206,319,0,718,68,30
68,31,250,0,1290,150,0,1690,68,31
68,32,143,0,253,145,0,541,68,32
68,33,14,0,6,0,0,20,68,33
68,34,39,0,42,59,0,140,68,34
68,35,0,0,33,0,0,33,68,35
68,36,121,0,0,131,0,252,68,36
68,37,0,0,72,0,0,72,68,37
68,38,35,0,0,0,0,35,68,38
68,40,0,0,18,0,0,18,68,40
68,41,0,0,140,0,0,140,68,41
68,42,0,0,23,0,0,23,68,42
68,43,121,0,176,98,0,395,68,43
68,44,302,0,0,0,0,302,68,44
68,48,121,0,0,0,0,121,68,48
68,51,174,0,0,0,0,174,68,51
68,53,426,0,519,58,0,1003,68,53
68,54,74,0,291,0,0,365,68,54
68,55,347,0,97,0,0,444,68,55
68,56,461,0,90,0,0,551,68,56
68,57,443,0,63,21,0,527,68,57
68,58,97,0,127,0,0,224,68,58
68,60,1031,0,0,75,0,1106,68,60
68,62,0,0,168,107,0,275,68,62
68,63,127,0,132,0,33,292,68,63
68,64,999,0,0,0,572,1571,68,64
68,65,1504,316,0,225,0,2045,68,65
68,66,349,58,65,58,0,530,68,66
68,67,705,1052,0,361,0,2118,68,67
68,68,1516,45201,488,2292,0,49497,68,68
68,69,1073,2342,0,0,216,3631,68,69
68,70,1779,836,858,183,130,3786,68,70
68,71,572,0,132,375,0,1079,68,71
68,72,119,0,132,0,160,411,68,72
68,73,518,2310,153,197,0,3178,68,73
68,74,613,0,427,160,142,1342,68,74
68,75,310,0,184,188,0,682,68,75
68,76,514,443,277,564,0,1798,68,76
68,77,300,0,323,1163,0,1786,68,77
68,78,586,0,221,0,518,1325,68,78
68,79,320,0,157,63,0,540,68,79
68,80,137,210,196,545,326,1414,68,80
68,81,846,1210,193,802,355,3406,68,81
68,82,711,232,76,90,130,1239,68,82
68,83,187,0,94,37,276,594,68,83
68,84,221,0,198,51,0,470,68,84
68,85,47,0,44,24,0,115,68,85
68,86,18,0,70,0,0,88,68,86
68,87,240,0,230,152,0,622,68,87
68,88,496,0,110,138,0,744,68,88
68,89,149,0,0,150,0,299,68,89
68,90,62,0,287,276,0,625,68,90
68,91,9,0,9,0,0,18,68,91
68,93,191,0,117,0,0,308,68,93
68,94,150,0,524,0,0,674,68,94
68,95,75,0,0,102,0,177,68,95
68,96,0,0,0,66,0,66,68,96
68,97,35,0,0,35,0,70,68,97
68,98,7,0,0,7,0,14,68,98
68,99,0,184,0,0,0,184,68,99
68,100,183,0,145,150,0,478,68,100
68,101,0,0,484,0,0,484,68,101
68,102,105,0,114,0,0,219,68,102
68,103,35,0,0,0,0,35,68,103
68,104,42,0,0,159,0,201,68,104
68,105,50,0,0,0,0,50,68,105
68,106,290,0,0,0,0,290,68,106
68,107,342,0,0,0,0,342,68,107
68,111,336,0,0,0,0,336,68,111
68,127,0,0,348,0,0,348,68,127
68,129,0,0,174,0,0,174,68,129
68,133,36,0,0,0,0,36,68,133
68,136,0,0,0,90,0,90,68,136
68,137,0,0,475,36,0,511,68,137
68,144,59,0,0,0,0,59,68,144
68,152,0,0,174,0,0,174,68,152
68,153,152,0,0,0,0,152,68,153
68,160,78,0,0,0,0,78,68,160
68,163,0,0,676,0,0,676,68,163
68,164,0,0,32,55,0,87,68,164
68,165,0,0,435,0,0,435,68,165
68,166,201,0,0,0,0,201,68,166
68,167,0,0,121,0,0,121,68,167
68,174,0,0,372,0,0,372,68,174
68,183,0,0,84,0,0,84,68,183
68,187,0,0,222,0,0,222,68,187
68,188,0,0,225,225,0,450,68,188
68,189,0,0,269,0,0,269,68,189
68,196,338,0,0,0,0,338,68,196
68,200,0,0,222,0,0,222,68,200
68,205,0,0,384,0,0,384,68,205
68,211,744,0,0,0,0,744,68,211
68,212,0,0,437,0,0,437,68,212
68,213,0,0,143,0,0,143,68,213
68,215,49,0,456,0,0,505,68,215
68,216,0,0,439,0,0,439,68,216
68,225,0,0,268,0,0,268,68,225
68,226,0,0,1535,0,0,1535,68,226
68,227,0,0,501,0,0,501,68,227
68,228,0,0,176,0,0,176,68,228
68,229,0,0,365,0,0,365,68,229
68,232,0,0,314,0,0,314,68,232
68,235,0,0,1020,0,0,1020,68,235
68,237,0,0,0,26,0,26,68,237
68,247,725,0,894,0,0,1619,68,247
68,251,256,0,279,0,0,535,68,251
68,252,62,0,0,0,0,62,68,252
68,254,0,0,294,0,0,294,68,254
68,265,0,0,61,679,0,740,68,265
68,268,0,139,0,36,0,175,68,268
68,269,448,0,132,0,0,580,68,269
68,270,0,0,128,0,0,128,68,270
68,271,0,0,0,121,0,121,68,271
68,272,136,0,0,0,0,136,68,272
68,273,1076,0,0,0,0,1076,68,273
68,274,377,0,1112,196,0,1685,68,274
68,276,0,0,923,0,0,923,68,276
68,277,0,0,81,0,0,81,68,277
68,278,0,0,1156,0,0,1156,68,278
68,279,0,0,789,121,0,910,68,279
68,281,0,0,173,0,0,173,68,281
68,282,0,0,0,279,0,279,68,282
68,283,0,0,99,0,0,99,68,283
68,284,0,0,230,0,0,230,68,284
68,288,39,0,0,0,0,39,68,288
68,289,0,0,375,0,0,375,68,289
68,290,0,0,477,0,0,477,68,290
68,294,542,0,667,0,0,1209,68,294
68,295,0,0,895,0,0,895,68,295
68,298,0,0,2200,0,0,2200,68,298
68,299,0,0,0,104,0,104,68,299
68,300,453,0,282,49,176,960,68,300
68,301,79,0,86,0,0,165,68,301
68,302,272,0,226,0,0,498,68,302
68,303,79,0,358,0,0,437,68,303
68,305,202,0,220,0,0,422,68,305
68,306,0,0,879,0,0,879,68,306
68,307,0,0,327,0,0,327,68,307
68,308,0,0,220,0,0,220,68,308
68,309,0,0,1001,0,0,1001,68,309
68,311,0,0,0,1165,0,1165,68,311
68,312,259,0,436,0,0,695,68,312
68,313,0,0,357,0,0,357,68,313
68,314,0,0,788,0,0,788,68,314
68,315,321,0,734,321,0,1376,68,315
68,316,190,0,107,144,0,441,68,316
68,317,242,15,132,49,0,438,68,317
68,318,335,0,112,317,0,764,68,318
68,319,118,0,221,99,0,438,68,319
68,320,212,0,299,215,0,726,68,320
68,321,965,0,67,0,0,1032,68,321
68,322,245,0,157,121,0,523,68,322
68,324,820,0,0,0,0,820,68,324
68,325,409,0,395,0,0,804,68,325
68,326,0,0,2020,0,0,2020,68,326
68,327,523,0,30,38,0,591,68,327
68,328,571,0,0,0,0,571,68,328
68,329,322,0,55,0,0,377,68,329
68,331,107,0,0,0,0,107,68,331
68,333,0,0,366,186,0,552,68,333
68,334,502,0,0,0,0,502,68,334
68,336,166,0,743,0,0,909,68,336
68,337,132,0,358,0,0,490,68,337
68,338,89,0,0,0,0,89,68,338
68,339,79,0,1099,74,176,1428,68,339
68,340,489,0,37,0,0,526,68,340
68,341,77,0,136,0,0,213,68,341
69,2,80,0,0,0,0,80,69,2
69,3,0,0,253,80,0,333,69,3
69,4,0,0,233,560,0,793,69,4
69,5,80,0,248,0,0,328,69,5
69,6,0,0,79,0,0,79,69,6
69,7,0,0,75,0,0,75,69,7
69,17,20,0,0,0,0,20,69,17
69,18,0,0,87,0,0,87,69,18
69,19,201,0,0,35,0,236,69,19
69,20,0,0,319,0,0,319,69,20
69,21,0,0,72,0,0,72,69,21
69,23,63,0,0,0,0,63,69,23
69,24,103,0,163,0,0,266,69,24
69,25,0,0,174,0,0,174,69,25
69,27,80,0,0,0,0,80,69,27
69,28,80,0,24,152,0,256,69,28
69,30,64,0,144,0,0,208,69,30
69,31,0,0,53,0,186,239,69,31
69,32,80,0,334,93,0,507,69,32
69,34,39,0,38,0,0,77,69,34
69,35,73,0,87,0,0,160,69,35
69,36,823,0,0,131,0,954,69,36
69,39,73,0,0,0,0,73,69,39
69,41,0,0,121,0,0,121,69,41
69,43,0,0,167,0,0,167,69,43
69,45,172,0,0,0,0,172,69,45
69,49,248,0,0,153,0,401,69,49
69,51,197,0,0,0,0,197,69,51
69,52,227,0,279,0,0,506,69,52
69,53,0,0,101,0,0,101,69,53
69,54,110,0,87,80,0,277,69,54
69,56,0,0,38,0,0,38,69,56
69,57,350,0,87,0,0,437,69,57
69,60,118,0,129,0,0,247,69,60
69,62,177,80,361,0,39,657,69,62
69,63,187,0,0,24,0,211,69,63
69,64,0,0,0,120,321,441,69,64
69,65,1000,531,40,80,0,1651,69,65
69,66,0,0,0,116,0,116,69,66
69,67,380,877,0,0,0,1257,69,67
69,68,1572,1775,0,80,216,3643,69,68
69,69,2524,10164,0,0,287,12975,69,69
69,70,275,794,0,160,0,1229,69,70
69,71,121,0,0,80,0,201,69,71
69,72,232,0,0,0,0,232,69,72
69,73,303,1115,0,125,347,1890,69,73
69,74,39,0,307,0,0,346,69,74
69,75,35,0,174,0,0,209,69,75
69,76,80,0,0,73,0,153,69,76
69,79,41,0,45,0,0,86,69,79
69,80,106,0,79,80,0,265,69,80
69,81,623,152,226,336,0,1337,69,81
69,82,115,0,0,0,102,217,69,82
69,83,187,0,129,0,0,316,69,83
69,84,73,0,0,0,0,73,69,84
69,85,0,0,19,41,0,60,69,85
69,86,18,0,22,0,0,40,69,86
69,87,138,0,26,0,0,164,69,87
69,88,138,0,0,0,0,138,69,88
69,94,0,0,0,127,0,127,69,94
69,96,0,0,0,0,95,95,69,96
69,97,154,0,0,35,51,240,69,97
69,99,131,0,0,0,0,131,69,99
69,100,80,0,0,0,0,80,69,100
69,101,820,0,0,0,0,820,69,101
69,102,56,0,0,0,0,56,69,102
69,104,0,0,22,0,0,22,69,104
69,105,50,0,0,0,0,50,69,105
69,107,118,0,0,0,0,118,69,107
69,111,0,0,84,0,0,84,69,111
69,113,0,0,293,0,0,293,69,113
69,115,427,0,0,0,0,427,69,115
69,118,129,0,0,0,0,129,69,118
69,119,0,0,504,0,0,504,69,119
69,134,0,0,307,0,0,307,69,134
69,136,73,0,0,0,0,73,69,136
69,141,0,0,985,0,0,985,69,141
69,144,994,0,350,0,0,1344,69,144
69,164,0,0,64,0,0,64,69,164
69,165,0,0,35,0,0,35,69,165
69,169,0,0,60,0,0,60,69,169
69,171,0,0,526,0,0,526,69,171
69,172,0,0,258,0,0,258,69,172
69,185,0,0,335,0,0,335,69,185
69,192,0,0,0,73,0,73,69,192
69,193,189,0,0,0,0,189,69,193
69,229,0,0,365,0,0,365,69,229
69,237,26,0,0,0,0,26,69,237
69,239,0,0,0,35,0,35,69,239
69,247,80,0,0,0,0,80,69,247
69,252,85,0,0,0,0,85,69,252
69,264,613,0,0,0,0,613,69,264
69,268,243,0,101,80,0,424,69,268
69,269,0,0,0,80,0,80,69,269
69,270,54,0,59,0,0,113,69,270
69,271,60,0,0,0,0,60,69,271
69,272,38,0,142,0,0,180,69,272
69,273,292,0,0,0,0,292,69,273
69,276,0,0,0,195,0,195,69,276
69,278,0,0,663,0,0,663,69,278
69,279,0,0,447,0,0,447,69,279
69,280,143,0,0,0,0,143,69,280
69,283,0,0,86,0,0,86,69,283
69,284,353,0,0,0,0,353,69,284
69,286,0,0,235,0,0,235,69,286
69,287,106,0,0,0,0,106,69,287
69,290,0,0,251,0,0,251,69,290
69,295,0,0,895,0,0,895,69,295
69,300,905,0,581,0,50,1536,69,300
69,302,0,0,1098,0,0,1098,69,302
69,303,0,0,250,0,0,250,69,303
69,304,0,0,993,0,0,993,69,304
69,305,0,0,440,0,0,440,69,305
69,307,0,0,325,0,0,325,69,307
69,308,0,0,535,0,0,535,69,308
69,309,0,0,176,0,0,176,69,309
69,314,0,0,527,0,0,527,69,314
69,316,188,0,0,0,0,188,69,316
69,317,0,0,125,21,0,146,69,317
69,319,17,0,0,0,0,17,69,319
69,320,152,0,299,0,0,451,69,320
69,321,111,0,0,0,0,111,69,321
69,322,0,0,0,177,0,177,69,322
69,323,80,0,539,0,0,619,69,323
69,327,210,0,0,0,0,210,69,327
69,328,51,0,0,0,0,51,69,328
69,330,0,0,234,0,0,234,69,330
69,338,0,0,214,0,0,214,69,338
69,339,190,0,0,0,0,190,69,339
69,340,71,0,0,37,0,108,69,340
70,2,0,0,160,0,0,160,70,2
70,6,0,0,91,0,0,91,70,6
70,11,11,0,0,0,0,11,70,11
70,12,156,0,0,0,0,156,70,12
70,19,97,0,0,0,0,97,70,19
70,22,0,0,953,0,0,953,70,22
70,23,127,0,0,0,0,127,70,23
70,24,0,0,0,110,0,110,70,24
70,25,84,0,0,0,0,84,70,25
70,26,0,0,91,0,0,91,70,26
70,27,84,0,0,84,0,168,70,27
70,29,0,0,128,63,0,191,70,29
70,30,0,0,0,71,0,71,70,30
70,31,78,0,0,0,0,78,70,31
70,32,84,0,101,0,21,206,70,32
70,34,0,0,0,17,0,17,70,34
70,37,0,0,55,0,0,55,70,37
70,41,121,0,132,0,0,253,70,41
70,43,90,0,0,0,0,90,70,43
70,49,0,0,81,35,0,116,70,49
70,50,35,0,0,156,0,191,70,50
70,51,311,0,0,0,0,311,70,51
70,54,155,0,0,78,0,233,70,54
70,55,211,0,0,0,0,211,70,55
70,56,84,0,0,0,0,84,70,56
70,58,184,0,0,0,0,184,70,58
70,60,0,0,91,0,0,91,70,60
70,62,79,0,0,0,0,79,70,62
70,63,179,0,12,0,0,191,70,63
70,64,154,0,0,0,102,256,70,64
70,65,610,568,0,84,0,1262,70,65
70,66,593,445,154,165,0,1357,70,66
70,67,506,0,178,0,0,684,70,67
70,68,1245,760,1072,121,130,3328,70,68
70,69,282,760,0,160,0,1202,70,69
70,70,0,8035,0,86,0,8121,70,70
70,71,385,328,128,0,0,841,70,71
70,72,0,61,0,0,0,61,70,72
70,73,409,880,253,190,0,1732,70,73
70,74,98,0,95,82,0,275,70,74
70,75,0,0,91,0,0,91,70,75
70,76,68,0,0,0,0,68,70,76
70,77,0,0,0,60,0,60,70,77
70,78,88,0,289,0,0,377,70,78
70,79,167,0,400,0,0,567,70,79
70,80,71,0,0,0,0,71,70,80
70,81,249,0,41,155,0,445,70,81
70,82,0,0,185,0,0,185,70,82
70,83,35,0,107,0,0,142,70,83
70,84,130,0,102,0,0,232,70,84
70,87,33,0,0,0,0,33,70,87
70,88,0,0,0,141,0,141,70,88
70,90,62,0,0,62,0,124,70,90
70,92,0,0,110,0,0,110,70,92
70,94,0,0,67,0,0,67,70,94
70,95,0,0,111,0,0,111,70,95
70,97,70,0,0,0,0,70,70,97
70,98,7,0,0,0,0,7,70,98
70,99,58,0,0,0,0,58,70,99
70,102,85,0,53,0,0,138,70,102
70,104,21,0,0,0,0,21,70,104
70,105,50,0,0,0,0,50,70,105
70,116,118,0,0,0,0,118,70,116
70,126,0,0,371,0,0,371,70,126
70,131,0,0,8,0,0,8,70,131
70,133,0,0,192,0,0,192,70,133
70,135,170,0,0,0,0,170,70,135
70,140,152,0,0,0,0,152,70,140
70,161,0,0,294,0,0,294,70,161
70,163,621,0,0,0,0,621,70,163
70,196,338,0,0,0,0,338,70,196
70,203,0,0,249,0,0,249,70,203
70,209,174,0,0,0,0,174,70,209
70,210,97,0,0,0,0,97,70,210
70,236,84,0,0,0,0,84,70,236
70,237,65,0,0,0,0,65,70,237
70,239,0,0,110,0,0,110,70,239
70,246,114,0,0,0,0,114,70,246
70,247,0,0,1125,0,0,1125,70,247
70,252,0,0,0,62,0,62,70,252
70,254,218,0,0,0,0,218,70,254
70,257,0,0,433,0,0,433,70,257
70,268,146,0,306,35,0,487,70,268
70,269,425,0,0,0,0,425,70,269
70,270,84,0,0,0,0,84,70,270
70,273,0,0,696,0,0,696,70,273
70,274,0,0,159,0,0,159,70,274
70,277,0,0,276,181,0,457,70,277
70,278,0,0,560,0,0,560,70,278
70,279,0,0,395,0,0,395,70,279
70,280,425,0,133,0,0,558,70,280
70,282,143,0,0,0,0,143,70,282
70,283,0,0,54,0,0,54,70,283
70,287,106,0,710,0,0,816,70,287
70,289,0,0,582,0,0,582,70,289
70,293,0,0,235,0,0,235,70,293
70,294,84,0,667,0,0,751,70,294
70,295,0,0,895,0,0,895,70,295
70,300,285,0,0,0,121,406,70,300
70,301,312,0,0,0,0,312,70,301
70,303,31,0,0,0,0,31,70,303
70,304,0,0,91,0,0,91,70,304
70,305,570,0,806,0,0,1376,70,305
70,306,0,0,458,0,0,458,70,306
70,307,0,0,325,0,0,325,70,307
70,308,0,0,245,0,0,245,70,308
70,312,0,0,279,0,0,279,70,312
70,313,0,0,114,0,0,114,70,313
70,314,0,0,43,0,0,43,70,314
70,315,0,0,539,0,0,539,70,315
70,316,94,0,0,0,0,94,70,316
70,317,172,0,0,42,0,214,70,317
70,318,172,0,245,141,0,558,70,318
70,319,482,0,118,0,0,600,70,319
70,321,341,0,0,0,0,341,70,321
70,324,118,0,0,0,0,118,70,324
70,325,0,0,43,0,0,43,70,325
70,327,200,0,0,103,0,303,70,327
70,328,197,0,0,0,0,197,70,328
70,329,120,0,0,51,0,171,70,329
70,330,0,0,111,0,0,111,70,330
70,331,0,0,326,0,0,326,70,331
70,332,0,0,758,0,0,758,70,332
70,337,132,0,182,0,0,314,70,337
70,340,373,0,91,0,0,464,70,340
70,341,0,0,154,0,0,154,70,341
70,342,373,0,0,0,0,373,70,342
71,2,0,0,96,0,0,96,71,2
71,5,0,0,193,0,302,495,71,5
71,6,193,0,0,0,0,193,71,6
71,22,0,0,46,0,0,46,71,22
71,25,0,0,376,0,0,376,71,25
71,26,0,0,81,0,0,81,71,26
71,27,46,0,238,0,0,284,71,27
71,28,0,0,145,0,0,145,71,28
71,29,255,0,167,0,0,422,71,29
71,30,0,0,349,0,0,349,71,30
71,31,0,0,153,306,0,459,71,31
71,35,0,0,473,0,0,473,71,35
71,36,193,0,0,321,0,514,71,36
71,48,321,0,0,0,0,321,71,48
71,54,292,0,0,0,53,345,71,54
71,55,0,0,0,95,0,95,71,55
71,57,131,0,210,514,0,855,71,57
71,58,0,0,145,0,0,145,71,58
71,60,69,0,0,0,0,69,71,60
71,62,153,0,0,193,0,346,71,62
71,63,11,0,0,542,0,553,71,63
71,64,506,0,329,0,174,1009,71,64
71,65,116,0,0,116,0,232,71,65
71,66,733,0,92,193,0,1018,71,66
71,68,1178,0,147,90,0,1415,71,68
71,69,121,0,0,80,0,201,71,69
71,70,385,99,128,0,0,612,71,70
71,71,3263,9876,0,524,386,14049,71,71
71,72,1474,1442,192,255,257,3620,71,72
71,73,1923,1266,82,618,0,3889,71,73
71,74,651,0,0,0,0,651,71,74
71,76,0,0,0,131,0,131,71,76
71,77,47,0,0,0,0,47,71,77
71,78,0,0,210,102,0,312,71,78
71,79,193,0,0,41,0,234,71,79
71,80,70,0,0,0,0,70,71,80
71,81,56,0,559,0,0,615,71,81
71,82,153,0,0,321,222,696,71,82
71,84,131,0,0,0,0,131,71,84
71,86,18,0,0,0,0,18,71,86
71,88,138,0,138,0,0,276,71,88
71,90,0,0,0,193,0,193,71,90
71,93,0,0,0,109,0,109,71,93
71,96,218,0,0,0,0,218,71,96
71,97,0,0,0,70,0,70,71,97
71,98,7,0,0,0,0,7,71,98
71,100,0,0,143,0,0,143,71,100
71,103,764,0,0,0,0,764,71,103
71,104,21,0,0,0,0,21,71,104
71,107,99,0,0,0,0,99,71,107
71,116,0,0,372,0,0,372,71,116
71,121,0,0,376,0,0,376,71,121
71,147,0,0,432,0,0,432,71,147
71,197,0,0,0,95,0,95,71,197
71,236,0,0,143,0,0,143,71,236
71,268,1284,264,0,341,134,2023,71,268
71,269,416,321,0,0,284,1021,71,269
71,270,700,90,182,0,0,972,71,270
71,272,38,0,0,0,0,38,71,272
71,275,193,0,0,0,0,193,71,275
71,276,0,0,874,0,0,874,71,276
71,277,0,0,168,0,0,168,71,277
71,280,94,0,986,0,0,1080,71,280
71,281,379,0,0,124,0,503,71,281
71,282,0,0,0,823,0,823,71,282
71,286,193,0,0,0,0,193,71,286
71,287,106,0,115,0,0,221,71,287
71,288,0,0,393,0,0,393,71,288
71,290,0,0,774,0,0,774,71,290
71,291,0,0,967,0,0,967,71,291
71,293,323,0,237,0,0,560,71,293
71,298,0,0,371,0,0,371,71,298
71,300,1768,0,660,0,0,2428,71,300
71,301,511,0,0,0,0,511,71,301
71,302,437,0,167,0,0,604,71,302
71,303,79,0,167,0,0,246,71,303
71,304,0,0,406,0,0,406,71,304
71,305,202,0,0,0,0,202,71,305
71,309,0,0,166,0,0,166,71,309
71,310,0,0,282,0,0,282,71,310
71,311,0,0,912,0,0,912,71,311
71,312,0,0,155,0,0,155,71,312
71,314,0,0,724,899,0,1623,71,314
71,315,0,0,658,0,0,658,71,315
71,316,0,0,78,0,0,78,71,316
71,317,28,0,0,20,0,48,71,317
71,318,365,0,112,0,0,477,71,318
71,319,72,0,0,0,0,72,71,319
71,320,244,0,299,0,0,543,71,320
71,321,205,0,121,0,0,326,71,321
71,322,275,0,0,0,0,275,71,322
71,325,0,0,248,0,0,248,71,325
71,326,0,0,651,0,0,651,71,326
71,327,27,0,0,0,0,27,71,327
71,329,378,0,0,0,0,378,71,329
71,333,0,0,0,193,0,193,71,333
71,335,0,0,195,0,0,195,71,335
71,339,385,0,0,0,0,385,71,339
71,341,193,0,0,0,0,193,71,341
72,2,0,0,89,0,0,89,72,2
72,5,0,0,33,0,0,33,72,5
72,20,76,0,0,0,0,76,72,20
72,21,0,0,83,0,0,83,72,21
72,22,0,0,97,0,0,97,72,22
72,24,89,0,61,0,0,150,72,24
72,25,0,0,98,0,0,98,72,25
72,28,38,0,240,0,0,278,72,28
72,29,63,0,0,63,0,126,72,29
72,30,0,0,64,0,93,157,72,30
72,32,31,0,60,0,0,91,72,32
72,33,89,0,0,0,0,89,72,33
72,34,39,0,0,0,0,39,72,34
72,36,0,0,176,0,0,176,72,36
72,43,0,0,613,0,0,613,72,43
72,49,0,0,80,0,0,80,72,49
72,52,0,0,60,0,0,60,72,52
72,55,89,0,192,0,0,281,72,55
72,57,0,0,105,0,0,105,72,57
72,58,148,0,333,0,0,481,72,58
72,59,0,0,0,607,0,607,72,59
72,63,0,0,0,0,17,17,72,63
72,64,61,0,272,0,0,333,72,64
72,65,139,0,118,0,0,257,72,65
72,66,176,0,129,0,0,305,72,66
72,68,215,0,132,0,160,507,72,68
72,69,232,0,0,0,0,232,72,69
72,70,0,61,0,0,0,61,72,70
72,71,2083,1605,192,255,257,4392,72,71
72,72,441,5895,0,0,0,6336,72,72
72,73,177,325,60,90,0,652,72,73
72,75,212,0,61,61,0,334,72,75
72,78,0,0,156,0,129,285,72,78
72,79,176,0,23,0,0,199,72,79
72,80,0,0,41,0,0,41,72,80
72,81,0,0,192,0,256,448,72,81
72,82,0,0,327,0,0,327,72,82
72,83,0,0,97,0,0,97,72,83
72,84,61,0,0,0,0,61,72,84
72,87,0,0,41,0,0,41,72,87
72,88,276,0,260,0,0,536,72,88
72,89,0,0,48,0,0,48,72,89
72,91,31,0,0,0,0,31,72,91
72,97,40,0,0,0,0,40,72,97
72,98,0,0,76,0,0,76,72,98
72,104,21,0,0,0,0,21,72,104
72,106,61,288,0,0,0,349,72,106
72,117,0,0,826,0,0,826,72,117
72,128,38,0,0,0,0,38,72,128
72,135,0,0,170,0,0,170,72,135
72,138,0,0,110,0,0,110,72,138
72,144,350,0,0,0,0,350,72,144
72,152,0,0,187,0,0,187,72,152
72,169,202,0,0,0,0,202,72,169
72,174,0,0,0,315,0,315,72,174
72,180,0,0,388,0,0,388,72,180
72,208,0,0,268,0,0,268,72,208
72,217,0,0,266,0,0,266,72,217
72,226,0,0,732,0,0,732,72,226
72,230,0,0,306,0,0,306,72,230
72,237,26,0,0,0,0,26,72,237
72,245,0,0,234,0,0,234,72,245
72,246,0,0,166,0,0,166,72,246
72,256,0,0,295,0,0,295,72,256
72,257,0,0,433,0,0,433,72,257
72,265,0,0,100,0,0,100,72,265
72,268,744,996,192,47,0,1979,72,268
72,269,1811,254,0,0,0,2065,72,269
72,270,207,0,0,152,0,359,72,270
72,272,136,0,0,0,0,136,72,272
72,273,237,0,0,0,0,237,72,273
72,274,0,0,546,0,0,546,72,274
72,275,549,0,698,0,0,1247,72,275
72,276,176,0,647,0,0,823,72,276
72,277,1072,0,33,0,0,1105,72,277
72,278,632,0,273,0,0,905,72,278
72,280,143,0,67,0,0,210,72,280
72,281,581,0,0,0,0,581,72,281
72,282,284,0,60,0,0,344,72,282
72,283,0,0,153,0,0,153,72,283
72,288,122,0,0,0,0,122,72,288
72,291,879,0,0,0,0,879,72,291
72,293,0,0,596,0,0,596,72,293
72,295,0,0,895,0,0,895,72,295
72,297,0,0,39,0,0,39,72,297
72,298,301,0,1951,0,0,2252,72,298
72,300,1608,2683,206,383,256,5136,72,300
72,301,590,0,0,0,0,590,72,301
72,302,0,0,97,0,0,97,72,302
72,303,115,0,0,26,0,141,72,303
72,304,176,0,0,0,0,176,72,304
72,305,202,0,768,330,0,1300,72,305
72,307,0,0,0,613,0,613,72,307
72,310,0,0,139,0,0,139,72,310
72,312,0,0,85,0,0,85,72,312
72,316,44,0,0,89,0,133,72,316
72,317,14,0,0,0,0,14,72,317
72,318,192,0,110,700,0,1002,72,318
72,319,139,0,0,0,0,139,72,319
72,320,0,249,962,453,0,1664,72,320
72,321,575,0,0,0,0,575,72,321
72,323,0,0,758,0,0,758,72,323
72,327,127,0,35,356,0,518,72,327
72,328,243,0,0,0,0,243,72,328
72,329,102,0,55,0,0,157,72,329
72,330,882,0,1522,0,0,2404,72,330
72,331,0,0,306,0,0,306,72,331
72,335,0,0,455,0,0,455,72,335
72,338,0,0,268,0,0,268,72,338
72,339,31,0,0,0,0,31,72,339
73,2,0,0,94,0,0,94,73,2
73,3,0,0,156,0,0,156,73,3
73,4,0,0,416,0,0,416,73,4
73,5,0,0,76,0,0,76,73,5
73,6,0,0,169,0,0,169,73,6
73,10,0,0,129,0,0,129,73,10
73,16,55,0,155,0,0,210,73,16
73,17,0,0,82,0,0,82,73,17
73,18,84,0,0,0,0,84,73,18
73,19,42,0,60,0,0,102,73,19
73,20,0,0,0,76,0,76,73,20
73,21,321,0,83,0,0,404,73,21
73,22,0,0,178,0,0,178,73,22
73,23,0,0,570,56,0,626,73,23
73,24,0,0,205,0,0,205,73,24
73,25,0,0,0,0,285,285,73,25
73,27,0,0,1235,91,0,1326,73,27
73,28,263,0,178,145,0,586,73,28
73,29,0,0,68,76,0,144,73,29
73,30,369,0,147,64,0,580,73,30
73,31,0,0,665,0,0,665,73,31
73,32,21,0,133,0,0,154,73,32
73,33,72,0,0,0,0,72,73,33
73,34,92,0,73,0,0,165,73,34
73,35,268,0,818,0,0,1086,73,35
73,36,252,0,532,0,0,784,73,36
73,37,0,0,18,0,0,18,73,37
73,38,70,0,38,0,0,108,73,38
73,39,0,0,47,0,0,47,73,39
73,41,0,0,347,0,0,347,73,41
73,43,63,0,577,0,0,640,73,43
73,44,376,0,0,0,0,376,73,44
73,45,0,0,323,0,0,323,73,45
73,47,0,0,0,214,0,214,73,47
73,48,0,0,418,0,0,418,73,48
73,49,0,0,184,0,0,184,73,49
73,50,377,0,0,136,0,513,73,50
73,52,0,0,61,0,0,61,73,52
73,53,435,0,0,0,0,435,73,53
73,54,0,0,162,0,292,454,73,54
73,56,148,0,644,0,0,792,73,56
73,57,339,0,416,0,0,755,73,57
73,58,387,0,0,0,0,387,73,58
73,59,607,0,1053,0,0,1660,73,59
73,60,296,0,0,0,0,296,73,60
73,61,193,57,412,122,0,784,73,61
73,63,46,0,35,0,0,81,73,63
73,64,796,0,466,0,0,1262,73,64
73,65,726,297,86,231,161,1501,73,65
73,66,192,0,0,0,0,192,73,66
73,67,244,80,0,129,80,533,73,67
73,68,756,2340,180,121,0,3397,73,68
73,69,502,1040,87,201,231,2061,73,69
73,70,1044,1049,110,190,0,2393,73,70
73,71,1365,1144,82,421,0,3012,73,71
73,72,1080,325,60,90,0,1555,73,72
73,73,1129,49926,290,167,1264,52776,73,73
73,74,350,0,0,0,56,406,73,74
73,75,56,0,38,56,0,150,73,75
73,76,333,0,42,0,0,375,73,76
73,77,0,0,172,0,0,172,73,77
73,78,201,0,0,72,0,273,73,78
73,79,187,0,86,75,0,348,73,79
73,80,177,0,169,0,0,346,73,80
73,81,937,0,0,56,0,993,73,81
73,82,31,282,155,215,139,822,73,82
73,83,117,0,224,69,0,410,73,83
73,84,298,0,50,0,0,348,73,84
73,85,47,0,0,0,0,47,73,85
73,87,158,0,60,0,0,218,73,87
73,88,276,0,110,0,0,386,73,88
73,89,0,0,93,0,0,93,73,89
73,90,62,0,0,0,0,62,73,90
73,93,40,0,282,0,0,322,73,93
73,94,76,0,0,0,0,76,73,94
73,95,130,0,125,0,0,255,73,95
73,96,402,0,102,0,0,504,73,96
73,97,243,0,0,0,0,243,73,97
73,99,122,0,0,0,0,122,73,99
73,100,0,0,389,7,0,396,73,100
73,101,261,0,0,0,0,261,73,101
73,103,10,0,56,0,0,66,73,103
73,104,43,0,0,0,0,43,73,104
73,105,50,0,0,78,0,128,73,105
73,106,38,93,0,0,0,131,73,106
73,107,198,0,108,0,0,306,73,107
73,108,51,0,0,0,0,51,73,108
73,112,0,0,350,0,0,350,73,112
73,116,0,0,384,0,0,384,73,116
73,118,0,0,0,129,0,129,73,118
73,124,507,0,0,0,0,507,73,124
73,127,0,0,914,0,0,914,73,127
73,128,0,0,10,0,0,10,73,128
73,130,0,0,14,0,0,14,73,130
73,131,0,0,8,102,0,110,73,131
73,134,211,0,0,0,0,211,73,134
73,135,0,0,565,0,0,565,73,135
73,136,162,0,0,168,0,330,73,136
73,137,0,0,0,227,0,227,73,137
73,139,0,0,119,0,0,119,73,139
73,141,0,0,0,360,0,360,73,141
73,154,0,0,0,601,0,601,73,154
73,157,0,0,237,0,0,237,73,157
73,162,0,0,25,0,0,25,73,162
73,163,0,0,953,0,0,953,73,163
73,166,201,0,546,0,0,747,73,166
73,167,315,0,142,0,0,457,73,167
73,169,34,0,236,0,0,270,73,169
73,173,0,0,272,0,0,272,73,173
73,176,228,0,0,0,0,228,73,176
73,180,0,0,546,0,0,546,73,180
73,201,372,0,513,0,0,885,73,201
73,204,550,0,0,0,0,550,73,204
73,208,268,0,0,268,0,536,73,208
73,210,111,0,0,0,0,111,73,210
73,213,792,0,0,0,0,792,73,213
73,215,0,0,0,456,0,456,73,215
73,218,0,0,639,0,0,639,73,218
73,221,72,0,0,0,0,72,73,221
73,226,76,0,0,0,0,76,73,226
73,227,0,0,674,674,0,1348,73,227
73,234,0,0,506,0,0,506,73,234
73,237,26,0,102,0,0,128,73,237
73,238,0,0,135,0,0,135,73,238
73,239,134,0,22,0,0,156,73,239
73,240,201,0,0,0,0,201,73,240
73,241,222,0,0,0,0,222,73,241
73,245,0,0,127,0,0,127,73,245
73,246,227,0,124,0,0,351,73,246
73,252,0,0,144,0,0,144,73,252
73,254,0,0,248,0,0,248,73,254
73,257,433,0,0,0,0,433,73,257
73,258,0,0,809,0,0,809,73,258
73,261,0,0,892,0,0,892,73,261
73,268,73,36,254,36,53,452,73,268
73,269,396,373,86,0,0,855,73,269
73,270,64,0,69,64,0,197,73,270
73,272,38,0,0,0,0,38,73,272
73,273,436,0,300,0,0,736,73,273
73,274,0,0,173,159,0,332,73,274
73,275,594,0,0,0,0,594,73,275
73,278,0,0,460,0,0,460,73,278
73,280,248,0,213,0,0,461,73,280
73,281,796,0,275,159,0,1230,73,281
73,282,0,0,61,0,0,61,73,282
73,283,49,0,394,0,0,443,73,283
73,284,955,0,870,0,0,1825,73,284
73,285,0,0,1578,0,0,1578,73,285
73,286,0,0,36,0,0,36,73,286
73,287,106,0,0,0,0,106,73,287
73,288,94,0,0,0,0,94,73,288
73,289,0,0,1472,0,0,1472,73,289
73,291,0,0,1550,0,0,1550,73,291
73,292,233,0,999,0,0,1232,73,292
73,293,0,0,808,0,0,808,73,293
73,294,0,0,1720,0,0,1720,73,294
73,295,0,0,395,0,0,395,73,295
73,298,0,0,1100,0,0,1100,73,298
73,300,645,168,522,330,0,1665,73,300
73,301,0,0,339,0,0,339,73,301
73,302,85,0,198,397,0,680,73,302
73,303,657,0,136,0,0,793,73,303
73,304,0,0,1364,0,0,1364,73,304
73,305,0,0,2986,330,0,3316,73,305
73,307,0,0,325,0,0,325,73,307
73,308,0,0,220,0,0,220,73,308
73,309,0,0,551,0,0,551,73,309
73,311,740,0,1268,0,0,2008,73,311
73,312,0,0,259,0,0,259,73,312
73,313,0,0,587,0,0,587,73,313
73,314,899,0,1282,0,0,2181,73,314
73,315,0,0,1366,0,0,1366,73,315
73,316,311,0,0,0,0,311,73,316
73,317,106,0,0,64,0,170,73,317
73,318,0,0,795,103,0,898,73,318
73,319,128,14,80,17,0,239,73,319
73,321,1491,0,275,205,161,2132,73,321
73,322,895,0,0,397,0,1292,73,322
73,323,539,0,1029,0,0,1568,73,323
73,326,0,0,45,0,0,45,73,326
73,327,246,0,41,0,0,287,73,327
73,328,595,0,291,0,0,886,73,328
73,329,327,0,670,0,0,997,73,329
73,330,0,0,234,0,0,234,73,330
73,332,0,0,494,0,0,494,73,332
73,334,2025,0,263,0,0,2288,73,334
73,336,0,0,505,0,0,505,73,336
73,337,132,0,755,0,0,887,73,337
73,338,0,0,0,109,0,109,73,338
73,339,305,0,0,0,0,305,73,339
73,340,37,0,63,0,0,100,73,340
73,341,77,0,0,0,0,77,73,341
73,342,0,0,1906,0,0,1906,73,342
74,1,0,0,39,0,0,39,74,1
74,2,0,0,303,0,0,303,74,2
74,3,0,0,306,0,0,306,74,3
74,4,0,0,191,910,0,1101,74,4
74,7,882,83,0,0,0,965,74,7
74,12,124,0,0,0,0,124,74,12
74,13,0,0,42,0,0,42,74,13
74,14,196,0,0,0,0,196,74,14
74,15,53,0,24,0,0,77,74,15
74,20,0,0,322,254,0,576,74,20
74,21,0,0,78,83,0,161,74,21
74,22,0,0,98,0,0,98,74,22
74,23,0,457,154,0,0,611,74,23
74,24,77,0,0,36,0,113,74,24
74,25,336,0,0,0,0,336,74,25
74,26,0,167,0,0,0,167,74,26
74,27,353,1414,0,55,0,1822,74,27
74,28,111,2572,0,0,0,2683,74,28
74,29,350,1308,59,23,0,1740,74,29
74,30,0,44,192,0,0,236,74,30
74,31,39,55,89,30,0,213,74,31
74,32,133,793,156,87,0,1169,74,32
74,33,7,0,0,0,0,7,74,33
74,34,98,39,0,0,0,137,74,34
74,36,229,0,143,0,0,372,74,36
74,40,0,0,26,0,0,26,74,40
74,42,0,0,21,0,0,21,74,42
74,43,132,0,55,0,0,187,74,43
74,44,0,0,152,0,0,152,74,44
74,47,955,0,0,0,0,955,74,47
74,49,98,10,242,55,0,405,74,49
74,50,0,0,0,62,0,62,74,50
74,51,0,0,104,0,0,104,74,51
74,52,62,0,202,0,0,264,74,52
74,53,0,0,201,0,168,369,74,53
74,54,0,0,85,0,0,85,74,54
74,55,0,0,185,0,0,185,74,55
74,56,0,381,55,0,0,436,74,56
74,57,671,2257,211,239,284,3662,74,57
74,58,100,0,389,0,0,489,74,58
74,60,0,0,527,0,0,527,74,60
74,61,513,0,394,0,0,907,74,61
74,62,27,98,59,26,0,210,74,62
74,64,120,0,0,0,0,120,74,64
74,65,231,0,0,0,0,231,74,65
74,66,58,0,0,0,0,58,74,66
74,67,98,0,0,0,0,98,74,67
74,68,554,0,427,182,142,1305,74,68
74,69,80,0,307,24,0,411,74,69
74,70,180,0,95,0,0,275,74,70
74,71,291,0,0,0,0,291,74,71
74,73,251,0,0,0,56,307,74,73
74,74,175,8507,0,0,0,8682,74,74
74,75,168,626,0,0,0,794,74,75
74,76,358,55,42,0,0,455,74,76
74,77,0,0,106,0,0,106,74,77
74,78,349,362,0,159,0,870,74,78
74,79,486,1184,224,269,59,2222,74,79
74,80,44,0,228,267,0,539,74,80
74,81,150,0,284,56,0,490,74,81
74,82,62,0,441,0,0,503,74,82
74,83,0,0,295,0,0,295,74,83
74,84,102,0,94,0,0,196,74,84
74,85,24,0,0,0,0,24,74,85
74,86,18,0,0,32,0,50,74,86
74,87,227,0,54,98,0,379,74,87
74,88,98,0,488,138,0,724,74,88
74,89,201,0,0,0,0,201,74,89
74,93,0,0,483,0,0,483,74,93
74,94,0,0,176,139,0,315,74,94
74,95,0,0,144,0,0,144,74,95
74,96,98,0,0,0,0,98,74,96
74,97,0,0,70,0,0,70,74,97
74,99,0,0,37,0,0,37,74,99
74,100,0,0,456,0,0,456,74,100
74,101,130,0,261,0,0,391,74,101
74,102,0,0,39,0,0,39,74,102
74,105,0,0,192,0,0,192,74,105
74,106,0,0,54,0,0,54,74,106
74,108,0,0,0,23,0,23,74,108
74,109,0,0,725,0,0,725,74,109
74,110,0,0,267,0,0,267,74,110
74,112,0,0,399,0,0,399,74,112
74,115,0,0,427,0,0,427,74,115
74,116,312,0,1184,0,0,1496,74,116
74,126,0,0,362,0,0,362,74,126
74,127,0,0,50,0,0,50,74,127
74,128,0,0,15,0,0,15,74,128
74,129,35,0,124,98,0,257,74,129
74,131,0,0,229,0,0,229,74,131
74,135,0,0,565,0,0,565,74,135
74,136,0,0,170,0,0,170,74,136
74,138,0,0,94,0,0,94,74,138
74,140,0,0,152,0,0,152,74,140
74,141,0,0,700,0,0,700,74,141
74,144,416,0,824,0,0,1240,74,144
74,152,0,0,187,0,0,187,74,152
74,162,98,0,0,0,0,98,74,162
74,168,0,0,98,0,0,98,74,168
74,169,0,0,26,0,0,26,74,169
74,170,0,0,189,0,0,189,74,170
74,172,0,0,258,0,0,258,74,172
74,176,0,0,228,0,0,228,74,176
74,180,0,0,388,0,0,388,74,180
74,181,0,0,140,0,0,140,74,181
74,197,0,0,615,0,0,615,74,197
74,198,0,0,246,0,0,246,74,198
74,203,0,0,190,0,0,190,74,203
74,207,0,0,361,0,0,361,74,207
74,209,0,0,0,206,0,206,74,209
74,211,677,0,0,0,0,677,74,211
74,214,0,0,228,0,0,228,74,214
74,215,0,0,193,0,0,193,74,215
74,217,0,0,25,0,0,25,74,217
74,218,0,0,390,0,0,390,74,218
74,222,0,0,361,0,0,361,74,222
74,231,0,0,310,0,0,310,74,231
74,235,0,0,553,0,0,553,74,235
74,236,0,0,156,0,0,156,74,236
74,237,0,0,222,0,0,222,74,237
74,239,0,0,192,110,0,302,74,239
74,240,55,0,0,0,0,55,74,240
74,241,0,0,174,0,0,174,74,241
74,244,0,0,337,0,0,337,74,244
74,246,0,0,113,0,0,113,74,246
74,249,0,0,608,0,0,608,74,249
74,252,0,0,144,0,0,144,74,252
74,254,109,0,698,0,0,807,74,254
74,257,0,0,255,0,0,255,74,257
74,263,87,0,0,0,0,87,74,263
74,266,114,0,0,0,0,114,74,266
74,268,0,0,86,0,0,86,74,268
74,269,262,0,151,0,0,413,74,269
74,270,54,0,0,0,0,54,74,270
74,272,174,0,37,0,0,211,74,272
74,274,0,0,49,0,0,49,74,274
74,276,0,0,276,0,0,276,74,276
74,280,143,0,0,0,0,143,74,280
74,286,55,0,0,0,0,55,74,286
74,291,0,0,785,0,0,785,74,291
74,295,0,0,555,0,0,555,74,295
74,298,0,0,308,0,0,308,74,298
74,300,284,0,423,39,0,746,74,300
74,302,85,0,118,0,0,203,74,302
74,303,107,0,91,0,0,198,74,303
74,304,98,0,452,0,0,550,74,304
74,311,0,0,806,0,0,806,74,311
74,316,0,0,95,0,0,95,74,316
74,317,14,0,0,0,0,14,74,317
74,318,0,0,59,0,0,59,74,318
74,319,25,0,0,17,0,42,74,319
74,321,111,0,111,0,0,222,74,321
74,323,0,0,317,0,0,317,74,323
74,327,126,0,0,0,0,126,74,327
74,329,120,0,0,0,0,120,74,329
74,331,0,0,268,0,0,268,74,331
74,334,425,0,460,0,0,885,74,334
74,337,452,0,203,0,0,655,74,337
74,339,0,0,87,0,0,87,74,339
74,341,91,0,0,0,0,91,74,341
74,342,0,0,296,0,0,296,74,342
75,1,0,0,261,0,0,261,75,1
75,2,46,0,187,0,0,233,75,2
75,4,70,0,38,0,0,108,75,4
75,5,112,0,538,0,0,650,75,5
75,6,0,0,0,56,0,56,75,6
75,7,0,0,100,0,0,100,75,7
75,16,0,0,56,0,0,56,75,16
75,19,0,0,38,0,0,38,75,19
75,21,0,0,42,0,0,42,75,21
75,22,67,0,0,0,0,67,75,22
75,23,56,0,502,0,0,558,75,23
75,24,0,0,61,0,0,61,75,24
75,25,0,0,76,0,0,76,75,25
75,26,126,0,288,0,0,414,75,26
75,27,252,592,0,0,0,844,75,27
75,28,320,776,0,93,0,1189,75,28
75,29,408,124,0,58,0,590,75,29
75,30,290,0,0,0,0,290,75,30
75,31,71,0,151,155,0,377,75,31
75,32,190,0,116,187,0,493,75,32
75,34,39,0,0,35,0,74,75,34
75,36,0,0,61,0,0,61,75,36
75,39,0,0,0,78,0,78,75,39
75,42,0,0,0,35,0,35,75,42
75,44,47,0,0,0,0,47,75,44
75,52,0,0,154,0,0,154,75,52
75,53,35,0,0,0,0,35,75,53
75,54,0,0,117,0,0,117,75,54
75,55,0,0,0,35,0,35,75,55
75,56,218,0,38,149,0,405,75,56
75,57,696,351,76,112,0,1235,75,57
75,58,126,0,0,0,0,126,75,58
75,59,0,0,393,0,0,393,75,59
75,60,205,0,0,0,0,205,75,60
75,61,35,0,0,0,0,35,75,61
75,62,263,328,29,0,246,866,75,62
75,63,23,0,61,0,0,84,75,63
75,64,35,0,0,0,0,35,75,64
75,66,35,0,61,35,0,131,75,66
75,67,127,56,0,0,0,183,75,67
75,68,577,0,122,95,0,794,75,68
75,69,35,0,174,0,0,209,75,69
75,70,35,0,91,0,0,126,75,70
75,72,272,0,61,61,0,394,75,72
75,73,56,0,609,56,0,721,75,73
75,74,267,376,59,56,0,758,75,74
75,75,1421,6465,0,35,0,7921,75,75
75,76,260,703,0,534,0,1497,75,76
75,77,161,35,56,56,0,308,75,77
75,78,35,466,0,56,0,557,75,78
75,79,538,1260,96,259,0,2153,75,79
75,80,0,44,35,100,0,179,75,80
75,81,35,0,61,163,0,259,75,81
75,82,149,0,134,0,0,283,75,82
75,83,160,0,0,0,0,160,75,83
75,84,102,0,0,238,0,340,75,84
75,85,0,0,0,35,0,35,75,85
75,88,276,0,0,138,0,414,75,88
75,90,0,0,102,0,0,102,75,90
75,92,0,0,35,0,0,35,75,92
75,93,56,0,209,0,0,265,75,93
75,94,56,0,0,0,0,56,75,94
75,95,102,0,0,0,0,102,75,95
75,96,0,0,61,0,0,61,75,96
75,97,35,0,0,0,0,35,75,97
75,100,56,0,0,112,0,168,75,100
75,101,56,0,0,0,0,56,75,101
75,102,56,0,0,0,0,56,75,102
75,105,56,0,0,0,0,56,75,105
75,110,0,0,35,0,0,35,75,110
75,118,15,0,0,0,0,15,75,118
75,119,417,0,0,0,0,417,75,119
75,136,0,0,139,0,0,139,75,136
75,139,0,0,97,0,0,97,75,139
75,148,0,0,82,0,0,82,75,148
75,152,0,0,226,0,0,226,75,152
75,153,56,0,0,0,0,56,75,153
75,165,0,0,35,0,0,35,75,165
75,170,0,0,436,0,0,436,75,170
75,176,0,0,582,0,0,582,75,176
75,180,0,0,630,0,0,630,75,180
75,191,0,0,61,0,0,61,75,191
75,201,56,0,0,0,0,56,75,201
75,203,0,0,207,0,0,207,75,203
75,206,56,0,0,0,0,56,75,206
75,209,721,0,0,0,0,721,75,209
75,219,56,0,0,0,0,56,75,219
75,226,0,0,521,0,0,521,75,226
75,227,0,0,295,0,0,295,75,227
75,236,33,0,0,0,0,33,75,236
75,237,0,0,58,0,0,58,75,237
75,240,35,0,0,0,0,35,75,240
75,243,56,0,0,0,0,56,75,243
75,245,0,0,117,0,0,117,75,245
75,269,56,0,16,0,0,72,75,269
75,270,56,0,0,0,0,56,75,270
75,274,35,0,0,0,0,35,75,274
75,278,274,0,395,0,0,669,75,278
75,283,109,0,0,0,0,109,75,283
75,286,17,0,0,0,0,17,75,286
75,295,0,0,469,0,0,469,75,295
75,300,46,0,139,0,0,185,75,300
75,301,0,0,86,0,0,86,75,301
75,302,91,0,0,0,0,91,75,302
75,303,0,0,29,0,0,29,75,303
75,314,19,0,0,0,0,19,75,314
75,316,72,0,0,0,0,72,75,316
75,319,0,0,0,35,0,35,75,319
75,320,0,0,123,0,0,123,75,320
75,324,0,0,892,0,0,892,75,324
75,327,56,0,30,0,0,86,75,327
75,329,0,0,0,69,0,69,75,329
75,331,0,0,547,0,0,547,75,331
75,336,0,0,469,0,0,469,75,336
75,338,0,0,701,0,0,701,75,338
75,339,91,0,0,0,0,91,75,339
75,340,13,0,0,0,0,13,75,340
76,1,61,0,189,0,0,250,76,1
76,3,0,0,38,0,0,38,76,3
76,4,0,0,495,0,0,495,76,4
76,5,0,0,69,0,0,69,76,5
76,6,0,0,321,0,0,321,76,6
76,7,0,0,42,0,0,42,76,7
76,10,0,0,11,0,0,11,76,10
76,21,165,0,0,0,0,165,76,21
76,22,38,0,73,0,0,111,76,22
76,23,557,56,0,0,111,724,76,23
76,24,77,0,84,0,0,161,76,24
76,25,162,0,0,0,0,162,76,25
76,26,154,0,0,0,0,154,76,26
76,27,204,0,101,0,0,305,76,27
76,28,38,0,152,0,0,190,76,28
76,29,245,38,34,70,0,387,76,29
76,30,361,0,0,0,0,361,76,30
76,31,348,0,109,0,0,457,76,31
76,32,36,38,91,0,0,165,76,32
76,33,38,0,0,0,0,38,76,33
76,34,39,0,0,0,0,39,76,34
76,35,28,0,0,0,0,28,76,35
76,36,466,0,294,0,0,760,76,36
76,37,0,0,41,0,0,41,76,37
76,41,0,0,26,0,0,26,76,41
76,45,204,0,0,0,0,204,76,45
76,49,0,0,38,34,0,72,76,49
76,50,70,0,0,0,0,70,76,50
76,53,93,38,77,0,0,208,76,53
76,54,114,0,110,38,0,262,76,54
76,56,283,104,322,143,81,933,76,56
76,57,626,623,0,66,0,1315,76,57
76,59,0,0,173,0,0,173,76,59
76,61,38,0,42,0,0,80,76,61
76,62,67,296,29,0,0,392,76,62
76,63,0,0,0,6,0,6,76,63
76,65,77,0,0,28,0,105,76,65
76,66,344,0,0,0,0,344,76,66
76,67,241,879,60,0,0,1180,76,67
76,68,454,443,197,243,0,1337,76,68
76,69,80,0,0,73,0,153,76,69
76,70,68,0,0,0,0,68,76,70
76,71,0,0,0,131,0,131,76,71
76,73,333,0,42,0,0,375,76,73
76,74,260,55,42,0,0,357,76,74
76,75,329,704,0,534,0,1567,76,75
76,76,287,4310,233,57,0,4887,76,76
76,77,0,38,41,178,0,257,76,77
76,78,472,1078,95,61,0,1706,76,78
76,79,233,154,155,128,0,670,76,79
76,80,162,98,33,0,0,293,76,80
76,81,716,275,0,34,0,1025,76,81
76,82,0,0,76,0,0,76,76,82
76,83,105,0,0,0,0,105,76,83
76,84,51,0,51,201,0,303,76,84
76,85,24,0,0,0,0,24,76,85
76,86,0,0,0,58,0,58,76,86
76,87,94,0,0,0,0,94,76,87
76,89,0,0,52,0,0,52,76,89
76,91,57,0,0,0,0,57,76,91
76,92,0,0,34,0,0,34,76,92
76,94,97,0,38,0,0,135,76,94
76,95,102,0,0,0,0,102,76,95
76,96,102,0,0,0,0,102,76,96
76,97,108,0,0,0,0,108,76,97
76,99,38,0,0,0,0,38,76,99
76,100,127,0,0,0,0,127,76,100
76,102,77,0,0,0,0,77,76,102
76,104,0,0,51,21,0,72,76,104
76,105,50,0,0,0,0,50,76,105
76,107,77,0,0,0,0,77,76,107
76,109,158,0,0,0,0,158,76,109
76,111,0,0,329,0,0,329,76,111
76,113,90,0,0,0,0,90,76,113
76,116,0,0,300,0,0,300,76,116
76,118,0,0,141,0,0,141,76,118
76,122,0,1098,0,0,0,1098,76,122
76,127,214,0,137,0,0,351,76,127
76,128,0,0,56,0,0,56,76,128
76,129,0,0,31,0,0,31,76,129
76,133,1035,0,0,0,0,1035,76,133
76,136,200,0,0,0,0,200,76,136
76,145,0,0,34,0,0,34,76,145
76,154,451,0,0,0,0,451,76,154
76,162,0,0,340,0,0,340,76,162
76,164,28,0,0,0,0,28,76,164
76,167,77,0,0,0,0,77,76,167
76,169,77,0,0,0,0,77,76,169
76,172,34,0,0,0,0,34,76,172
76,173,77,0,0,0,0,77,76,173
76,174,357,0,0,0,0,357,76,174
76,177,56,0,0,0,0,56,76,177
76,180,0,0,390,0,0,390,76,180
76,191,0,0,38,0,0,38,76,191
76,194,0,0,127,0,0,127,76,194
76,203,0,0,190,0,0,190,76,203
76,210,38,0,0,0,0,38,76,210
76,214,0,0,124,0,0,124,76,214
76,225,0,0,146,0,0,146,76,225
76,236,0,0,34,0,0,34,76,236
76,238,338,0,38,0,0,376,76,238
76,239,0,0,34,0,0,34,76,239
76,241,0,0,100,0,0,100,76,241
76,248,38,0,0,0,0,38,76,248
76,251,428,0,0,0,0,428,76,251
76,252,62,0,0,0,0,62,76,252
76,268,38,0,0,0,0,38,76,268
76,269,72,0,0,0,0,72,76,269
76,270,105,0,0,0,0,105,76,270
76,273,436,0,0,0,0,436,76,273
76,274,0,0,115,0,0,115,76,274
76,275,122,0,0,0,0,122,76,275
76,276,0,0,601,0,0,601,76,276
76,277,0,0,266,0,0,266,76,277
76,280,0,0,59,0,0,59,76,280
76,281,304,0,173,0,0,477,76,281
76,283,0,0,54,0,0,54,76,283
76,284,1203,0,0,0,0,1203,76,284
76,287,0,0,315,0,0,315,76,287
76,294,0,0,589,0,0,589,76,294
76,298,261,0,272,0,0,533,76,298
76,300,193,0,0,0,0,193,76,300
76,301,79,0,0,0,0,79,76,301
76,304,0,0,1115,0,0,1115,76,304
76,305,570,0,0,0,0,570,76,305
76,307,0,0,0,154,0,154,76,307
76,309,0,0,631,0,0,631,76,309
76,315,0,0,378,321,0,699,76,315
76,317,38,0,16,0,0,54,76,317
76,318,0,0,0,103,0,103,76,318
76,319,153,0,0,0,21,174,76,319
76,321,38,0,0,0,0,38,76,321
76,322,38,0,0,0,0,38,76,322
76,323,436,0,584,0,0,1020,76,323
76,326,0,0,542,0,0,542,76,326
76,327,154,0,0,38,0,192,76,327
76,328,0,0,179,0,0,179,76,328
76,329,89,0,388,0,0,477,76,329
76,339,0,0,74,0,0,74,76,339
76,340,147,0,0,0,0,147,76,340
76,341,115,0,0,0,0,115,76,341
77,1,0,0,595,0,0,595,77,1
77,2,0,0,140,0,0,140,77,2
77,3,135,0,0,0,0,135,77,3
77,4,0,0,241,0,0,241,77,4
77,5,0,0,531,0,0,531,77,5
77,6,0,0,472,740,0,1212,77,6
77,9,0,0,92,0,0,92,77,9
77,11,22,0,12,0,0,34,77,11
77,12,0,0,68,0,0,68,77,12
77,14,0,0,105,0,0,105,77,14
77,15,0,0,127,0,0,127,77,15
77,21,0,0,0,143,0,143,77,21
77,22,0,0,94,0,0,94,77,22
77,23,140,0,545,0,0,685,77,23
77,24,38,0,38,0,0,76,77,24
77,25,0,0,176,38,0,214,77,25
77,27,199,0,534,230,0,963,77,27
77,28,60,0,250,0,0,310,77,28
77,29,0,237,339,0,0,576,77,29
77,30,127,0,51,476,0,654,77,30
77,31,348,0,167,0,56,571,77,31
77,32,76,509,278,0,0,863,77,32
77,33,44,15,8,57,0,124,77,33
77,34,89,0,39,86,0,214,77,34
77,35,0,0,473,0,0,473,77,35
77,36,0,0,0,232,0,232,77,36
77,37,140,0,0,357,45,542,77,37
77,40,0,0,10,0,0,10,77,40
77,41,0,0,1046,52,0,1098,77,41
77,43,0,0,98,0,0,98,77,43
77,45,0,0,140,0,0,140,77,45
77,49,0,0,65,0,0,65,77,49
77,51,104,0,104,0,0,208,77,51
77,52,182,0,140,38,0,360,77,52
77,53,58,0,0,0,0,58,77,53
77,54,14,0,140,0,0,154,77,54
77,55,0,0,238,196,0,434,77,55
77,56,0,0,194,0,215,409,77,56
77,58,0,0,331,0,0,331,77,58
77,59,0,0,886,0,0,886,77,59
77,61,353,0,0,0,0,353,77,61
77,62,27,0,0,27,0,54,77,62
77,63,26,0,518,0,0,544,77,63
77,65,116,0,0,0,0,116,77,65
77,66,78,0,0,0,0,78,77,66
77,68,316,476,323,592,0,1707,77,68
77,70,0,0,53,60,0,113,77,70
77,71,47,0,0,0,0,47,77,71
77,73,27,0,0,140,0,167,77,73
77,74,0,0,373,0,0,373,77,74
77,75,91,35,0,56,0,182,77,75
77,76,0,38,41,178,0,257,77,76
77,77,248,12810,0,6209,0,19267,77,77
77,78,438,440,102,349,0,1329,77,78
77,79,41,2104,292,142,0,2579,77,79
77,80,1207,1516,247,119,0,3089,77,80
77,81,387,38,42,43,0,510,77,81
77,82,667,442,263,776,0,2148,77,82
77,83,562,720,138,0,0,1420,77,83
77,84,382,0,0,102,0,484,77,84
77,85,43,0,26,0,0,69,77,85
77,86,18,64,0,20,0,102,77,86
77,87,386,240,297,33,206,1162,77,87
77,88,278,138,560,0,0,976,77,88
77,89,197,0,52,0,0,249,77,89
77,90,123,0,0,0,0,123,77,90
77,91,280,0,0,0,0,280,77,91
77,93,40,0,152,0,0,192,77,93
77,94,51,0,0,109,0,160,77,94
77,95,0,0,0,0,148,148,77,95
77,96,165,0,0,0,0,165,77,96
77,97,89,0,139,0,0,228,77,97
77,99,0,0,374,0,0,374,77,99
77,101,0,328,142,273,0,743,77,101
77,102,36,0,53,0,0,89,77,102
77,103,0,0,25,0,0,25,77,103
77,104,0,0,0,21,0,21,77,104
77,105,50,0,441,0,0,491,77,105
77,106,0,0,91,0,0,91,77,106
77,109,0,0,1072,0,0,1072,77,109
77,113,269,0,300,0,0,569,77,113
77,117,0,0,337,0,0,337,77,117
77,123,0,0,647,0,0,647,77,123
77,124,183,0,0,0,0,183,77,124
77,126,0,0,89,0,0,89,77,126
77,129,38,0,389,0,0,427,77,129
77,134,78,0,0,0,0,78,77,134
77,136,162,0,0,0,0,162,77,136
77,139,262,0,0,0,0,262,77,139
77,142,0,0,811,0,0,811,77,142
77,145,0,0,25,0,0,25,77,145
77,150,0,0,314,0,0,314,77,150
77,152,0,0,410,0,0,410,77,152
77,153,0,0,314,0,0,314,77,153
77,156,0,0,98,0,0,98,77,156
77,165,0,0,30,0,0,30,77,165
77,168,58,0,204,0,0,262,77,168
77,182,0,0,473,0,0,473,77,182
77,184,0,0,185,0,0,185,77,184
77,190,0,0,116,0,0,116,77,190
77,192,0,0,276,0,0,276,77,192
77,197,101,0,0,0,0,101,77,197
77,202,0,0,444,0,0,444,77,202
77,213,0,0,143,0,0,143,77,213
77,218,0,0,639,0,0,639,77,218
77,219,0,0,0,343,0,343,77,219
77,226,0,0,1172,0,0,1172,77,226
77,229,0,0,365,0,0,365,77,229
77,230,0,0,0,306,0,306,77,230
77,231,0,0,165,0,0,165,77,231
77,237,0,0,72,0,0,72,77,237
77,238,0,0,309,0,0,309,77,238
77,239,60,0,0,0,0,60,77,239
77,242,0,0,588,0,0,588,77,242
77,246,0,0,114,0,0,114,77,246
77,253,0,0,24,0,0,24,77,253
77,254,0,0,13,0,0,13,77,254
77,258,0,0,417,0,0,417,77,258
77,259,0,0,196,0,0,196,77,259
77,268,36,0,38,0,0,74,77,268
77,271,0,0,0,140,0,140,77,271
77,272,0,0,40,0,0,40,77,272
77,273,280,0,0,0,0,280,77,273
77,274,0,0,159,0,0,159,77,274
77,275,0,0,274,0,0,274,77,275
77,277,244,0,244,0,0,488,77,277
77,278,0,0,395,0,0,395,77,278
77,279,0,0,1175,0,0,1175,77,279
77,280,0,0,570,0,0,570,77,280
77,281,0,0,159,0,0,159,77,281
77,283,0,0,112,0,0,112,77,283
77,286,199,0,0,0,0,199,77,286
77,291,0,0,498,0,0,498,77,291
77,294,0,0,486,0,0,486,77,294
77,295,1389,0,431,0,0,1820,77,295
77,298,0,0,308,0,0,308,77,298
77,300,139,0,0,0,0,139,77,300
77,301,0,0,0,79,0,79,77,301
77,305,0,0,202,0,0,202,77,305
77,307,0,0,325,0,0,325,77,307
77,308,0,0,391,0,0,391,77,308
77,309,0,0,0,153,0,153,77,309
77,310,0,0,259,0,0,259,77,310
77,315,0,0,172,0,0,172,77,315
77,316,0,0,124,0,0,124,77,316
77,319,0,0,18,12,0,30,77,319
77,320,35,0,299,0,0,334,77,320
77,322,77,0,0,276,0,353,77,322
77,323,0,0,539,0,0,539,77,323
77,325,0,0,279,0,0,279,77,325
77,327,92,0,0,0,0,92,77,327
77,328,664,0,0,0,0,664,77,328
77,329,102,0,0,526,0,628,77,329
77,330,0,0,1314,0,0,1314,77,330
77,331,0,0,547,0,0,547,77,331
77,332,0,0,463,0,0,463,77,332
77,333,0,0,536,0,0,536,77,333
77,336,0,0,380,0,0,380,77,336
77,339,72,0,125,0,0,197,77,339
77,340,0,0,77,0,0,77,77,340
77,341,205,0,139,0,0,344,77,341
77,342,280,0,373,0,0,653,77,342
78,1,407,0,121,0,0,528,78,1
78,2,102,0,48,0,89,239,78,2
78,3,0,0,0,102,0,102,78,3
78,4,88,0,89,0,0,177,78,4
78,5,0,0,400,0,0,400,78,5
78,6,102,0,0,203,148,453,78,6
78,7,173,0,0,0,0,173,78,7
78,9,0,0,113,0,0,113,78,9
78,17,0,0,102,0,0,102,78,17
78,19,230,0,0,0,0,230,78,19
78,20,555,0,0,254,0,809,78,20
78,21,0,0,0,83,0,83,78,21
78,22,0,0,97,0,0,97,78,22
78,23,0,0,203,0,0,203,78,23
78,24,0,0,122,0,0,122,78,24
78,25,0,97,807,72,0,976,78,25
78,26,0,0,366,0,0,366,78,26
78,27,393,78,293,102,256,1122,78,27
78,28,315,61,72,140,0,588,78,28
78,29,324,203,0,309,0,836,78,29
78,30,904,0,95,102,0,1101,78,30
78,31,137,183,0,102,0,422,78,31
78,32,334,685,391,160,0,1570,78,32
78,34,314,0,61,0,0,375,78,34
78,36,102,0,160,88,0,350,78,36
78,37,0,0,111,0,0,111,78,37
78,41,121,0,33,0,0,154,78,41
78,43,126,0,170,98,0,394,78,43
78,45,268,0,0,0,0,268,78,45
78,49,151,0,10,222,104,487,78,49
78,53,0,0,72,0,0,72,78,53
78,54,88,0,173,88,0,349,78,54
78,55,480,0,164,0,0,644,78,55
78,57,0,102,204,160,0,466,78,57
78,58,10,0,88,0,0,98,78,58
78,59,0,0,710,0,0,710,78,59
78,60,69,0,0,0,0,69,78,60
78,61,0,0,135,0,0,135,78,61
78,62,102,75,0,72,0,249,78,62
78,63,11,0,0,0,0,11,78,63
78,64,88,0,0,7,0,95,78,64
78,65,116,0,0,0,0,116,78,65
78,66,135,0,0,98,0,233,78,66
78,67,80,0,10,55,0,145,78,67
78,68,485,0,271,102,104,962,78,68
78,70,88,0,179,0,0,267,78,70
78,71,98,0,210,102,0,410,78,71
78,72,0,0,156,0,129,285,78,72
78,73,134,0,0,10,0,144,78,73
78,74,277,133,143,231,0,784,78,74
78,75,0,556,0,56,0,612,78,75
78,76,431,1078,147,90,0,1746,78,76
78,77,249,541,102,349,0,1241,78,77
78,78,187,7852,0,369,0,8408,78,78
78,79,992,1886,102,225,0,3205,78,79
78,80,0,44,99,72,0,215,78,80
78,81,506,0,14,229,0,749,78,81
78,82,759,0,63,307,0,1129,78,82
78,83,187,0,344,0,0,531,78,83
78,84,138,0,51,96,0,285,78,84
78,85,178,0,26,0,0,204,78,85
78,86,64,0,0,36,0,100,78,86
78,87,203,0,0,0,0,203,78,87
78,88,162,0,248,101,0,511,78,88
78,89,0,0,95,96,0,191,78,89
78,90,189,0,62,0,0,251,78,90
78,91,0,0,0,62,0,62,78,91
78,92,0,0,72,0,0,72,78,92
78,93,0,0,10,102,0,112,78,93
78,94,0,0,78,62,0,140,78,94
78,95,204,0,0,0,0,204,78,95
78,96,163,0,0,0,0,163,78,96
78,97,23,0,0,0,0,23,78,97
78,101,203,0,0,0,0,203,78,101
78,102,0,0,61,10,0,71,78,102
78,104,0,0,45,0,0,45,78,104
78,105,9,0,0,0,0,9,78,105
78,107,0,0,0,118,0,118,78,107
78,118,129,0,0,0,0,129,78,118
78,128,102,0,0,0,0,102,78,128
78,131,0,0,72,0,0,72,78,131
78,135,0,0,565,0,0,565,78,135
78,138,0,0,26,0,0,26,78,138
78,142,0,0,541,0,0,541,78,142
78,144,0,0,742,0,0,742,78,144
78,163,238,0,0,0,0,238,78,163
78,166,102,0,0,0,0,102,78,166
78,168,0,0,0,207,0,207,78,168
78,169,0,0,34,0,0,34,78,169
78,180,0,0,546,0,0,546,78,180
78,188,102,0,0,0,0,102,78,188
78,197,95,0,0,0,0,95,78,197
78,200,0,0,149,0,0,149,78,200
78,203,0,0,440,0,0,440,78,203
78,210,111,0,0,0,0,111,78,210
78,229,0,0,365,0,0,365,78,229
78,238,0,0,135,0,0,135,78,238
78,247,0,0,894,0,0,894,78,247
78,251,200,0,0,0,0,200,78,251
78,268,0,0,40,0,0,40,78,268
78,269,28,0,0,67,0,95,78,269
78,272,0,0,136,0,0,136,78,272
78,277,0,0,698,0,0,698,78,277
78,286,0,0,18,0,0,18,78,286
78,289,410,0,0,0,0,410,78,289
78,294,0,0,667,0,0,667,78,294
78,295,0,0,895,0,0,895,78,295
78,298,102,0,529,0,0,631,78,298
78,299,0,0,109,0,0,109,78,299
78,300,156,0,102,0,414,672,78,300
78,303,0,0,0,189,0,189,78,303
78,307,0,0,768,0,0,768,78,307
78,312,141,0,584,0,0,725,78,312
78,315,185,0,0,185,0,370,78,315
78,316,72,0,48,0,0,120,78,316
78,317,134,0,118,0,0,252,78,317
78,319,28,0,18,88,0,134,78,319
78,320,0,0,123,0,0,123,78,320
78,321,111,0,0,0,0,111,78,321
78,322,77,0,0,0,0,77,78,322
78,325,0,0,423,0,0,423,78,325
78,326,0,0,214,0,0,214,78,326
78,327,44,0,0,27,0,71,78,327
78,328,0,0,215,0,0,215,78,328
78,329,88,0,0,0,0,88,78,329
78,335,0,0,308,0,0,308,78,335
78,336,0,0,194,0,0,194,78,336
78,337,0,0,0,132,0,132,78,337
78,338,0,0,0,102,0,102,78,338
78,339,0,0,198,0,0,198,78,339
78,340,0,0,70,0,0,70,78,340
78,342,0,0,0,287,0,287,78,342
79,1,0,0,116,41,0,157,79,1
79,2,105,0,715,42,0,862,79,2
79,3,41,0,85,74,0,200,79,3
79,4,198,122,962,0,0,1282,79,4
79,5,0,0,212,138,0,350,79,5
79,6,25,0,108,0,0,133,79,6
79,7,84,0,42,0,0,126,79,7
79,8,82,0,111,0,0,193,79,8
79,11,0,0,19,0,0,19,79,11
79,14,0,0,47,0,0,47,79,14
79,16,0,0,171,0,0,171,79,16
79,17,0,0,44,49,0,93,79,17
79,18,2215,0,289,0,0,2504,79,18
79,19,63,0,0,178,0,241,79,19
79,21,41,0,0,0,0,41,79,21
79,23,0,0,104,0,0,104,79,23
79,24,0,0,576,0,0,576,79,24
79,25,1043,358,0,0,0,1401,79,25
79,26,41,88,419,0,0,548,79,26
79,27,0,123,380,265,0,768,79,27
79,28,123,1169,91,42,33,1458,79,28
79,29,391,2436,72,591,75,3565,79,29
79,30,80,0,434,0,0,514,79,30
79,31,195,368,564,142,0,1269,79,31
79,32,307,7571,145,0,0,8023,79,32
79,33,61,202,8,16,0,287,79,33
79,34,39,0,0,17,0,56,79,34
79,35,41,0,325,23,0,389,79,35
79,36,0,0,172,64,0,236,79,36
79,37,0,0,82,0,0,82,79,37
79,38,0,0,0,53,0,53,79,38
79,40,0,0,120,0,0,120,79,40
79,41,23,0,26,0,0,49,79,41
79,42,24,0,0,0,0,24,79,42
79,43,126,0,484,63,0,673,79,43
79,48,0,0,247,0,0,247,79,48
79,49,114,0,245,0,0,359,79,49
79,50,0,0,38,0,0,38,79,50
79,51,0,0,191,0,0,191,79,51
79,52,178,0,276,185,0,639,79,52
79,53,41,0,162,0,0,203,79,53
79,54,276,0,37,14,0,327,79,54
79,55,38,0,72,0,0,110,79,55
79,56,0,0,123,0,0,123,79,56
79,57,204,0,407,193,0,804,79,57
79,58,0,0,690,0,0,690,79,58
79,59,0,0,884,0,0,884,79,59
79,60,41,0,0,0,0,41,79,60
79,61,0,0,246,0,0,246,79,61
79,62,231,41,0,154,0,426,79,62
79,63,23,0,0,11,0,34,79,63
79,64,453,0,0,189,0,642,79,64
79,65,619,0,244,111,0,974,79,65
79,66,36,0,52,0,0,88,79,66
79,67,0,0,60,134,0,194,79,67
79,68,151,0,181,41,0,373,79,68
79,69,237,0,71,0,0,308,79,69
79,70,167,0,571,0,0,738,79,70
79,71,313,0,0,41,0,354,79,71
79,72,176,0,23,63,0,262,79,72
79,73,145,0,86,75,0,306,79,73
79,74,247,1059,382,269,59,2016,79,74
79,75,355,1447,153,206,0,2161,79,75
79,76,274,122,155,128,0,679,79,76
79,77,41,1980,389,142,0,2552,79,77
79,78,1064,1916,212,225,0,3417,79,78
79,79,897,8703,0,163,37,9800,79,79
79,80,41,0,25,0,0,66,79,80
79,81,491,0,324,41,0,856,79,81
79,82,23,0,248,101,0,372,79,82
79,83,138,0,195,41,0,374,79,83
79,84,234,0,23,138,0,395,79,84
79,85,96,0,52,0,0,148,79,85
79,86,106,0,0,18,0,124,79,86
79,87,0,67,600,0,0,667,79,87
79,88,41,0,300,41,33,415,79,88
79,89,48,0,168,0,0,216,79,89
79,90,103,0,333,0,0,436,79,90
79,91,41,0,0,0,0,41,79,91
79,92,41,0,41,23,0,105,79,92
79,93,63,40,73,0,0,176,79,93
79,94,82,0,98,62,0,242,79,94
79,96,108,0,214,0,0,322,79,96
79,97,219,0,268,21,0,508,79,97
79,99,58,0,0,0,0,58,79,99
79,100,41,0,141,0,0,182,79,100
79,101,90,0,142,0,0,232,79,101
79,102,114,0,61,85,0,260,79,102
79,104,0,0,44,21,0,65,79,104
79,105,50,0,44,0,0,94,79,105
79,106,0,0,41,0,0,41,79,106
79,107,254,0,0,99,0,353,79,107
79,108,0,0,35,51,0,86,79,108
79,109,35,0,1143,0,0,1178,79,109
79,110,0,0,453,0,0,453,79,110
79,113,90,0,586,0,0,676,79,113
79,118,15,0,181,0,0,196,79,118
79,119,0,0,454,0,0,454,79,119
79,121,0,0,0,406,0,406,79,121
79,122,0,0,789,0,0,789,79,122
79,125,203,0,0,0,0,203,79,125
79,127,0,0,540,0,0,540,79,127
79,128,0,0,10,0,0,10,79,128
79,129,0,0,54,0,0,54,79,129
79,131,0,0,19,0,0,19,79,131
79,132,82,0,0,0,0,82,79,132
79,133,0,0,29,0,0,29,79,133
79,134,0,0,253,0,0,253,79,134
79,135,0,0,170,41,0,211,79,135
79,136,162,0,0,0,0,162,79,136
79,138,65,0,94,0,0,159,79,138
79,139,0,0,523,0,0,523,79,139
79,140,0,0,175,130,0,305,79,140
79,144,0,0,824,0,0,824,79,144
79,151,322,0,0,0,0,322,79,151
79,152,0,0,444,0,0,444,79,152
79,157,154,0,0,0,0,154,79,157
79,160,0,0,502,0,0,502,79,160
79,162,0,0,65,0,0,65,79,162
79,163,0,0,238,0,0,238,79,163
79,168,0,0,305,0,0,305,79,168
79,172,0,0,533,0,0,533,79,172
79,173,41,0,0,0,0,41,79,173
79,174,0,0,117,0,0,117,79,174
79,175,0,0,241,0,0,241,79,175
79,181,105,0,0,0,0,105,79,181
79,183,0,0,894,0,0,894,79,183
79,184,0,0,181,0,0,181,79,184
79,187,0,0,222,0,0,222,79,187
79,189,0,0,631,0,0,631,79,189
79,196,0,0,319,0,0,319,79,196
79,197,0,0,95,0,0,95,79,197
79,198,41,0,183,0,0,224,79,198
79,200,0,0,330,0,0,330,79,200
79,202,0,0,754,0,0,754,79,202
79,204,0,0,550,0,0,550,79,204
79,206,0,0,819,0,0,819,79,206
79,207,971,0,0,0,0,971,79,207
79,209,0,0,986,0,0,986,79,209
79,210,117,0,20,0,0,137,79,210
79,217,0,0,241,0,0,241,79,217
79,218,0,0,482,0,0,482,79,218
79,220,0,0,567,0,0,567,79,220
79,221,364,0,0,0,0,364,79,221
79,225,0,0,199,0,0,199,79,225
79,226,0,0,902,0,0,902,79,226
79,228,0,0,176,0,0,176,79,228
79,236,41,0,112,0,0,153,79,236
79,237,0,0,26,0,0,26,79,237
79,238,0,0,151,0,0,151,79,238
79,239,110,0,42,0,0,152,79,239
79,240,0,0,0,0,298,298,79,240
79,241,0,0,69,0,0,69,79,241
79,242,0,0,475,0,0,475,79,242
79,246,0,0,113,0,0,113,79,246
79,250,0,0,108,0,0,108,79,250
79,252,0,0,393,0,0,393,79,252
79,253,0,0,8,0,0,8,79,253
79,254,129,0,248,0,0,377,79,254
79,256,0,0,612,0,0,612,79,256
79,257,0,0,447,0,0,447,79,257
79,262,0,0,0,841,0,841,79,262
79,268,108,0,0,0,0,108,79,268
79,269,139,0,151,0,0,290,79,269
79,270,54,0,0,0,0,54,79,270
79,271,0,0,25,0,0,25,79,271
79,272,149,0,80,304,0,533,79,272
79,273,488,0,0,0,0,488,79,273
79,274,0,0,63,0,0,63,79,274
79,276,601,0,0,0,0,601,79,276
79,278,0,0,790,0,0,790,79,278
79,279,0,0,0,363,0,363,79,279
79,280,54,0,146,0,0,200,79,280
79,282,433,0,0,0,0,433,79,282
79,285,490,0,0,0,0,490,79,285
79,286,0,0,126,0,0,126,79,286
79,292,0,0,125,0,0,125,79,292
79,293,41,0,0,0,0,41,79,293
79,297,13,0,0,0,0,13,79,297
79,298,534,0,301,0,0,835,79,298
79,300,41,0,0,511,59,611,79,300
79,301,0,0,158,0,0,158,79,301
79,302,85,0,0,0,0,85,79,302
79,303,0,0,65,0,0,65,79,303
79,305,0,0,665,0,0,665,79,305
79,306,0,0,523,0,0,523,79,306
79,307,0,0,1691,277,0,1968,79,307
79,308,0,0,360,0,0,360,79,308
79,312,257,0,0,0,0,257,79,312
79,313,0,0,459,0,0,459,79,313
79,314,0,0,21,0,0,21,79,314
79,315,0,0,592,0,0,592,79,315
79,316,114,0,95,0,0,209,79,316
79,317,28,0,63,0,0,91,79,317
79,318,41,0,175,0,0,216,79,318
79,319,33,0,84,0,0,117,79,319
79,321,0,0,0,210,0,210,79,321
79,322,77,0,0,0,0,77,79,322
79,323,436,0,0,0,0,436,79,323
79,326,0,0,915,0,0,915,79,326
79,327,109,0,0,66,0,175,79,327
79,328,372,0,132,0,0,504,79,328
79,329,138,0,20,0,0,158,79,329
79,330,0,0,234,0,0,234,79,330
79,331,0,0,444,0,0,444,79,331
79,333,0,0,89,0,0,89,79,333
79,334,0,0,312,242,0,554,79,334
79,335,0,0,0,66,0,66,79,335
79,337,0,0,143,0,0,143,79,337
79,338,0,0,394,0,0,394,79,338
79,339,48,0,44,0,0,92,79,339
79,340,77,0,0,37,0,114,79,340
79,341,118,0,136,0,0,254,79,341
80,1,0,0,623,0,0,623,80,1
80,2,26,0,88,0,64,178,80,2
80,4,0,0,44,214,0,258,80,4
80,5,44,0,457,161,0,662,80,5
80,6,0,0,44,0,0,44,80,6
80,9,0,0,40,0,0,40,80,9
80,11,22,0,0,0,0,22,80,11
80,13,0,0,44,0,0,44,80,13
80,14,180,0,0,0,0,180,80,14
80,16,44,0,88,0,0,132,80,16
80,18,0,0,135,0,0,135,80,18
80,19,0,0,140,49,0,189,80,19
80,23,98,0,29,0,0,127,80,23
80,24,0,0,0,44,0,44,80,24
80,25,162,0,162,0,0,324,80,25
80,27,0,0,273,104,0,377,80,27
80,28,88,0,214,0,0,302,80,28
80,29,405,0,0,0,0,405,80,29
80,30,109,0,58,0,0,167,80,30
80,31,0,0,414,49,0,463,80,31
80,32,180,0,1215,0,0,1395,80,32
80,33,15,6,48,15,0,84,80,33
80,34,100,0,178,0,0,278,80,34
80,35,0,0,553,0,0,553,80,35
80,36,492,0,342,0,0,834,80,36
80,37,150,0,0,18,0,168,80,37
80,43,0,0,151,0,0,151,80,43
80,45,496,0,0,0,0,496,80,45
80,50,74,0,0,0,0,74,80,50
80,51,104,0,0,0,0,104,80,51
80,52,42,0,0,180,0,222,80,52
80,53,44,0,81,0,0,125,80,53
80,55,0,0,0,168,64,232,80,55
80,56,0,0,309,107,0,416,80,56
80,57,0,0,276,0,0,276,80,57
80,58,0,0,100,0,0,100,80,58
80,61,125,0,0,0,0,125,80,61
80,62,0,0,29,0,0,29,80,62
80,63,0,0,180,0,0,180,80,63
80,64,0,0,48,0,0,48,80,64
80,65,116,0,0,0,0,116,80,65
80,66,58,0,0,0,84,142,80,66
80,68,137,210,244,545,326,1462,80,68
80,69,178,0,0,80,0,258,80,69
80,70,71,0,0,0,0,71,80,70
80,71,44,0,181,0,0,225,80,71
80,72,0,0,0,176,0,176,80,72
80,73,157,0,169,180,0,506,80,73
80,74,102,0,228,0,0,330,80,74
80,75,107,0,140,44,0,291,80,75
80,76,62,98,33,0,0,193,80,76
80,77,1029,1947,295,93,0,3364,80,77
80,78,89,44,99,72,0,304,80,78
80,79,41,0,0,0,0,41,80,79
80,80,2783,16389,0,230,128,19530,80,80
80,81,392,630,113,187,0,1322,80,81
80,82,1138,1656,1079,106,0,3979,80,82
80,83,195,1541,465,510,200,2911,80,83
80,84,193,0,0,51,0,244,80,84
80,85,11,0,39,24,0,74,80,85
80,86,0,0,48,20,0,68,80,86
80,87,67,33,33,67,146,346,80,87
80,88,171,0,0,0,0,171,80,88
80,89,216,0,0,168,69,453,80,89
80,90,0,0,33,0,0,33,80,90
80,93,0,0,60,0,0,60,80,93
80,94,0,0,0,44,0,44,80,94
80,95,792,0,49,0,0,841,80,95
80,96,276,67,205,112,38,698,80,96
80,97,158,35,209,35,0,437,80,97
80,99,96,0,0,0,0,96,80,99
80,100,450,0,200,267,0,917,80,100
80,101,286,0,53,44,0,383,80,101
80,102,136,0,0,0,0,136,80,102
80,104,21,0,0,0,0,21,80,104
80,108,39,0,0,0,0,39,80,108
80,116,0,0,202,0,0,202,80,116
80,117,0,0,510,0,0,510,80,117
80,131,0,0,44,0,0,44,80,131
80,133,44,0,0,0,0,44,80,133
80,134,0,0,233,0,0,233,80,134
80,135,0,0,44,0,0,44,80,135
80,137,0,0,732,0,0,732,80,137
80,138,65,0,0,0,0,65,80,138
80,139,0,0,97,0,0,97,80,139
80,144,0,0,807,0,0,807,80,144
80,152,0,0,206,0,0,206,80,152
80,157,0,0,214,0,0,214,80,157
80,159,44,0,0,0,0,44,80,159
80,167,0,0,250,0,0,250,80,167
80,168,0,0,98,0,0,98,80,168
80,172,0,0,258,0,0,258,80,172
80,173,0,0,215,0,0,215,80,173
80,186,0,0,73,0,0,73,80,186
80,191,0,0,44,0,0,44,80,191
80,200,0,0,149,0,0,149,80,200
80,210,0,0,0,93,0,93,80,210
80,211,0,0,623,0,0,623,80,211
80,222,0,0,0,223,0,223,80,222
80,239,26,0,0,0,0,26,80,239
80,240,59,0,0,0,0,59,80,240
80,245,0,0,127,0,0,127,80,245
80,249,0,0,661,0,0,661,80,249
80,252,0,0,0,44,0,44,80,252
80,254,0,0,294,0,0,294,80,254
80,268,71,0,0,0,0,71,80,268
80,271,132,0,0,0,0,132,80,271
80,274,0,0,222,0,0,222,80,274
80,275,0,0,274,0,0,274,80,275
80,278,0,0,172,0,0,172,80,278
80,280,287,0,311,0,0,598,80,280
80,281,0,0,0,49,0,49,80,281
80,283,0,0,0,29,0,29,80,283
80,290,0,0,774,0,0,774,80,290
80,291,0,0,248,0,0,248,80,291
80,298,0,0,308,0,0,308,80,298
80,300,60,0,534,0,0,594,80,300
80,301,0,0,106,0,0,106,80,301
80,302,0,0,0,85,0,85,80,302
80,304,0,0,452,415,0,867,80,304
80,305,44,0,202,0,0,246,80,305
80,307,0,0,327,0,0,327,80,307
80,309,0,0,162,174,0,336,80,309
80,313,0,0,250,0,0,250,80,313
80,315,348,0,0,0,0,348,80,315
80,316,88,0,0,0,0,88,80,316
80,317,87,0,0,0,0,87,80,317
80,318,437,0,0,0,0,437,80,318
80,319,136,0,0,0,0,136,80,319
80,320,113,0,541,0,0,654,80,320
80,322,154,0,0,0,0,154,80,322
80,324,0,0,521,0,0,521,80,324
80,325,0,0,572,0,0,572,80,325
80,326,0,0,214,0,0,214,80,326
80,327,0,0,68,27,0,95,80,327
80,328,0,0,267,197,0,464,80,328
80,329,51,0,55,0,0,106,80,329
80,330,349,0,473,0,0,822,80,330
80,331,201,0,49,0,0,250,80,331
80,332,86,0,89,0,0,175,80,332
80,334,0,0,48,0,0,48,80,334
80,335,44,0,0,0,0,44,80,335
80,336,0,0,574,0,0,574,80,336
80,337,49,0,492,0,0,541,80,337
80,338,44,0,0,0,0,44,80,338
80,339,269,0,628,0,38,935,80,339
80,340,63,0,62,34,0,159,80,340
80,341,88,0,452,0,0,540,80,341
80,342,452,0,449,0,0,901,80,342
81,1,0,0,40,0,0,40,81,1
81,2,0,0,92,0,0,92,81,2
81,3,111,0,61,0,0,172,81,3
81,4,468,0,0,0,0,468,81,4
81,5,684,0,56,0,0,740,81,5
81,7,98,0,0,78,0,176,81,7
81,8,43,0,155,0,0,198,81,8
81,11,0,0,63,0,0,63,81,11
81,14,111,0,0,0,0,111,81,14
81,17,13,0,0,0,0,13,81,17
81,20,43,0,0,0,0,43,81,20
81,22,29,0,0,0,0,29,81,22
81,23,0,0,56,0,0,56,81,23
81,24,46,0,0,0,0,46,81,24
81,27,0,0,176,0,0,176,81,27
81,28,0,0,283,66,0,349,81,28
81,29,198,0,194,72,0,464,81,29
81,30,159,0,0,0,0,159,81,30
81,31,0,0,342,214,0,556,81,31
81,32,218,0,334,0,0,552,81,32
81,33,31,0,0,0,0,31,81,33
81,34,146,0,390,47,0,583,81,34
81,35,0,0,0,291,0,291,81,35
81,36,131,0,0,0,0,131,81,36
81,38,0,0,35,0,0,35,81,38
81,41,0,0,56,0,0,56,81,41
81,43,0,0,0,102,0,102,81,43
81,48,0,0,191,0,0,191,81,48
81,49,0,0,32,0,0,32,81,49
81,50,0,0,30,0,0,30,81,50
81,52,98,0,61,0,0,159,81,52
81,53,182,0,0,0,0,182,81,53
81,54,56,0,97,56,0,209,81,54
81,55,139,0,0,0,0,139,81,55
81,56,0,0,0,0,256,256,81,56
81,57,345,0,63,0,0,408,81,57
81,60,0,0,0,102,148,250,81,60
81,61,204,0,0,0,0,204,81,61
81,62,53,0,54,0,0,107,81,62
81,63,23,0,0,0,0,23,81,63
81,64,0,0,261,172,174,607,81,64
81,65,405,0,50,446,0,901,81,65
81,66,372,0,38,164,0,574,81,66
81,67,198,0,0,419,0,617,81,67
81,68,808,1210,132,802,355,3307,81,68
81,69,470,152,226,336,0,1184,81,69
81,70,139,0,0,155,0,294,81,70
81,71,56,0,559,0,0,615,81,71
81,72,0,0,462,0,0,462,81,72
81,73,881,0,0,56,0,937,81,73
81,74,248,0,231,56,142,677,81,74
81,75,91,0,61,163,0,315,81,75
81,76,757,275,0,34,0,1066,81,76
81,77,248,82,0,0,0,330,81,77
81,78,545,0,14,229,0,788,81,78
81,79,308,0,324,41,0,673,81,79
81,80,552,824,0,49,0,1425,81,80
81,81,1331,13170,0,358,646,15505,81,81
81,82,671,2014,558,213,89,3545,81,82
81,83,447,38,75,61,81,702,81,83
81,84,51,0,102,0,0,153,81,84
81,85,126,0,0,24,0,150,81,85
81,86,27,0,0,0,0,27,81,86
81,87,340,0,0,100,0,440,81,87
81,88,138,0,0,0,0,138,81,88
81,89,0,0,114,0,0,114,81,89
81,90,0,0,206,0,0,206,81,90
81,93,87,0,345,0,0,432,81,93
81,94,0,0,0,56,0,56,81,94
81,95,241,0,0,0,0,241,81,95
81,96,807,0,73,61,0,941,81,96
81,97,110,0,61,0,51,222,81,97
81,100,404,0,163,0,0,567,81,100
81,101,226,0,321,0,0,547,81,101
81,102,250,0,0,0,0,250,81,102
81,103,10,0,0,0,0,10,81,103
81,104,73,0,23,0,0,96,81,104
81,105,286,0,0,0,0,286,81,105
81,107,99,0,0,99,0,198,81,107
81,110,439,0,0,0,0,439,81,110
81,111,128,0,0,0,0,128,81,111
81,113,269,0,0,0,0,269,81,113
81,116,292,0,340,0,0,632,81,116
81,119,0,0,464,0,0,464,81,119
81,127,0,0,304,0,0,304,81,127
81,131,0,0,7,0,0,7,81,131
81,132,87,0,0,0,0,87,81,132
81,137,0,0,673,0,0,673,81,137
81,140,0,0,152,0,0,152,81,140
81,154,0,0,393,0,0,393,81,154
81,163,0,0,621,0,0,621,81,163
81,164,55,0,0,55,0,110,81,164
81,165,56,0,0,0,0,56,81,165
81,166,0,0,0,275,0,275,81,166
81,171,0,0,939,0,0,939,81,171
81,181,0,0,551,0,0,551,81,181
81,184,0,0,185,0,0,185,81,184
81,188,56,0,0,0,0,56,81,188
81,193,0,0,99,0,0,99,81,193
81,203,0,0,190,0,0,190,81,203
81,205,0,0,592,0,0,592,81,205
81,209,0,0,640,0,0,640,81,209
81,210,0,0,97,0,0,97,81,210
81,212,0,0,53,0,0,53,81,212
81,217,0,0,363,0,0,363,81,217
81,220,0,0,184,0,0,184,81,220
81,232,0,0,195,0,0,195,81,232
81,238,0,0,438,0,0,438,81,238
81,240,0,0,355,0,0,355,81,240
81,246,0,0,113,0,0,113,81,246
81,249,0,0,526,0,0,526,81,249
81,251,56,0,0,0,0,56,81,251
81,253,0,0,86,0,0,86,81,253
81,262,0,0,331,0,0,331,81,262
81,267,0,0,346,0,0,346,81,267
81,268,288,0,0,0,0,288,81,268
81,269,0,0,131,139,0,270,81,269
81,270,63,0,0,0,0,63,81,270
81,272,38,0,0,56,0,94,81,272
81,273,348,0,56,0,0,404,81,273
81,274,103,0,0,0,0,103,81,274
81,278,0,0,416,0,0,416,81,278
81,284,0,0,870,0,0,870,81,284
81,286,21,0,207,0,0,228,81,286
81,288,39,0,0,0,0,39,81,288
81,290,0,0,231,0,0,231,81,290
81,298,0,0,272,0,0,272,81,298
81,300,159,0,305,0,0,464,81,300
81,301,87,0,0,0,0,87,81,301
81,303,53,0,421,26,0,500,81,303
81,305,0,0,790,0,0,790,81,305
81,306,0,0,1337,0,0,1337,81,306
81,309,0,0,950,0,0,950,81,309
81,310,0,0,282,0,0,282,81,310
81,311,0,0,554,0,0,554,81,311
81,313,0,0,337,0,0,337,81,313
81,314,0,0,1361,0,0,1361,81,314
81,315,377,0,781,0,0,1158,81,315
81,316,510,0,260,172,0,942,81,316
81,317,259,0,0,14,0,273,81,317
81,318,111,0,272,103,0,486,81,318
81,319,254,0,192,0,0,446,81,319
81,320,525,0,541,0,0,1066,81,320
81,321,484,0,513,0,0,997,81,321
81,322,595,0,0,101,0,696,81,322
81,323,539,0,0,0,0,539,81,323
81,327,82,0,110,27,0,219,81,327
81,328,197,0,0,0,0,197,81,328
81,329,213,0,55,0,0,268,81,329
81,330,102,0,0,0,0,102,81,330
81,331,114,0,306,0,0,420,81,331
81,333,173,0,0,0,0,173,81,333
81,334,221,0,0,0,0,221,81,334
81,339,56,0,29,0,0,85,81,339
81,340,99,0,157,93,106,455,81,340
81,342,417,0,0,0,0,417,81,342
82,1,31,0,40,0,0,71,82,1
82,2,0,0,260,0,0,260,82,2
82,3,0,0,473,0,0,473,82,3
82,4,30,0,0,0,0,30,82,4
82,5,0,0,97,162,0,259,82,5
82,6,0,0,257,0,0,257,82,6
82,7,0,0,0,18,0,18,82,7
82,9,26,0,0,0,0,26,82,9
82,12,182,0,0,0,0,182,82,12
82,14,0,0,61,0,0,61,82,14
82,15,0,0,70,0,0,70,82,15
82,16,0,0,302,0,0,302,82,16
82,18,0,0,366,0,0,366,82,18
82,19,0,0,0,156,0,156,82,19
82,20,0,0,306,0,0,306,82,20
82,22,0,0,36,0,0,36,82,22
82,23,0,0,317,0,0,317,82,23
82,24,181,0,22,0,0,203,82,24
82,27,177,0,495,31,0,703,82,27
82,28,0,0,79,0,0,79,82,28
82,29,0,0,56,0,0,56,82,29
82,30,402,0,234,0,0,636,82,30
82,31,0,0,491,64,0,555,82,31
82,32,21,0,122,21,0,164,82,32
82,33,15,0,15,6,0,36,82,33
82,34,47,0,70,53,0,170,82,34
82,35,0,0,128,51,0,179,82,35
82,36,131,0,1066,0,0,1197,82,36
82,37,0,0,31,0,0,31,82,37
82,40,0,0,0,27,0,27,82,40
82,41,0,0,494,26,0,520,82,41
82,42,0,0,21,0,0,21,82,42
82,43,0,0,97,0,0,97,82,43
82,47,0,0,107,0,0,107,82,47
82,49,0,0,146,0,0,146,82,49
82,50,0,0,74,0,0,74,82,50
82,51,87,0,0,0,0,87,82,51
82,52,0,0,42,0,0,42,82,52
82,53,0,0,178,53,0,231,82,53
82,54,35,0,0,0,0,35,82,54
82,55,0,0,541,0,0,541,82,55
82,56,83,0,89,148,0,320,82,56
82,57,230,0,99,0,0,329,82,57
82,58,0,0,200,0,0,200,82,58
82,59,0,0,607,0,0,607,82,59
82,60,205,0,0,0,0,205,82,60
82,61,1015,0,238,0,0,1253,82,61
82,62,31,0,229,0,0,260,82,62
82,63,11,0,0,0,0,11,82,63
82,64,171,0,0,95,276,542,82,64
82,66,174,0,0,0,84,258,82,66
82,67,0,0,176,0,80,256,82,67
82,68,527,215,76,90,130,1038,82,68
82,69,115,0,0,7,102,224,82,69
82,70,0,0,943,0,0,943,82,70
82,71,153,0,0,321,222,696,82,71
82,72,176,0,327,0,0,503,82,72
82,73,276,282,479,0,91,1128,82,73
82,74,62,0,470,21,0,553,82,74
82,75,56,0,99,0,0,155,82,75
82,76,0,0,76,0,0,76,82,76
82,77,598,442,263,667,0,1970,82,77
82,78,759,0,109,307,89,1264,82,78
82,79,182,0,686,101,0,969,82,79
82,80,1294,1653,554,335,0,3836,82,80
82,81,600,2006,356,416,142,3520,82,81
82,82,1198,24423,153,0,744,26518,82,82
82,83,854,1132,269,228,145,2628,82,83
82,84,51,0,74,102,0,227,82,84
82,85,35,0,44,0,0,79,82,85
82,87,176,0,54,266,49,545,82,87
82,88,675,0,150,719,0,1544,82,88
82,89,168,0,0,0,0,168,82,89
82,90,0,0,0,501,0,501,82,90
82,91,0,0,30,33,0,63,82,91
82,93,0,0,0,70,0,70,82,93
82,94,0,0,67,0,0,67,82,94
82,95,400,129,952,0,147,1628,82,95
82,96,419,428,238,62,190,1337,82,96
82,97,671,0,44,186,0,901,82,97
82,99,58,0,0,33,0,91,82,99
82,100,132,0,0,0,0,132,82,100
82,101,130,0,200,130,0,460,82,101
82,102,114,0,201,100,45,460,82,102
82,103,21,0,46,14,0,81,82,103
82,104,110,0,0,0,0,110,82,104
82,105,609,0,0,113,0,722,82,105
82,107,1241,0,0,0,0,1241,82,107
82,108,0,0,86,0,0,86,82,108
82,110,877,0,0,0,0,877,82,110
82,111,425,0,0,0,0,425,82,111
82,112,62,0,0,0,0,62,82,112
82,116,312,0,897,0,0,1209,82,116
82,117,1431,0,0,0,0,1431,82,117
82,118,0,0,321,0,0,321,82,118
82,119,0,0,417,0,0,417,82,119
82,121,0,0,590,0,0,590,82,121
82,122,0,0,0,334,0,334,82,122
82,131,0,0,669,0,0,669,82,131
82,133,0,0,98,0,0,98,82,133
82,134,0,0,0,282,0,282,82,134
82,136,199,0,0,0,0,199,82,136
82,139,0,0,391,0,0,391,82,139
82,140,343,0,0,0,0,343,82,140
82,144,919,0,0,0,0,919,82,144
82,153,45,0,0,0,0,45,82,153
82,154,0,0,226,0,0,226,82,154
82,157,154,0,0,0,0,154,82,157
82,160,966,0,0,0,0,966,82,160
82,166,0,0,206,0,0,206,82,166
82,167,0,0,227,0,0,227,82,167
82,168,204,0,258,0,0,462,82,168
82,169,0,0,132,0,0,132,82,169
82,172,258,0,0,0,0,258,82,172
82,174,0,0,357,0,0,357,82,174
82,180,0,0,453,0,0,453,82,180
82,181,277,0,0,0,0,277,82,181
82,186,0,0,272,0,0,272,82,186
82,192,0,0,258,0,0,258,82,192
82,195,0,0,317,0,0,317,82,195
82,198,0,0,246,0,0,246,82,198
82,204,0,0,758,0,0,758,82,204
82,207,164,0,0,0,0,164,82,207
82,209,0,0,206,0,0,206,82,209
82,210,97,0,0,0,0,97,82,210
82,211,0,0,746,0,0,746,82,211
82,219,0,0,0,343,0,343,82,219
82,223,0,0,171,0,0,171,82,223
82,226,0,0,381,0,0,381,82,226
82,227,0,0,858,0,0,858,82,227
82,237,111,0,31,0,0,142,82,237
82,240,0,0,76,0,0,76,82,240
82,246,114,0,0,0,0,114,82,246
82,250,254,0,108,0,0,362,82,250
82,252,126,0,126,0,0,252,82,252
82,257,0,0,433,0,0,433,82,257
82,258,0,0,674,0,0,674,82,258
82,265,0,0,828,0,0,828,82,265
82,268,73,0,47,132,191,443,82,268
82,269,119,0,0,0,0,119,82,269
82,270,0,0,0,54,0,54,82,270
82,272,38,0,42,0,0,80,82,272
82,275,0,0,140,0,0,140,82,275
82,276,0,0,33,0,0,33,82,276
82,278,0,0,771,0,0,771,82,278
82,280,197,0,505,0,0,702,82,280
82,281,202,0,801,0,0,1003,82,281
82,284,724,0,870,76,0,1670,82,284
82,285,0,0,498,0,0,498,82,285
82,286,0,0,106,0,0,106,82,286
82,288,240,0,0,0,0,240,82,288
82,290,0,0,238,0,0,238,82,290
82,291,574,0,1594,0,0,2168,82,291
82,294,0,0,542,0,0,542,82,294
82,295,0,0,395,0,0,395,82,295
82,296,0,0,0,127,0,127,82,296
82,298,0,0,657,0,0,657,82,298
82,299,0,0,218,0,0,218,82,299
82,300,401,0,114,0,40,555,82,300
82,301,0,0,153,66,0,219,82,301
82,302,85,0,928,0,0,1013,82,302
82,303,29,0,409,0,0,438,82,303
82,304,0,0,652,373,0,1025,82,304
82,305,0,0,2693,0,0,2693,82,305
82,306,0,0,1003,0,0,1003,82,306
82,307,0,0,1071,0,0,1071,82,307
82,310,0,0,0,33,0,33,82,310
82,311,0,0,1282,0,0,1282,82,311
82,312,0,0,30,0,0,30,82,312
82,313,0,0,724,0,0,724,82,313
82,315,0,0,1220,0,0,1220,82,315
82,316,72,0,445,72,0,589,82,316
82,317,72,301,16,20,0,409,82,317
82,318,0,0,243,141,0,384,82,318
82,319,64,0,68,12,0,144,82,319
82,320,0,0,839,0,0,839,82,320
82,321,333,0,121,0,0,454,82,321
82,322,226,0,1123,0,0,1349,82,322
82,323,1017,0,1550,0,0,2567,82,323
82,324,0,0,2763,631,0,3394,82,324
82,325,0,0,248,0,0,248,82,325
82,326,0,0,651,0,0,651,82,326
82,327,134,0,149,120,0,403,82,327
82,328,0,0,451,267,0,718,82,328
82,329,666,0,1933,102,0,2701,82,329
82,330,0,0,30,0,0,30,82,330
82,331,618,0,298,0,0,916,82,331
82,332,937,0,0,0,0,937,82,332
82,333,0,0,697,0,0,697,82,333
82,334,0,0,0,313,0,313,82,334
82,335,0,0,280,0,0,280,82,335
82,336,486,0,0,0,0,486,82,336
82,337,132,0,635,0,0,767,82,337
82,338,0,0,237,0,0,237,82,338
82,339,31,0,446,31,476,984,82,339
82,340,435,0,760,13,0,1208,82,340
82,341,286,0,313,0,0,599,82,341
82,342,0,0,811,33,0,844,82,342
83,1,69,0,247,84,0,400,83,1
83,2,0,0,69,0,0,69,83,2
83,3,36,0,406,0,0,442,83,3
83,5,0,0,236,0,0,236,83,5
83,6,0,0,349,0,0,349,83,6
83,7,0,0,234,69,0,303,83,7
83,20,0,0,254,0,0,254,83,20
83,21,0,0,321,0,0,321,83,21
83,22,0,0,165,0,0,165,83,22
83,24,0,0,146,0,0,146,83,24
83,26,33,0,0,0,0,33,83,26
83,27,0,0,658,0,0,658,83,27
83,28,0,0,744,527,0,1271,83,28
83,29,147,0,273,0,0,420,83,29
83,30,240,0,129,233,0,602,83,30
83,31,559,0,193,138,0,890,83,31
83,32,108,0,1470,0,0,1578,83,32
83,33,62,0,0,15,0,77,83,33
83,34,301,0,39,77,0,417,83,34
83,35,55,0,53,0,0,108,83,35
83,36,299,0,1104,0,0,1403,83,36
83,37,0,0,0,37,0,37,83,37
83,41,197,0,0,0,0,197,83,41
83,43,0,0,177,0,0,177,83,43
83,49,0,0,74,0,0,74,83,49
83,52,0,0,189,0,0,189,83,52
83,54,37,0,117,0,0,154,83,54
83,55,0,0,196,0,0,196,83,55
83,56,0,0,231,0,0,231,83,56
83,57,0,0,103,0,0,103,83,57
83,59,0,0,259,0,0,259,83,59
83,60,102,0,0,0,0,102,83,60
83,61,69,0,0,0,0,69,83,61
83,62,0,0,56,0,0,56,83,62
83,63,11,0,0,0,0,11,83,63
83,64,0,0,200,0,0,200,83,64
83,65,220,0,0,207,0,427,83,65
83,66,58,0,0,0,0,58,83,66
83,67,193,0,0,0,0,193,83,67
83,68,205,0,94,0,276,575,83,68
83,69,168,0,182,0,0,350,83,69
83,70,69,0,53,0,0,122,83,70
83,72,0,0,97,0,0,97,83,72
83,73,69,0,214,0,0,283,83,73
83,74,0,0,197,137,0,334,83,74
83,75,160,0,0,0,0,160,83,75
83,76,128,0,173,0,0,301,83,76
83,77,674,720,276,0,0,1670,83,77
83,78,0,0,344,0,0,344,83,78
83,79,138,0,268,41,0,447,83,79
83,80,274,1805,233,78,200,2590,83,80
83,81,392,0,281,61,81,815,83,81
83,82,824,1607,694,228,145,3498,83,82
83,83,1772,12631,150,175,0,14728,83,83
83,84,360,51,297,0,0,708,83,84
83,85,47,0,12,69,0,128,83,85
83,86,268,30,0,0,0,298,83,86
83,87,892,979,186,57,100,2214,83,87
83,88,1539,21,225,210,0,1995,83,88
83,89,470,607,235,0,400,1712,83,89
83,90,193,189,206,0,0,588,83,90
83,91,88,0,0,0,0,88,83,91
83,92,4,0,0,0,0,4,83,92
83,93,131,0,64,466,0,661,83,93
83,94,0,0,29,62,0,91,83,94
83,95,1265,2230,104,0,0,3599,83,95
83,96,988,67,0,0,95,1150,83,96
83,97,608,0,78,248,0,934,83,97
83,98,19,0,25,0,0,44,83,98
83,99,0,0,0,41,0,41,83,99
83,100,1160,0,0,215,0,1375,83,100
83,101,692,0,75,438,400,1605,83,101
83,102,49,0,0,350,0,399,83,102
83,103,21,0,45,0,0,66,83,103
83,104,64,0,23,0,0,87,83,104
83,105,195,0,1854,0,0,2049,83,105
83,107,2347,0,118,0,0,2465,83,107
83,108,37,0,0,0,0,37,83,108
83,116,0,0,348,0,0,348,83,116
83,119,0,0,879,0,0,879,83,119
83,125,0,0,420,0,0,420,83,125
83,129,0,0,69,0,0,69,83,129
83,133,0,0,795,0,0,795,83,133
83,134,211,0,0,0,0,211,83,134
83,135,0,0,565,0,0,565,83,135
83,138,131,0,0,0,0,131,83,138
83,140,343,0,0,0,0,343,83,140
83,141,0,0,700,0,0,700,83,141
83,167,0,0,69,0,0,69,83,167
83,168,204,0,0,0,0,204,83,168
83,169,0,0,42,0,0,42,83,169
83,173,272,0,0,0,0,272,83,173
83,176,0,0,1252,0,0,1252,83,176
83,183,84,0,0,0,0,84,83,183
83,190,0,0,364,0,0,364,83,190
83,213,0,0,49,0,0,49,83,213
83,220,62,0,0,0,0,62,83,220
83,237,206,0,51,0,0,257,83,237
83,238,0,0,444,0,0,444,83,238
83,254,0,0,129,0,0,129,83,254
83,258,0,0,607,0,0,607,83,258
83,270,0,0,83,0,0,83,83,270
83,277,619,0,0,0,0,619,83,277
83,280,69,0,0,0,0,69,83,280
83,281,531,0,0,0,0,531,83,281
83,284,69,0,602,0,0,671,83,284
83,285,0,0,69,0,0,69,83,285
83,291,0,0,505,0,0,505,83,291
83,293,0,0,945,0,0,945,83,293
83,298,0,0,500,0,0,500,83,298
83,299,0,0,104,0,0,104,83,299
83,300,354,0,98,74,0,526,83,300
83,302,0,0,75,0,0,75,83,302
83,303,256,0,0,138,0,394,83,303
83,305,69,0,0,0,0,69,83,305
83,308,0,0,202,0,0,202,83,308
83,309,0,0,153,0,0,153,83,309
83,312,0,0,154,155,0,309,83,312
83,314,0,0,424,0,0,424,83,314
83,316,0,0,49,0,0,49,83,316
83,317,97,0,0,0,0,97,83,317
83,319,58,0,75,0,0,133,83,319
83,320,0,0,910,0,0,910,83,320
83,321,0,0,0,111,0,111,83,321
83,323,0,0,586,0,0,586,83,323
83,327,27,0,27,0,0,54,83,327
83,328,197,0,132,0,0,329,83,328
83,329,171,0,130,50,0,351,83,329
83,332,0,0,245,0,0,245,83,332
83,334,0,0,118,0,0,118,83,334
83,337,600,0,0,0,0,600,83,337
83,339,593,0,381,37,71,1082,83,339
83,340,629,13,37,84,0,763,83,340
83,341,251,0,0,0,0,251,83,341
83,342,132,0,193,0,0,325,83,342
84,1,51,0,43,19,0,113,84,1
84,2,100,0,320,0,0,420,84,2
84,3,51,0,47,45,0,143,84,3
84,4,0,0,55,51,0,106,84,4
84,5,111,0,844,0,0,955,84,5
84,6,0,0,659,45,0,704,84,6
84,7,244,0,0,45,0,289,84,7
84,8,0,0,120,0,0,120,84,8
84,9,0,0,45,0,0,45,84,9
84,21,0,0,111,0,0,111,84,21
84,22,0,0,0,67,0,67,84,22
84,23,0,0,51,0,0,51,84,23
84,24,51,0,0,0,0,51,84,24
84,27,0,0,51,0,0,51,84,27
84,28,147,0,276,102,0,525,84,28
84,29,248,0,103,51,0,402,84,29
84,30,0,0,55,0,0,55,84,30
84,31,0,0,51,51,0,102,84,31
84,32,445,0,116,96,0,657,84,32
84,33,51,51,72,23,0,197,84,33
84,34,726,0,0,57,0,783,84,34
84,35,466,0,292,0,0,758,84,35
84,36,152,530,1032,121,0,1835,84,36
84,37,69,0,0,0,0,69,84,37
84,39,0,0,152,0,0,152,84,39
84,40,51,0,0,0,0,51,84,40
84,43,0,0,55,0,0,55,84,43
84,49,51,0,0,0,0,51,84,49
84,51,93,0,0,89,0,182,84,51
84,53,0,0,39,0,0,39,84,53
84,54,61,0,0,0,0,61,84,54
84,55,98,0,0,0,0,98,84,55
84,56,83,0,51,0,0,134,84,56
84,57,210,0,177,311,74,772,84,57
84,58,0,0,306,0,0,306,84,58
84,59,0,0,0,607,0,607,84,59
84,62,168,0,0,0,0,168,84,62
84,63,0,0,25,0,0,25,84,63
84,65,227,0,126,0,0,353,84,65
84,66,0,0,38,43,0,81,84,66
84,67,51,0,0,0,0,51,84,67
84,68,102,0,278,0,0,380,84,68
84,69,73,0,0,0,0,73,84,69
84,70,130,0,102,0,0,232,84,70
84,71,131,0,0,0,0,131,84,71
84,73,404,0,0,0,0,404,84,73
84,74,102,0,93,0,0,195,84,74
84,75,86,0,0,203,0,289,84,75
84,76,72,0,51,201,0,324,84,76
84,77,366,0,0,118,0,484,84,77
84,78,88,0,104,0,0,192,84,78
84,79,183,0,106,160,0,449,84,79
84,80,102,0,0,51,0,153,84,80
84,81,51,0,102,0,0,153,84,81
84,82,114,0,55,203,0,372,84,82
84,83,309,0,282,96,0,687,84,83
84,84,2556,6632,55,135,0,9378,84,84
84,85,1197,2148,0,46,0,3391,84,85
84,86,65,231,10,58,26,390,84,86
84,87,1648,51,109,276,0,2084,84,87
84,88,1186,1348,110,471,0,3115,84,88
84,89,325,0,0,0,0,325,84,89
84,90,544,265,0,67,0,876,84,90
84,91,91,0,55,8,0,154,84,91
84,92,9,6,0,0,0,15,84,92
84,93,390,1731,149,236,59,2565,84,93
84,94,914,371,102,0,0,1387,84,94
84,95,204,0,111,0,0,315,84,95
84,97,152,0,35,0,0,187,84,97
84,99,250,0,0,0,0,250,84,99
84,100,201,0,253,0,0,454,84,100
84,101,0,0,0,104,0,104,84,101
84,102,346,0,0,0,0,346,84,102
84,104,42,0,22,0,0,64,84,104
84,105,50,0,0,0,0,50,84,105
84,106,51,0,0,0,0,51,84,106
84,107,99,0,63,0,0,162,84,107
84,119,0,0,454,0,0,454,84,119
84,122,0,0,141,0,0,141,84,122
84,125,0,0,0,0,74,74,84,125
84,127,51,0,0,0,0,51,84,127
84,131,0,0,47,0,0,47,84,131
84,135,51,0,0,0,0,51,84,135
84,136,89,0,0,0,0,89,84,136
84,138,0,0,55,0,0,55,84,138
84,139,0,0,113,0,0,113,84,139
84,144,51,0,0,0,0,51,84,144
84,151,0,0,727,0,0,727,84,151
84,154,187,0,0,0,0,187,84,154
84,162,0,0,43,0,0,43,84,162
84,163,353,0,0,0,0,353,84,163
84,166,330,0,0,51,0,381,84,166
84,168,0,0,199,0,0,199,84,168
84,169,42,0,0,0,0,42,84,169
84,193,382,0,0,0,0,382,84,193
84,203,0,0,234,0,0,234,84,203
84,214,51,0,0,0,0,51,84,214
84,230,0,0,306,0,0,306,84,230
84,237,0,0,0,47,0,47,84,237
84,242,0,0,901,0,0,901,84,242
84,245,0,0,127,0,0,127,84,245
84,251,0,0,389,0,0,389,84,251
84,260,225,0,0,0,0,225,84,260
84,268,0,0,87,0,0,87,84,268
84,269,139,0,0,0,0,139,84,269
84,271,0,0,51,51,0,102,84,271
84,274,0,0,47,0,0,47,84,274
84,275,51,0,51,0,0,102,84,275
84,280,51,0,0,0,0,51,84,280
84,281,0,0,153,0,0,153,84,281
84,284,51,0,0,0,0,51,84,284
84,286,17,0,50,0,0,67,84,286
84,300,51,0,62,0,0,113,84,300
84,301,51,0,166,74,0,291,84,301
84,302,0,0,140,0,0,140,84,302
84,307,0,0,298,0,0,298,84,307
84,316,0,0,103,0,0,103,84,316
84,317,15,0,117,14,0,146,84,317
84,319,73,0,0,0,0,73,84,319
84,320,0,0,51,0,0,51,84,320
84,321,263,0,0,0,0,263,84,321
84,327,27,0,0,0,0,27,84,327
84,329,51,0,51,0,0,102,84,329
84,330,0,0,290,0,0,290,84,330
84,331,114,0,0,0,0,114,84,331
84,338,0,0,255,0,0,255,84,338
84,339,186,0,51,31,0,268,84,339
84,340,0,0,23,0,0,23,84,340
84,342,0,0,51,114,0,165,84,342
85,1,33,0,12,0,0,45,85,1
85,2,0,0,11,0,0,11,85,2
85,3,0,0,26,47,0,73,85,3
85,5,0,0,82,0,0,82,85,5
85,7,11,0,0,144,0,155,85,7
85,8,24,0,12,0,0,36,85,8
85,10,0,0,0,24,0,24,85,10
85,19,24,0,0,0,0,24,85,19
85,23,0,0,35,0,0,35,85,23
85,25,97,0,0,0,0,97,85,25
85,27,11,0,19,91,0,121,85,27
85,29,24,63,24,11,0,122,85,29
85,30,162,0,0,0,0,162,85,30
85,31,35,0,1541,24,0,1600,85,31
85,32,143,21,38,156,0,358,85,32
85,33,59,112,0,0,0,171,85,33
85,34,390,73,0,88,0,551,85,34
85,35,0,0,618,0,0,618,85,35
85,36,82,476,24,11,0,593,85,36
85,37,11,0,0,24,0,35,85,37
85,40,0,0,24,0,0,24,85,40
85,42,24,0,0,0,0,24,85,42
85,44,0,0,11,0,0,11,85,44
85,51,0,0,24,0,0,24,85,51
85,54,0,0,35,0,0,35,85,54
85,55,0,0,0,20,0,20,85,55
85,57,0,0,30,0,0,30,85,57
85,59,24,0,267,0,0,291,85,59
85,62,11,0,17,0,0,28,85,62
85,66,35,0,0,0,0,35,85,66
85,67,0,0,0,17,0,17,85,67
85,68,131,0,44,47,0,222,85,68
85,69,24,0,37,0,0,61,85,69
85,73,82,0,0,0,0,82,85,73
85,74,0,0,0,24,0,24,85,74
85,75,0,0,0,35,0,35,85,75
85,77,34,0,26,0,0,60,85,77
85,78,225,0,26,0,0,251,85,78
85,79,96,0,52,0,0,148,85,79
85,80,59,0,39,0,0,98,85,80
85,81,98,0,0,24,0,122,85,81
85,82,35,0,19,24,0,78,85,82
85,83,71,0,12,69,0,152,85,83
85,84,1048,2108,0,24,0,3180,85,84
85,85,206,593,0,0,69,868,85,85
85,86,145,95,10,0,0,250,85,86
85,87,103,0,26,89,0,218,85,87
85,88,1141,63,31,35,0,1270,85,88
85,90,0,0,26,0,0,26,85,90
85,91,65,0,0,0,0,65,85,91
85,92,73,0,0,24,0,97,85,92
85,93,136,456,0,11,0,603,85,93
85,94,0,0,61,41,0,102,85,94
85,95,35,0,0,0,0,35,85,95
85,99,345,0,167,0,0,512,85,99
85,100,943,0,187,41,0,1171,85,100
85,101,0,0,0,361,0,361,85,101
85,103,36,0,0,0,0,36,85,103
85,105,0,0,29,0,0,29,85,105
85,106,35,0,0,0,0,35,85,106
85,109,0,0,1347,0,0,1347,85,109
85,110,24,0,0,0,0,24,85,110
85,113,0,0,229,0,0,229,85,113
85,133,42,0,0,0,0,42,85,133
85,138,0,0,71,0,0,71,85,138
85,139,47,0,0,0,0,47,85,139
85,147,0,0,305,0,0,305,85,147
85,168,0,0,11,0,0,11,85,168
85,200,0,0,109,0,0,109,85,200
85,210,11,0,0,0,0,11,85,210
85,241,0,0,0,11,0,11,85,241
85,269,0,0,0,17,0,17,85,269
85,300,24,0,0,0,0,24,85,300
85,314,899,0,0,0,0,899,85,314
85,317,47,0,0,0,0,47,85,317
85,319,71,0,0,0,0,71,85,319
85,321,11,0,0,0,0,11,85,321
85,327,11,0,0,0,0,11,85,327
85,330,0,0,17,0,0,17,85,330
85,339,0,0,48,0,0,48,85,339
86,2,0,0,82,0,0,82,86,2
86,3,0,0,32,0,0,32,86,3
86,4,0,0,18,20,0,38,86,4
86,5,0,0,47,0,0,47,86,5
86,6,9,0,0,0,0,9,86,6
86,7,18,0,0,0,0,18,86,7
86,9,0,0,20,0,0,20,86,9
86,19,0,0,74,0,0,74,86,19
86,21,0,0,70,0,0,70,86,21
86,24,0,0,46,0,0,46,86,24
86,27,9,0,41,0,0,50,86,27
86,28,0,0,45,0,0,45,86,28
86,29,9,0,9,0,0,18,86,29
86,30,9,0,89,20,0,118,86,30
86,31,0,0,0,66,0,66,86,31
86,32,163,0,74,0,0,237,86,32
86,33,0,47,44,0,0,91,86,33
86,34,85,0,0,0,0,85,86,34
86,36,116,0,0,0,0,116,86,36
86,43,0,0,41,0,0,41,86,43
86,45,0,0,166,0,0,166,86,45
86,49,0,0,0,18,0,18,86,49
86,55,20,0,0,0,0,20,86,55
86,56,0,0,45,0,0,45,86,56
86,57,18,0,45,24,0,87,86,57
86,58,18,0,0,0,0,18,86,58
86,61,33,0,0,0,0,33,86,61
86,63,64,0,0,0,0,64,86,63
86,64,36,0,0,0,0,36,86,64
86,65,18,0,0,0,0,18,86,65
86,68,0,0,70,0,0,70,86,68
86,69,0,0,22,0,0,22,86,69
86,71,18,0,0,0,0,18,86,71
86,74,18,0,0,32,0,50,86,74
86,76,0,0,0,40,0,40,86,76
86,77,38,64,0,20,0,122,86,77
86,78,36,0,0,18,0,54,86,78
86,79,171,0,0,18,0,189,86,79
86,80,0,0,48,0,0,48,86,80
86,81,27,0,19,9,0,55,86,81
86,82,0,0,89,0,0,89,86,82
86,83,205,30,0,138,0,373,86,83
86,84,110,248,10,76,26,470,86,84
86,85,106,95,10,0,0,211,86,85
86,86,61,711,0,18,0,790,86,86
86,87,176,9,27,9,0,221,86,87
86,88,269,467,0,263,0,999,86,88
86,89,0,0,226,0,147,373,86,89
86,90,18,0,372,96,0,486,86,90
86,91,9,0,0,0,0,9,86,91
86,93,127,18,44,0,0,189,86,93
86,94,58,0,10,63,0,131,86,94
86,95,0,0,102,0,0,102,86,95
86,96,18,0,0,40,0,58,86,96
86,97,0,0,0,45,0,45,86,97
86,98,12,0,0,0,0,12,86,98
86,100,0,0,19,0,0,19,86,100
86,102,123,0,0,0,0,123,86,102
86,117,0,0,718,0,0,718,86,117
86,121,0,0,590,0,0,590,86,121
86,128,0,0,19,0,0,19,86,128
86,136,38,0,0,0,0,38,86,136
86,138,18,0,0,0,0,18,86,138
86,140,64,0,0,0,0,64,86,140
86,147,32,0,0,0,0,32,86,147
86,150,18,0,0,0,0,18,86,150
86,165,18,0,0,0,0,18,86,165
86,190,0,0,244,0,0,244,86,190
86,218,58,0,0,0,0,58,86,218
86,221,0,0,84,0,0,84,86,221
86,293,0,0,484,0,0,484,86,293
86,300,0,0,10,0,0,10,86,300
86,303,44,0,0,0,0,44,86,303
86,315,0,0,200,0,0,200,86,315
86,319,17,0,0,0,0,17,86,319
86,328,0,0,19,0,0,19,86,328
86,339,0,0,85,0,0,85,86,339
87,1,0,0,33,33,0,66,87,1
87,3,33,0,176,0,0,209,87,3
87,4,214,0,36,0,0,250,87,4
87,5,0,0,91,0,0,91,87,5
87,6,0,0,36,0,0,36,87,6
87,7,0,0,27,0,0,27,87,7
87,8,98,0,0,0,0,98,87,8
87,13,0,0,33,0,0,33,87,13
87,16,0,0,142,0,0,142,87,16
87,19,0,0,26,0,0,26,87,19
87,23,0,0,33,0,0,33,87,23
87,24,0,0,53,0,0,53,87,24
87,26,0,0,30,0,0,30,87,26
87,27,0,0,271,0,0,271,87,27
87,28,0,0,127,0,0,127,87,28
87,29,0,0,57,0,0,57,87,29
87,30,98,0,155,33,0,286,87,30
87,31,160,0,0,33,0,193,87,31
87,32,67,0,236,0,49,352,87,32
87,34,145,0,92,0,0,237,87,34
87,35,81,0,142,0,0,223,87,35
87,36,150,0,26,0,49,225,87,36
87,43,100,0,0,0,0,100,87,43
87,44,0,0,33,0,0,33,87,44
87,49,50,0,100,0,0,150,87,49
87,52,0,0,193,0,0,193,87,52
87,53,33,0,33,0,0,66,87,53
87,54,142,0,142,0,0,284,87,54
87,55,0,0,412,0,0,412,87,55
87,57,30,0,222,97,0,349,87,57
87,59,0,0,1606,0,0,1606,87,59
87,60,67,0,0,0,0,67,87,60
87,61,0,0,100,0,0,100,87,61
87,62,67,0,24,0,0,91,87,62
87,63,6,0,0,0,0,6,87,63
87,65,111,0,0,0,0,111,87,65
87,67,284,0,0,0,0,284,87,67
87,68,358,0,121,152,0,631,87,68
87,69,138,0,26,0,0,164,87,69
87,70,33,0,0,24,0,57,87,70
87,72,0,0,41,0,0,41,87,72
87,73,181,0,33,0,49,263,87,73
87,74,173,0,109,98,0,380,87,74
87,76,94,0,0,0,0,94,87,76
87,77,151,240,249,0,206,846,87,77
87,78,203,0,0,0,0,203,87,78
87,79,51,33,699,0,0,783,87,79
87,80,209,33,100,78,146,566,87,80
87,81,340,0,0,100,0,440,87,81
87,82,199,0,56,243,49,547,87,82
87,83,658,1001,262,0,100,2021,87,83
87,84,1284,244,0,134,0,1662,87,84
87,85,170,33,26,0,0,229,87,85
87,86,149,0,46,9,0,204,87,86
87,87,853,2824,219,156,97,4149,87,87
87,88,2949,2698,36,722,0,6405,87,88
87,89,1034,136,52,0,0,1222,87,89
87,90,356,201,276,0,0,833,87,90
87,91,27,0,0,0,0,27,87,91
87,92,64,0,0,0,0,64,87,92
87,93,240,0,128,0,0,368,87,93
87,94,33,0,65,33,0,131,87,94
87,95,371,33,36,96,0,536,87,95
87,96,1139,0,36,33,0,1208,87,96
87,97,0,0,392,86,0,478,87,97
87,99,96,0,0,0,0,96,87,99
87,100,708,61,912,0,0,1681,87,100
87,101,153,0,322,56,0,531,87,101
87,102,0,0,0,47,0,47,87,102
87,104,0,0,140,89,0,229,87,104
87,105,423,0,328,0,0,751,87,105
87,106,0,0,26,33,0,59,87,106
87,107,0,0,0,27,0,27,87,107
87,109,33,0,0,0,0,33,87,109
87,110,0,0,477,439,0,916,87,110
87,111,0,0,0,117,0,117,87,111
87,113,64,0,329,0,0,393,87,113
87,122,0,0,141,0,0,141,87,122
87,132,0,0,0,0,49,49,87,132
87,135,300,0,0,0,0,300,87,135
87,137,67,0,0,0,0,67,87,137
87,138,33,0,0,24,0,57,87,138
87,152,33,0,498,0,0,531,87,152
87,154,0,0,30,0,0,30,87,154
87,156,0,0,113,0,0,113,87,156
87,165,0,0,142,0,0,142,87,165
87,166,0,0,560,0,0,560,87,166
87,167,0,0,24,0,0,24,87,167
87,177,0,0,46,0,0,46,87,177
87,189,0,0,397,0,0,397,87,189
87,210,57,0,0,0,0,57,87,210
87,218,0,0,24,0,0,24,87,218
87,238,168,0,0,0,0,168,87,238
87,242,0,0,33,0,0,33,87,242
87,260,0,0,458,0,0,458,87,260
87,274,33,0,33,0,0,66,87,274
87,276,0,0,627,0,0,627,87,276
87,280,0,0,24,0,0,24,87,280
87,281,67,0,276,0,0,343,87,281
87,286,33,0,0,0,0,33,87,286
87,288,24,0,0,0,0,24,87,288
87,289,0,0,27,0,0,27,87,289
87,293,0,0,484,0,0,484,87,293
87,298,250,0,0,0,0,250,87,298
87,300,33,0,176,0,0,209,87,300
87,302,143,0,0,0,0,143,87,302
87,303,142,0,0,0,0,142,87,303
87,305,0,0,202,0,0,202,87,305
87,319,179,0,0,0,0,179,87,319
87,321,24,0,0,0,0,24,87,321
87,328,56,0,0,0,0,56,87,328
87,334,0,0,0,33,0,33,87,334
87,336,33,0,0,0,0,33,87,336
87,338,0,0,0,132,0,132,87,338
87,339,100,0,243,0,49,392,87,339
87,340,70,0,0,0,0,70,87,340
87,342,0,0,0,167,0,167,87,342
88,1,0,0,438,404,0,842,88,1
88,2,0,0,138,0,0,138,88,2
88,3,0,0,0,138,0,138,88,3
88,4,0,101,0,0,0,101,88,4
88,5,634,0,964,415,200,2213,88,5
88,6,0,0,0,440,0,440,88,6
88,7,200,0,0,0,0,200,88,7
88,8,24,0,71,0,0,95,88,8
88,9,0,0,138,0,0,138,88,9
88,16,266,0,0,0,0,266,88,16
88,17,0,0,0,220,0,220,88,17
88,19,138,0,0,0,0,138,88,19
88,20,138,0,0,0,0,138,88,20
88,21,138,0,0,0,0,138,88,21
88,22,0,0,150,0,0,150,88,22
88,23,377,0,138,0,0,515,88,23
88,24,138,0,0,0,0,138,88,24
88,25,138,0,201,0,0,339,88,25
88,27,46,0,260,0,0,306,88,27
88,29,0,0,260,440,0,700,88,29
88,30,420,0,389,487,0,1296,88,30
88,31,515,0,0,0,0,515,88,31
88,32,878,0,322,0,0,1200,88,32
88,33,62,0,0,0,0,62,88,33
88,34,317,0,0,0,0,317,88,34
88,35,47,0,0,0,0,47,88,35
88,36,537,0,150,131,0,818,88,36
88,37,138,0,150,67,0,355,88,37
88,38,35,0,0,0,0,35,88,38
88,41,138,0,0,0,0,138,88,41
88,45,0,0,118,138,0,256,88,45
88,47,101,0,0,0,0,101,88,47
88,49,0,0,141,0,0,141,88,49
88,54,391,0,0,0,0,391,88,54
88,55,0,0,0,138,0,138,88,55
88,56,0,0,101,0,0,101,88,56
88,57,276,0,0,253,0,529,88,57
88,59,0,0,101,0,0,101,88,59
88,60,0,0,414,138,0,552,88,60
88,61,0,0,101,253,0,354,88,61
88,63,62,0,0,0,0,62,88,63
88,64,0,0,0,145,0,145,88,64
88,66,58,0,0,0,0,58,88,66
88,67,0,0,150,0,0,150,88,67
88,68,619,0,110,138,0,867,88,68
88,69,138,0,0,0,0,138,88,69
88,70,0,0,110,141,0,251,88,70
88,71,138,0,138,0,0,276,88,71
88,72,276,0,260,0,0,536,88,72
88,73,276,0,110,0,0,386,88,73
88,74,98,138,526,138,0,900,88,74
88,75,276,0,0,0,0,276,88,75
88,77,173,0,560,138,0,871,88,77
88,78,138,0,460,0,0,598,88,78
88,79,179,0,150,41,33,403,88,79
88,80,438,0,22,831,0,1291,88,80
88,81,138,0,0,0,0,138,88,81
88,82,812,0,150,719,0,1681,88,82
88,83,815,301,228,49,0,1393,88,83
88,84,1630,1077,110,152,0,2969,88,84
88,85,1082,63,12,52,0,1209,88,85
88,86,354,467,0,186,0,1007,88,86
88,87,2741,2463,0,788,0,5992,88,87
88,88,2912,22379,0,599,0,25890,88,88
88,89,624,440,0,166,0,1230,88,89
88,90,1807,1884,0,123,105,3919,88,90
88,91,158,28,0,537,0,723,88,91
88,92,277,0,5,0,0,282,88,92
88,93,1451,186,0,297,0,1934,88,93
88,94,1970,993,153,788,0,3904,88,94
88,95,355,0,275,0,0,630,88,95
88,96,689,0,0,0,0,689,88,96
88,97,455,0,202,0,0,657,88,97
88,98,276,0,0,0,0,276,88,98
88,99,138,0,107,0,0,245,88,99
88,100,747,0,570,536,0,1853,88,100
88,101,883,261,865,361,0,2370,88,101
88,102,934,0,0,0,0,934,88,102
88,103,0,0,0,72,0,72,88,103
88,104,171,0,0,0,0,171,88,104
88,105,294,0,0,0,0,294,88,105
88,106,69,0,0,0,0,69,88,106
88,107,850,0,153,435,0,1438,88,107
88,109,276,0,0,0,0,276,88,109
88,115,138,0,0,0,0,138,88,115
88,116,0,0,584,0,0,584,88,116
88,118,0,0,181,0,0,181,88,118
88,119,0,0,504,0,0,504,88,119
88,121,666,0,1032,0,0,1698,88,121
88,125,420,0,457,0,0,877,88,125
88,126,100,0,0,0,0,100,88,126
88,127,0,0,295,0,0,295,88,127
88,130,0,0,138,0,0,138,88,130
88,131,138,0,0,0,0,138,88,131
88,132,435,0,0,0,0,435,88,132
88,136,156,0,439,0,0,595,88,136
88,137,0,0,0,138,0,138,88,137
88,140,0,0,153,0,0,153,88,140
88,141,0,0,0,62,0,62,88,141
88,144,0,0,807,0,0,807,88,144
88,151,0,0,814,0,0,814,88,151
88,154,253,0,0,0,0,253,88,154
88,162,253,0,0,0,0,253,88,162
88,165,32,0,0,0,0,32,88,165
88,171,0,0,138,0,0,138,88,171
88,173,0,0,272,0,0,272,88,173
88,186,0,0,97,0,0,97,88,186
88,194,0,0,101,0,0,101,88,194
88,219,0,0,343,0,0,343,88,219
88,222,0,0,496,0,0,496,88,222
88,231,152,0,0,0,0,152,88,231
88,239,391,0,0,0,0,391,88,239
88,241,0,0,116,0,0,116,88,241
88,261,0,0,0,253,0,253,88,261
88,264,0,0,518,0,0,518,88,264
88,269,276,0,0,0,0,276,88,269
88,271,138,0,153,0,0,291,88,271
88,274,101,0,138,0,0,239,88,274
88,276,101,0,0,0,0,101,88,276
88,278,0,0,288,0,0,288,88,278
88,283,0,0,112,0,0,112,88,283
88,288,32,0,0,0,0,32,88,288
88,295,0,0,1304,0,0,1304,88,295
88,300,276,0,110,0,0,386,88,300
88,301,0,0,170,0,0,170,88,301
88,316,101,0,0,0,0,101,88,316
88,319,0,0,136,0,0,136,88,319
88,327,247,0,0,0,0,247,88,327
88,331,0,0,515,0,0,515,88,331
88,339,101,0,717,0,0,818,88,339
88,340,0,0,0,220,0,220,88,340
89,1,0,0,72,0,0,72,89,1
89,4,0,0,0,168,0,168,89,4
89,5,0,0,52,0,0,52,89,5
89,6,0,0,231,0,0,231,89,6
89,7,0,0,392,0,0,392,89,7
89,9,62,0,0,0,0,62,89,9
89,12,118,0,0,0,0,118,89,12
89,24,0,0,168,0,0,168,89,24
89,27,0,0,405,0,0,405,89,27
89,28,0,0,145,0,0,145,89,28
89,29,0,0,48,0,0,48,89,29
89,30,0,0,119,0,0,119,89,30
89,31,0,0,119,0,0,119,89,31
89,32,0,0,48,0,0,48,89,32
89,34,48,0,79,0,0,127,89,34
89,35,0,0,101,0,0,101,89,35
89,36,48,0,31,48,0,127,89,36
89,49,0,0,31,0,0,31,89,49
89,56,48,0,224,0,0,272,89,56
89,57,296,0,0,0,0,296,89,57
89,59,0,0,0,57,0,57,89,59
89,68,48,0,0,150,0,198,89,68
89,69,0,0,183,0,0,183,89,69
89,72,0,0,48,0,0,48,89,72
89,77,149,0,52,0,0,201,89,77
89,78,0,0,143,96,0,239,89,78
89,79,0,0,168,0,0,168,89,79
89,80,216,0,0,0,69,285,89,80
89,81,0,0,57,0,0,57,89,81
89,83,477,0,287,0,799,1563,89,83
89,84,325,0,0,124,0,449,89,84
89,86,0,0,226,0,147,373,89,86
89,87,738,184,0,0,0,922,89,87
89,88,499,440,0,166,0,1105,89,88
89,89,152,1287,0,0,0,1439,89,89
89,90,947,0,0,134,0,1081,89,90
89,91,0,0,9,0,0,9,89,91
89,93,40,0,0,0,0,40,89,93
89,94,269,0,0,0,0,269,89,94
89,95,0,81,0,0,0,81,89,95
89,96,505,168,119,0,0,792,89,96
89,97,35,0,0,0,0,35,89,97
89,99,224,0,0,0,0,224,89,99
89,100,0,418,183,237,0,838,89,100
89,101,230,0,158,0,0,388,89,101
89,102,114,0,0,0,0,114,89,102
89,104,0,0,127,0,0,127,89,104
89,105,0,0,0,28,0,28,89,105
89,111,0,0,625,0,0,625,89,111
89,113,0,0,557,0,0,557,89,113
89,130,0,0,114,0,0,114,89,130
89,133,446,0,0,0,0,446,89,133
89,135,0,0,0,59,0,59,89,135
89,136,0,0,243,0,0,243,89,136
89,138,276,0,0,85,0,361,89,138
89,139,0,0,0,607,0,607,89,139
89,153,152,0,0,0,0,152,89,153
89,155,168,0,0,0,0,168,89,155
89,214,0,0,423,0,0,423,89,214
89,240,0,0,210,0,0,210,89,240
89,243,127,0,0,0,0,127,89,243
89,281,0,0,290,0,0,290,89,281
89,323,198,0,0,0,0,198,89,323
89,326,48,0,0,0,0,48,89,326
89,339,0,0,135,0,0,135,89,339
89,340,0,0,23,0,0,23,89,340
90,1,0,0,134,0,0,134,90,1
90,3,0,0,123,0,0,123,90,3
90,5,123,0,326,0,0,449,90,5
90,6,62,0,76,0,0,138,90,6
90,7,0,0,67,0,0,67,90,7
90,10,0,0,0,189,0,189,90,10
90,19,123,0,0,0,0,123,90,19
90,24,214,0,718,0,0,932,90,24
90,25,0,0,0,62,0,62,90,25
90,27,93,0,124,378,0,595,90,27
90,28,189,0,62,0,0,251,90,28
90,29,0,0,62,0,0,62,90,29
90,30,199,0,0,0,0,199,90,30
90,31,0,0,581,0,0,581,90,31
90,32,0,0,79,0,0,79,90,32
90,34,129,0,0,0,0,129,90,34
90,36,62,0,67,448,0,577,90,36
90,37,91,0,83,0,0,174,90,37
90,49,0,0,72,0,0,72,90,49
90,54,14,0,0,0,0,14,90,54
90,58,0,0,109,0,0,109,90,58
90,61,0,0,123,0,0,123,90,61
90,66,166,0,0,0,0,166,90,66
90,68,62,0,0,337,0,399,90,68
90,70,62,0,0,0,0,62,90,70
90,71,0,0,0,193,0,193,90,71
90,73,171,0,0,0,0,171,90,73
90,74,0,0,209,0,0,209,90,74
90,75,0,0,35,0,0,35,90,75
90,77,62,0,0,0,0,62,90,77
90,78,189,0,67,0,0,256,90,78
90,79,83,0,189,76,0,348,90,79
90,82,0,0,233,214,89,536,90,82
90,83,371,189,206,69,0,835,90,83
90,84,526,51,118,281,0,976,90,84
90,85,11,0,26,0,0,37,90,85
90,86,18,0,482,0,0,500,90,86
90,87,768,262,243,0,0,1273,90,87
90,88,1591,2044,0,335,105,4075,90,88
90,89,659,168,0,294,0,1121,90,89
90,90,1981,5473,254,859,549,9116,90,90
90,91,132,0,0,31,0,163,90,91
90,93,89,0,79,0,0,168,90,93
90,94,201,536,0,0,0,737,90,94
90,95,164,0,0,0,0,164,90,95
90,96,959,0,0,0,0,959,90,96
90,97,162,0,38,35,0,235,90,97
90,98,281,0,25,0,0,306,90,98
90,99,51,0,0,0,0,51,90,99
90,100,790,432,418,178,274,2092,90,100
90,101,1861,129,0,328,0,2318,90,101
90,103,11,0,6,35,0,52,90,103
90,104,63,0,0,0,0,63,90,104
90,105,269,0,0,371,0,640,90,105
90,108,123,0,0,0,0,123,90,108
90,109,189,0,0,0,0,189,90,109
90,112,0,0,667,0,0,667,90,112
90,113,62,0,98,0,0,160,90,113
90,116,0,0,415,0,0,415,90,116
90,123,0,0,0,367,0,367,90,123
90,127,0,0,67,0,0,67,90,127
90,128,0,0,10,0,0,10,90,128
90,131,62,0,0,0,0,62,90,131
90,135,170,0,0,0,0,170,90,135
90,138,62,0,0,0,0,62,90,138
90,139,0,0,121,0,0,121,90,139
90,140,62,0,0,0,0,62,90,140
90,142,0,0,0,669,0,669,90,142
90,144,994,0,0,0,0,994,90,144
90,147,62,0,0,0,0,62,90,147
90,153,0,0,0,152,0,152,90,153
90,154,0,0,226,0,0,226,90,154
90,160,0,0,422,0,0,422,90,160
90,165,0,0,25,0,0,25,90,165
90,166,62,0,0,0,0,62,90,166
90,192,994,0,0,0,0,994,90,192
90,202,0,0,546,0,0,546,90,202
90,213,0,0,396,0,0,396,90,213
90,220,239,0,0,0,0,239,90,220
90,240,0,0,0,0,274,274,90,240
90,270,0,0,0,54,0,54,90,270
90,272,136,0,0,0,0,136,90,272
90,283,0,0,54,0,0,54,90,283
90,316,189,0,0,0,0,189,90,316
90,317,7,0,0,0,0,7,90,317
90,319,12,0,0,0,0,12,90,319
90,320,0,0,299,0,0,299,90,320
90,322,0,0,0,24,0,24,90,322
90,334,185,0,0,0,0,185,90,334
90,338,62,0,0,0,0,62,90,338
90,339,62,0,0,0,0,62,90,339
90,340,0,0,0,44,0,44,90,340
90,342,0,0,129,0,0,129,90,342
91,8,0,228,80,0,0,308,91,8
91,19,0,0,884,0,0,884,91,19
91,21,110,0,83,0,0,193,91,21
91,26,0,0,156,0,0,156,91,26
91,27,31,0,0,0,0,31,91,27
91,28,60,0,28,0,0,88,91,28
91,30,95,0,0,0,0,95,91,30
91,31,0,0,0,30,0,30,91,31
91,32,10,0,0,0,0,10,91,32
91,33,0,0,24,0,0,24,91,33
91,34,37,0,0,0,0,37,91,34
91,35,0,0,182,0,0,182,91,35
91,36,95,0,0,0,0,95,91,36
91,37,44,0,62,0,0,106,91,37
91,39,0,0,736,0,0,736,91,39
91,41,26,0,429,0,0,455,91,41
91,42,0,0,81,0,0,81,91,42
91,43,0,0,9,0,0,9,91,43
91,45,0,0,0,660,0,660,91,45
91,46,0,0,193,0,0,193,91,46
91,47,107,0,134,0,0,241,91,47
91,48,0,0,186,0,0,186,91,48
91,52,0,0,89,0,0,89,91,52
91,55,0,0,192,0,0,192,91,55
91,56,0,0,17,0,0,17,91,56
91,58,31,0,0,0,0,31,91,58
91,63,0,0,0,10,0,10,91,63
91,67,0,0,80,0,0,80,91,67
91,68,9,0,9,0,0,18,91,68
91,73,0,0,0,62,0,62,91,73
91,75,35,0,0,0,0,35,91,75
91,76,57,0,0,0,0,57,91,76
91,77,280,0,0,0,0,280,91,77
91,79,41,0,0,0,0,41,91,79
91,82,0,0,30,33,0,63,91,82
91,83,58,0,0,0,0,58,91,83
91,84,121,0,55,8,0,184,91,84
91,85,65,0,0,0,0,65,91,85
91,86,9,0,80,0,0,89,91,86
91,87,0,0,0,27,0,27,91,87
91,88,182,28,0,537,0,747,91,88
91,89,0,0,9,0,0,9,91,89
91,90,199,0,0,31,0,230,91,90
91,91,37,2802,0,37,0,2876,91,91
91,92,0,0,57,0,0,57,91,92
91,93,31,0,1033,0,41,1105,91,93
91,94,20,0,48,0,0,68,91,94
91,98,8,0,0,23,0,31,91,98
91,99,338,73,0,23,0,434,91,99
91,100,202,10,692,25,0,929,91,100
91,101,0,0,180,0,0,180,91,101
91,102,9,0,0,0,0,9,91,102
91,103,10,0,0,0,0,10,91,103
91,104,9,0,0,0,0,9,91,104
91,105,10,0,0,0,0,10,91,105
91,107,0,0,31,0,0,31,91,107
91,109,0,0,825,0,0,825,91,109
91,110,655,0,0,0,0,655,91,110
91,111,660,0,828,0,0,1488,91,111
91,113,269,0,31,0,0,300,91,113
91,115,0,0,318,0,0,318,91,115
91,116,0,0,675,1374,0,2049,91,116
91,117,0,0,1557,660,0,2217,91,117
91,118,0,0,490,0,0,490,91,118
91,119,0,0,2188,0,0,2188,91,119
91,121,0,0,0,337,0,337,91,121
91,122,0,0,725,0,0,725,91,122
91,123,0,0,2119,0,0,2119,91,123
91,124,507,0,1103,0,0,1610,91,124
91,125,0,0,0,264,0,264,91,125
91,127,671,1775,911,46,0,3403,91,127
91,128,0,0,10,0,0,10,91,128
91,129,0,0,26,0,0,26,91,129
91,130,0,0,30,0,0,30,91,130
91,131,0,0,912,0,0,912,91,131
91,135,340,0,0,0,0,340,91,135
91,136,17,0,196,0,0,213,91,136
91,137,0,0,1466,0,0,1466,91,137
91,138,247,0,0,0,35,282,91,138
91,139,0,0,327,0,0,327,91,139
91,140,8,0,1175,0,0,1183,91,140
91,141,9,0,0,0,0,9,91,141
91,142,0,0,1079,0,0,1079,91,142
91,144,824,0,671,0,0,1495,91,144
91,153,245,0,0,0,0,245,91,153
91,156,0,0,292,0,0,292,91,156
91,159,59,0,0,0,0,59,91,159
91,164,0,0,74,0,0,74,91,164
91,166,0,0,285,0,0,285,91,166
91,167,0,0,142,0,0,142,91,167
91,170,0,0,437,0,0,437,91,170
91,173,0,0,215,0,0,215,91,173
91,177,0,0,91,0,0,91,91,177
91,211,0,0,519,0,0,519,91,211
91,218,0,0,639,0,0,639,91,218
91,219,343,0,1365,0,0,1708,91,219
91,223,0,0,171,0,0,171,91,223
91,225,0,0,316,0,0,316,91,225
91,227,0,0,261,0,0,261,91,227
91,228,0,0,0,455,0,455,91,228
91,236,41,0,0,0,0,41,91,236
91,246,0,0,113,0,0,113,91,246
91,251,0,0,200,0,0,200,91,251
91,256,0,0,261,0,0,261,91,256
91,260,0,0,1200,0,0,1200,91,260
91,265,0,0,679,0,0,679,91,265
91,266,0,0,119,0,0,119,91,266
91,269,0,0,158,0,0,158,91,269
91,274,0,0,159,0,0,159,91,274
91,282,201,0,0,0,0,201,91,282
91,295,0,0,555,0,0,555,91,295
91,300,0,0,315,0,0,315,91,300
91,303,20,0,0,0,0,20,91,303
91,307,0,0,28,0,0,28,91,307
91,308,0,0,0,202,0,202,91,308
91,315,185,0,0,0,0,185,91,315
91,319,10,0,0,0,0,10,91,319
91,320,0,0,299,0,0,299,91,320
91,332,0,0,1275,0,0,1275,91,332
91,333,0,0,147,0,0,147,91,333
91,334,0,0,741,0,0,741,91,334
91,336,0,0,648,0,0,648,91,336
91,337,10,0,0,0,0,10,91,337
92,1,0,0,4,0,0,4,92,1
92,3,0,0,138,0,0,138,92,3
92,4,0,0,6,0,0,6,92,4
92,5,114,0,5,0,0,119,92,5
92,6,3,0,1,0,0,4,92,6
92,7,0,0,0,189,0,189,92,7
92,16,0,0,4,0,0,4,92,16
92,17,0,0,21,0,0,21,92,17
92,23,0,0,0,100,0,100,92,23
92,26,0,0,144,0,0,144,92,26
92,27,0,0,4,0,0,4,92,27
92,29,0,0,63,0,0,63,92,29
92,30,15,0,0,5,0,20,92,30
92,32,93,0,0,0,0,93,92,32
92,35,532,493,0,0,0,1025,92,35
92,36,41,95,412,0,0,548,92,36
92,37,52,460,0,0,0,512,92,37
92,40,18,0,0,0,0,18,92,40
92,43,0,0,120,1,0,121,92,43
92,51,0,0,1,0,0,1,92,51
92,52,0,0,42,0,0,42,92,52
92,54,0,0,6,0,0,6,92,54
92,56,0,0,148,0,0,148,92,56
92,62,0,0,27,27,0,54,92,62
92,63,0,0,4,0,0,4,92,63
92,64,0,0,0,120,0,120,92,64
92,66,47,0,0,0,0,47,92,66
92,75,0,0,35,0,0,35,92,75
92,76,436,0,0,0,0,436,92,76
92,78,0,0,72,0,0,72,92,78
92,79,41,0,41,23,0,105,92,79
92,83,4,0,285,0,0,289,92,83
92,84,4,6,0,0,0,10,92,84
92,85,120,0,0,0,0,120,92,85
92,87,64,0,0,0,0,64,92,87
92,88,253,0,115,0,0,368,92,88
92,91,0,0,57,0,0,57,92,91
92,92,15,5866,0,20,0,5901,92,92
92,93,40,742,0,0,6,788,92,93
92,94,62,35,0,4,0,101,92,94
92,95,102,0,5,0,0,107,92,95
92,96,0,0,4,0,0,4,92,96
92,97,1034,0,0,0,0,1034,92,97
92,99,4,0,0,0,0,4,92,99
92,100,10,0,8,0,0,18,92,100
92,105,50,0,0,0,0,50,92,105
92,109,0,0,59,0,0,59,92,109
92,112,0,0,0,167,0,167,92,112
92,119,879,0,0,0,0,879,92,119
92,121,0,0,590,0,0,590,92,121
92,124,404,0,0,0,0,404,92,124
92,126,0,0,268,0,0,268,92,126
92,127,0,0,5,0,0,5,92,127
92,128,0,0,10,0,0,10,92,128
92,134,0,0,205,0,0,205,92,134
92,136,26,995,0,0,0,1021,92,136
92,138,0,0,124,0,0,124,92,138
92,139,4,0,0,0,0,4,92,139
92,140,19,0,426,10,0,455,92,140
92,144,10,0,0,0,0,10,92,144
92,145,0,0,27,0,0,27,92,145
92,152,0,0,187,0,0,187,92,152
92,153,93,0,0,0,0,93,92,153
92,155,292,0,0,0,0,292,92,155
92,168,0,0,0,4,0,4,92,168
92,174,0,0,302,0,0,302,92,174
92,195,0,0,317,0,0,317,92,195
92,202,0,0,766,0,0,766,92,202
92,204,1,0,0,0,0,1,92,204
92,215,0,0,4,0,0,4,92,215
92,216,0,0,444,0,0,444,92,216
92,218,0,0,873,0,0,873,92,218
92,225,4,0,4,0,0,8,92,225
92,226,0,0,493,0,0,493,92,226
92,229,0,0,450,0,0,450,92,229
92,237,0,0,111,0,0,111,92,237
92,261,0,0,426,0,0,426,92,261
92,275,0,0,274,0,0,274,92,275
92,279,0,0,225,0,0,225,92,279
92,280,0,0,4,0,0,4,92,280
92,283,0,0,4,0,0,4,92,283
92,286,86,0,0,0,0,86,92,286
92,302,0,0,5,0,0,5,92,302
92,316,72,0,0,0,0,72,92,316
92,317,0,0,14,0,0,14,92,317
92,327,0,0,27,0,0,27,92,327
92,329,0,0,34,0,0,34,92,329
92,334,192,0,0,0,0,192,92,334
92,336,295,0,0,166,0,461,92,336
92,338,0,0,134,0,0,134,92,338
92,339,0,0,5,0,0,5,92,339
93,1,0,0,83,0,0,83,93,1
93,2,0,0,44,0,0,44,93,2
93,3,0,0,312,0,0,312,93,3
93,4,0,0,561,0,0,561,93,4
93,5,0,447,134,0,0,581,93,5
93,6,40,0,739,0,0,779,93,6
93,7,260,0,0,0,0,260,93,7
93,8,0,0,339,0,0,339,93,8
93,12,0,0,268,0,0,268,93,12
93,15,0,0,53,0,0,53,93,15
93,16,0,0,40,0,0,40,93,16
93,17,0,0,59,0,0,59,93,17
93,19,0,0,156,0,0,156,93,19
93,20,0,0,0,254,0,254,93,20
93,21,83,0,120,0,0,203,93,21
93,23,40,0,29,0,0,69,93,23
93,24,0,0,1075,0,0,1075,93,24
93,25,0,0,160,0,0,160,93,25
93,26,168,0,0,0,0,168,93,26
93,27,246,0,243,0,0,489,93,27
93,29,48,40,0,0,0,88,93,29
93,30,135,0,40,0,0,175,93,30
93,31,4,0,400,301,0,705,93,31
93,32,0,0,60,27,0,87,93,32
93,33,51,0,31,0,0,82,93,33
93,34,30,23,0,39,0,92,93,34
93,35,24,0,335,0,0,359,93,35
93,36,1916,1236,54,1309,0,4515,93,36
93,37,92,378,0,0,0,470,93,37
93,39,40,0,78,0,0,118,93,39
93,40,18,0,18,0,0,36,93,40
93,43,0,0,0,0,59,59,93,43
93,46,0,0,345,0,0,345,93,46
93,49,0,0,201,0,0,201,93,49
93,54,40,0,14,0,0,54,93,54
93,55,0,0,28,0,0,28,93,55
93,56,381,0,0,0,0,381,93,56
93,57,155,0,65,0,0,220,93,57
93,58,0,0,92,0,0,92,93,58
93,59,0,0,393,0,0,393,93,59
93,63,23,0,0,0,0,23,93,63
93,65,227,0,0,0,0,227,93,65
93,67,0,0,88,0,0,88,93,67
93,68,191,0,117,0,0,308,93,68
93,71,0,0,0,109,0,109,93,71
93,73,40,0,0,0,0,40,93,73
93,74,0,0,397,0,0,397,93,74
93,75,56,0,209,0,0,265,93,75
93,77,40,0,0,0,0,40,93,77
93,78,0,0,10,102,0,112,93,78
93,79,63,0,23,40,0,126,93,79
93,80,0,0,567,0,0,567,93,80
93,81,87,0,0,0,0,87,93,81
93,82,0,0,0,70,0,70,93,82
93,83,0,0,53,0,0,53,93,83
93,84,497,1382,100,249,262,2490,93,84
93,85,158,456,0,11,0,625,93,85
93,86,127,0,63,0,0,190,93,86
93,87,240,113,0,0,0,353,93,87
93,88,1473,186,0,0,0,1659,93,88
93,89,40,0,0,168,0,208,93,89
93,90,89,0,79,0,0,168,93,90
93,91,37,0,0,0,41,78,93,91
93,92,438,200,873,0,6,1517,93,92
93,93,233,6731,237,0,0,7201,93,93
93,94,543,2150,204,128,0,3025,93,94
93,95,40,0,574,0,0,614,93,95
93,96,27,0,88,0,0,115,93,96
93,97,0,0,0,45,0,45,93,97
93,98,15,0,0,0,0,15,93,98
93,99,249,0,472,0,0,721,93,99
93,100,229,0,237,0,0,466,93,100
93,101,0,0,207,0,0,207,93,101
93,102,177,0,53,0,0,230,93,102
93,103,70,0,26,0,0,96,93,103
93,104,42,0,0,0,0,42,93,104
93,105,128,0,54,0,0,182,93,105
93,107,322,0,108,0,0,430,93,107
93,108,0,0,25,0,0,25,93,108
93,109,613,0,2984,0,0,3597,93,109
93,110,0,0,1757,0,0,1757,93,110
93,112,0,0,487,0,0,487,93,112
93,115,0,0,1610,0,0,1610,93,115
93,116,0,0,3197,0,0,3197,93,116
93,117,0,0,610,0,0,610,93,117
93,119,0,0,1169,0,0,1169,93,119
93,121,0,0,1032,0,0,1032,93,121
93,122,555,0,527,0,0,1082,93,122
93,123,0,0,1142,0,0,1142,93,123
93,124,0,0,943,0,0,943,93,124
93,125,0,0,1321,0,0,1321,93,125
93,126,261,0,0,0,0,261,93,126
93,128,0,0,87,0,0,87,93,128
93,129,0,0,80,0,0,80,93,129
93,133,0,0,0,109,0,109,93,133
93,135,170,0,0,0,0,170,93,135
93,137,0,0,552,0,0,552,93,137
93,139,97,0,294,0,0,391,93,139
93,140,343,0,0,0,0,343,93,140
93,141,531,0,25,0,0,556,93,141
93,142,0,0,728,273,0,1001,93,142
93,152,0,0,539,0,0,539,93,152
93,158,0,0,1133,0,0,1133,93,158
93,163,28,0,676,0,0,704,93,163
93,166,0,0,258,0,0,258,93,166
93,168,0,0,404,0,0,404,93,168
93,172,0,0,200,0,0,200,93,172
93,174,0,0,601,0,0,601,93,174
93,177,0,0,30,0,0,30,93,177
93,180,66,0,325,0,0,391,93,180
93,183,0,0,1788,0,0,1788,93,183
93,184,0,0,53,0,0,53,93,184
93,187,222,0,311,0,0,533,93,187
93,188,0,0,732,0,0,732,93,188
93,190,487,0,244,0,0,731,93,190
93,196,0,0,108,0,0,108,93,196
93,198,0,0,246,0,0,246,93,198
93,200,0,0,222,0,0,222,93,200
93,201,0,0,742,0,0,742,93,201
93,202,0,0,1532,0,0,1532,93,202
93,203,190,0,0,0,0,190,93,203
93,204,0,0,1418,0,0,1418,93,204
93,205,0,0,796,0,0,796,93,205
93,209,0,0,174,0,0,174,93,209
93,210,0,0,391,0,0,391,93,210
93,212,0,0,49,0,0,49,93,212
93,213,0,0,449,0,0,449,93,213
93,215,0,0,285,0,0,285,93,215
93,216,0,0,336,0,0,336,93,216
93,218,0,0,1377,0,0,1377,93,218
93,220,0,0,239,0,0,239,93,220
93,221,0,0,281,0,0,281,93,221
93,226,0,0,213,0,0,213,93,226
93,227,501,0,180,0,0,681,93,227
93,228,0,0,805,0,0,805,93,228
93,230,0,0,1302,0,0,1302,93,230
93,231,0,0,406,0,0,406,93,231
93,233,0,0,436,0,0,436,93,233
93,234,0,0,684,0,0,684,93,234
93,239,0,0,240,61,0,301,93,239
93,241,0,0,120,0,0,120,93,241
93,243,0,0,56,0,0,56,93,243
93,244,0,0,195,0,0,195,93,244
93,246,0,0,113,0,0,113,93,246
93,256,261,0,0,0,0,261,93,256
93,257,0,0,0,56,0,56,93,257
93,261,426,0,0,0,0,426,93,261
93,267,0,0,147,0,0,147,93,267
93,270,162,0,69,0,0,231,93,270
93,273,436,0,0,0,0,436,93,273
93,274,0,0,196,0,0,196,93,274
93,278,0,0,228,0,0,228,93,278
93,279,0,0,299,0,0,299,93,279
93,290,0,0,822,0,0,822,93,290
93,293,0,0,1283,0,0,1283,93,293
93,302,0,0,40,0,0,40,93,302
93,308,0,0,220,0,0,220,93,308
93,310,0,0,259,0,0,259,93,310
93,316,0,0,0,72,0,72,93,316
93,319,29,0,0,0,0,29,93,319
93,329,51,0,55,0,0,106,93,329
93,331,0,0,281,0,0,281,93,331
93,332,0,0,441,0,0,441,93,332
93,333,0,0,110,0,0,110,93,333
93,334,0,0,534,0,0,534,93,334
93,336,0,0,181,0,0,181,93,336
93,337,0,0,143,0,0,143,93,337
93,339,40,0,67,0,0,107,93,339
94,4,35,35,0,0,0,70,94,4
94,5,0,0,77,0,0,77,94,5
94,6,0,0,38,0,0,38,94,6
94,7,0,0,83,0,0,83,94,7
94,8,0,0,38,0,0,38,94,8
94,9,62,0,92,0,0,154,94,9
94,17,13,0,0,0,0,13,94,17
94,20,254,0,0,0,0,254,94,20
94,25,0,0,523,0,0,523,94,25
94,26,0,0,295,127,0,422,94,26
94,27,0,0,192,0,0,192,94,27
94,28,167,0,0,0,0,167,94,28
94,29,0,0,75,0,0,75,94,29
94,30,13,0,106,0,0,119,94,30
94,31,200,0,159,0,0,359,94,31
94,32,131,0,223,0,0,354,94,32
94,33,7,0,0,0,0,7,94,33
94,35,0,0,29,0,0,29,94,35
94,36,498,445,361,0,0,1304,94,36
94,37,91,83,0,0,0,174,94,37
94,43,0,0,62,0,0,62,94,43
94,45,166,0,131,0,0,297,94,45
94,47,0,0,107,0,0,107,94,47
94,49,62,0,0,0,0,62,94,49
94,50,74,0,0,0,0,74,94,50
94,52,0,0,62,0,0,62,94,52
94,54,0,0,35,0,0,35,94,54
94,55,168,0,35,0,0,203,94,55
94,56,35,0,0,0,0,35,94,56
94,58,100,0,0,0,0,100,94,58
94,60,0,0,0,102,0,102,94,60
94,61,0,0,62,0,0,62,94,61
94,62,0,0,27,0,0,27,94,62
94,63,11,0,0,0,0,11,94,63
94,65,224,0,0,0,0,224,94,65
94,67,80,0,0,0,0,80,94,67
94,68,150,0,26,0,0,176,94,68
94,69,0,0,0,127,0,127,94,69
94,70,0,0,67,0,0,67,94,70
94,73,76,0,0,0,0,76,94,73
94,74,0,0,176,139,0,315,94,74
94,75,91,0,582,0,0,673,94,75
94,76,97,0,38,0,0,135,94,76
94,77,0,0,0,109,0,109,94,77
94,78,0,0,0,62,0,62,94,78
94,79,82,0,132,62,0,276,94,79
94,80,0,0,0,44,0,44,94,80
94,81,0,0,0,56,0,56,94,81
94,82,0,0,67,0,0,67,94,82
94,83,0,189,96,0,0,285,94,83
94,84,748,407,55,0,0,1210,94,84
94,85,24,0,19,64,0,107,94,85
94,86,109,0,10,63,0,182,94,86
94,87,255,0,29,67,0,351,94,87
94,88,1654,1666,153,446,0,3919,94,88
94,89,269,0,0,0,0,269,94,89
94,90,263,293,67,47,0,670,94,90
94,91,20,0,52,0,0,72,94,91
94,92,62,35,0,4,0,101,94,92
94,93,457,1572,90,128,0,2247,94,93
94,94,681,7846,0,158,0,8685,94,94
94,95,254,0,0,110,0,364,94,95
94,98,12,0,25,0,0,37,94,98
94,99,0,62,122,0,0,184,94,99
94,100,158,232,347,638,0,1375,94,100
94,101,360,0,0,328,0,688,94,101
94,102,0,0,53,0,213,266,94,102
94,103,90,0,0,0,0,90,94,103
94,104,0,0,23,0,0,23,94,104
94,105,204,0,380,271,0,855,94,105
94,107,198,0,0,0,0,198,94,107
94,108,218,0,0,0,0,218,94,108
94,109,316,0,389,0,0,705,94,109
94,110,224,0,634,0,0,858,94,110
94,111,377,0,1142,0,0,1519,94,111
94,115,0,0,526,0,0,526,94,115
94,123,594,0,0,367,0,961,94,123
94,124,507,0,558,0,0,1065,94,124
94,127,0,0,86,0,0,86,94,127
94,129,0,0,45,0,0,45,94,129
94,133,53,0,0,0,0,53,94,133
94,136,35,0,0,0,0,35,94,136
94,137,0,0,1114,0,0,1114,94,137
94,138,62,0,207,0,0,269,94,138
94,139,104,0,0,0,0,104,94,139
94,141,0,0,578,0,0,578,94,141
94,151,0,0,720,0,0,720,94,151
94,152,0,0,187,0,0,187,94,152
94,153,0,0,0,35,0,35,94,153
94,154,498,0,0,0,0,498,94,154
94,156,0,0,338,0,0,338,94,156
94,166,46,0,0,0,0,46,94,166
94,184,0,0,210,0,0,210,94,184
94,189,0,0,397,0,0,397,94,189
94,203,0,0,190,0,0,190,94,203
94,207,0,0,593,0,0,593,94,207
94,208,0,0,402,0,0,402,94,208
94,217,0,0,467,0,0,467,94,217
94,221,0,0,364,0,0,364,94,221
94,226,0,0,213,0,0,213,94,226
94,236,0,0,122,0,0,122,94,236
94,252,0,0,745,0,0,745,94,252
94,254,31,0,0,0,0,31,94,254
94,257,631,0,255,0,0,886,94,257
94,264,0,0,419,0,0,419,94,264
94,270,349,0,0,0,0,349,94,270
94,275,0,0,0,35,0,35,94,275
94,278,0,0,395,0,0,395,94,278
94,281,0,0,173,0,0,173,94,281
94,285,35,0,0,0,0,35,94,285
94,300,0,0,666,0,0,666,94,300
94,303,31,0,43,0,0,74,94,303
94,316,72,0,0,0,0,72,94,316
94,322,77,0,0,0,0,77,94,322
94,329,0,0,117,0,0,117,94,329
94,334,35,0,0,0,0,35,94,334
94,336,0,0,548,0,0,548,94,336
94,341,77,0,0,0,0,77,94,341
95,1,0,0,343,0,0,343,95,1
95,2,0,0,75,0,0,75,95,2
95,7,75,0,204,0,0,279,95,7
95,8,0,0,111,0,0,111,95,8
95,22,39,0,0,0,0,39,95,22
95,27,75,0,102,75,0,252,95,27
95,28,60,0,140,0,0,200,95,28
95,29,0,0,216,35,0,251,95,29
95,30,0,0,64,0,0,64,95,30
95,31,102,0,302,0,0,404,95,31
95,32,0,0,204,0,0,204,95,32
95,33,47,0,0,0,0,47,95,33
95,34,53,0,0,102,0,155,95,34
95,35,102,0,0,0,0,102,95,35
95,36,95,0,0,0,0,95,95,36
95,37,0,0,81,0,0,81,95,37
95,41,0,0,30,0,0,30,95,41
95,50,0,0,74,0,0,74,95,50
95,52,0,0,150,75,0,225,95,52
95,54,37,0,75,0,0,112,95,54
95,55,102,0,0,0,0,102,95,55
95,56,0,0,0,75,0,75,95,56
95,57,102,0,0,0,0,102,95,57
95,63,6,0,0,0,0,6,95,63
95,64,75,0,0,0,0,75,95,64
95,66,0,0,0,465,0,465,95,66
95,67,200,0,0,0,0,200,95,67
95,68,75,0,0,102,0,177,95,68
95,73,130,0,0,102,0,232,95,73
95,74,0,0,141,0,0,141,95,74
95,75,102,0,0,0,0,102,95,75
95,76,102,0,0,0,0,102,95,76
95,77,0,0,0,0,148,148,95,77
95,78,294,0,0,0,0,294,95,78
95,80,815,0,49,0,0,864,95,80
95,81,241,0,57,0,0,298,95,81
95,82,376,129,961,0,147,1613,95,82
95,83,1298,1786,215,39,0,3338,95,83
95,84,204,0,0,0,0,204,95,84
95,85,82,0,0,0,0,82,95,85
95,86,0,0,102,0,0,102,95,86
95,87,247,33,36,182,0,498,95,87
95,88,331,0,275,0,0,606,95,88
95,89,0,24,0,0,0,24,95,89
95,90,164,0,0,0,0,164,95,90
95,92,102,0,5,0,0,107,95,92
95,93,40,0,574,0,0,614,95,93
95,94,146,0,0,26,0,172,95,94
95,95,3524,5453,111,204,0,9292,95,95
95,96,749,605,727,395,0,2476,95,96
95,97,493,0,38,299,0,830,95,97
95,100,802,0,111,437,0,1350,95,100
95,101,1870,639,111,328,0,2948,95,101
95,102,214,0,0,0,0,214,95,102
95,103,37,0,0,0,0,37,95,103
95,104,227,0,0,25,0,252,95,104
95,105,559,0,616,0,0,1175,95,105
95,107,0,0,0,150,0,150,95,107
95,108,102,0,0,0,0,102,95,108
95,111,21,0,0,0,0,21,95,111
95,112,0,0,312,0,0,312,95,112
95,116,0,0,584,0,0,584,95,116
95,117,0,0,111,0,0,111,95,117
95,121,0,0,725,0,0,725,95,121
95,124,102,0,0,0,0,102,95,124
95,127,75,0,0,0,0,75,95,127
95,134,0,0,465,0,0,465,95,134
95,136,189,0,0,0,0,189,95,136
95,205,0,0,592,0,0,592,95,205
95,206,102,0,0,0,0,102,95,206
95,211,1021,0,0,0,0,1021,95,211
95,237,0,0,72,0,0,72,95,237
95,238,0,0,287,0,0,287,95,238
95,253,0,0,24,0,0,24,95,253
95,256,102,0,0,0,0,102,95,256
95,268,84,0,0,0,0,84,95,268
95,270,71,0,0,0,0,71,95,270
95,281,0,0,223,0,0,223,95,281
95,300,149,0,0,0,0,149,95,300
95,301,79,0,0,0,0,79,95,301
95,303,321,0,0,0,0,321,95,303
95,313,0,0,0,421,0,421,95,313
95,314,102,0,0,0,0,102,95,314
95,315,0,0,350,0,0,350,95,315
95,317,28,0,0,0,0,28,95,317
95,318,0,0,112,0,0,112,95,318
95,319,241,0,0,0,0,241,95,319
95,322,465,0,0,0,0,465,95,322
95,330,658,0,0,0,0,658,95,330
95,339,175,0,111,150,0,436,95,339
95,340,242,0,0,37,0,279,95,340
96,1,0,0,67,67,0,134,96,1
96,2,66,0,0,0,0,66,96,2
96,3,0,0,27,0,0,27,96,3
96,4,0,0,255,0,0,255,96,4
96,23,49,0,56,0,0,105,96,23
96,25,0,0,379,0,0,379,96,25
96,27,23,0,0,0,0,23,96,27
96,29,67,0,27,0,0,94,96,29
96,30,58,0,55,0,0,113,96,30
96,31,91,0,0,0,0,91,96,31
96,32,0,0,89,0,0,89,96,32
96,33,37,0,0,0,0,37,96,33
96,34,133,0,0,0,0,133,96,34
96,35,0,0,89,0,0,89,96,35
96,43,0,0,98,0,0,98,96,43
96,49,0,0,50,0,0,50,96,49
96,50,76,0,0,0,0,76,96,50
96,54,0,0,27,66,0,93,96,54
96,55,66,0,0,0,0,66,96,55
96,57,155,0,155,0,0,310,96,57
96,58,0,0,284,0,0,284,96,58
96,63,76,0,73,0,0,149,96,63
96,64,64,0,0,0,0,64,96,64
96,65,76,0,0,0,0,76,96,65
96,68,158,0,0,66,0,224,96,68
96,69,0,0,0,0,95,95,96,69
96,71,218,0,0,0,0,218,96,71
96,73,327,0,102,0,0,429,96,73
96,75,0,0,61,0,0,61,96,75
96,76,65,0,0,0,0,65,96,76
96,77,134,0,0,0,0,134,96,77
96,78,0,0,67,0,0,67,96,78
96,79,108,0,214,0,0,322,96,79
96,80,368,67,118,67,38,658,96,80
96,81,898,0,73,61,0,1032,96,81
96,82,1149,428,238,62,190,2067,96,82
96,83,1101,67,132,0,95,1395,96,83
96,86,40,0,0,18,0,58,96,86
96,87,1139,0,36,33,0,1208,96,87
96,88,295,0,153,0,0,448,96,88
96,89,168,0,119,0,0,287,96,89
96,90,959,0,0,0,0,959,96,90
96,92,0,0,4,0,0,4,96,92
96,93,27,0,88,0,0,115,96,93
96,95,784,605,727,395,0,2511,96,95
96,96,1040,2197,0,325,0,3562,96,96
96,97,800,249,38,600,0,1687,96,97
96,100,297,0,0,0,0,297,96,100
96,101,512,62,0,0,0,574,96,101
96,102,512,0,53,38,0,603,96,102
96,103,6,0,0,0,0,6,96,103
96,104,243,0,0,0,0,243,96,104
96,105,377,0,0,80,0,457,96,105
96,106,35,0,0,0,87,122,96,106
96,107,198,0,108,0,0,306,96,107
96,108,64,0,0,0,0,64,96,108
96,109,67,0,0,0,0,67,96,109
96,113,269,0,0,0,0,269,96,113
96,116,0,0,584,0,0,584,96,116
96,122,0,0,603,0,0,603,96,122
96,127,0,0,348,0,0,348,96,127
96,128,0,0,10,0,0,10,96,128
96,140,152,0,0,0,0,152,96,140
96,169,0,0,67,0,0,67,96,169
96,171,50,0,0,0,0,50,96,171
96,178,102,0,0,0,0,102,96,178
96,214,0,0,124,0,0,124,96,214
96,236,25,0,0,0,0,25,96,236
96,258,0,0,674,0,0,674,96,258
96,269,0,0,82,0,0,82,96,269
96,273,0,0,32,0,0,32,96,273
96,274,67,0,0,0,0,67,96,274
96,280,67,0,0,0,0,67,96,280
96,284,0,0,308,0,0,308,96,284
96,289,0,0,60,0,0,60,96,289
96,291,0,0,305,0,0,305,96,291
96,294,53,0,667,0,0,720,96,294
96,300,94,0,785,0,0,879,96,300
96,303,0,0,38,26,0,64,96,303
96,307,0,0,325,0,0,325,96,307
96,311,0,0,912,0,0,912,96,311
96,317,80,0,0,0,0,80,96,317
96,318,0,0,112,0,0,112,96,318
96,319,67,0,0,0,0,67,96,319
96,321,152,0,0,0,0,152,96,321
96,327,0,0,276,27,0,303,96,327
96,328,0,0,135,0,0,135,96,328
96,329,51,0,0,0,0,51,96,329
96,330,253,0,0,0,0,253,96,330
96,335,67,0,0,0,0,67,96,335
96,336,0,0,548,0,0,548,96,336
96,337,53,0,0,0,0,53,96,337
96,339,459,0,137,0,0,596,96,339
96,340,472,0,0,0,0,472,96,340
96,341,0,0,0,77,0,77,96,341
97,1,0,0,139,0,0,139,97,1
97,2,70,0,0,0,0,70,97,2
97,4,44,0,0,0,0,44,97,4
97,7,51,0,0,0,0,51,97,7
97,19,40,0,0,0,0,40,97,19
97,21,0,0,349,0,0,349,97,21
97,23,0,0,56,0,0,56,97,23
97,24,0,0,96,23,0,119,97,24
97,27,140,0,65,0,0,205,97,27
97,28,38,0,69,0,0,107,97,28
97,29,58,0,0,0,0,58,97,29
97,30,64,0,111,0,0,175,97,30
97,31,35,0,0,0,0,35,97,31
97,32,304,0,35,0,0,339,97,32
97,34,98,0,0,35,0,133,97,34
97,35,35,0,0,0,0,35,97,35
97,36,131,0,0,0,0,131,97,36
97,41,45,0,0,0,0,45,97,41
97,43,56,0,40,0,0,96,97,43
97,44,98,0,0,0,0,98,97,44
97,49,0,0,50,0,0,50,97,49
97,53,0,0,35,0,0,35,97,53
97,54,35,0,0,0,0,35,97,54
97,60,205,0,0,0,0,205,97,60
97,64,193,0,0,0,0,193,97,64
97,65,0,0,0,370,0,370,97,65
97,68,35,0,0,35,0,70,97,68
97,69,154,0,0,35,51,240,97,69
97,70,70,0,38,0,0,108,97,70
97,71,0,0,0,70,0,70,97,71
97,72,40,0,0,0,0,40,97,72
97,73,318,0,0,35,0,353,97,73
97,74,0,0,70,0,0,70,97,74
97,75,70,0,0,0,0,70,97,75
97,76,108,0,0,0,0,108,97,76
97,77,45,0,142,0,0,187,97,77
97,78,23,0,0,0,0,23,97,78
97,79,184,0,780,0,0,964,97,79
97,80,193,0,246,0,0,439,97,80
97,81,104,0,61,0,51,216,97,81
97,82,706,0,370,40,0,1116,97,82
97,83,565,0,78,551,0,1194,97,83
97,84,77,0,35,0,0,112,97,84
97,87,35,0,392,86,0,513,97,87
97,88,455,0,202,0,0,657,97,88
97,90,162,0,38,35,0,235,97,90
97,92,1034,0,0,0,0,1034,97,92
97,93,168,0,0,45,0,213,97,93
97,95,348,0,149,150,0,647,97,95
97,96,845,249,38,45,0,1177,97,96
97,97,1486,5474,0,799,0,7759,97,97
97,99,35,0,0,0,0,35,97,99
97,100,575,0,252,0,0,827,97,100
97,101,314,23,0,746,0,1083,97,101
97,102,819,646,25,115,0,1605,97,102
97,103,19,0,15,555,0,589,97,103
97,104,189,21,70,52,0,332,97,104
97,105,1212,0,184,0,0,1396,97,105
97,106,24,0,0,35,0,59,97,106
97,107,1138,81,0,40,0,1259,97,107
97,108,93,0,0,0,0,93,97,108
97,109,35,0,0,23,0,58,97,109
97,112,287,0,0,0,0,287,97,112
97,113,35,0,426,0,0,461,97,113
97,124,0,0,316,0,0,316,97,124
97,127,35,0,0,0,393,428,97,127
97,132,35,0,0,0,0,35,97,132
97,133,0,0,412,0,0,412,97,133
97,136,0,0,38,0,0,38,97,136
97,153,35,0,0,0,0,35,97,153
97,154,0,0,105,0,0,105,97,154
97,186,0,0,101,0,0,101,97,186
97,200,0,0,0,109,0,109,97,200
97,205,0,0,382,0,0,382,97,205
97,208,0,0,35,0,0,35,97,208
97,239,0,0,40,0,0,40,97,239
97,241,0,0,24,0,0,24,97,241
97,262,0,0,841,0,0,841,97,262
97,268,36,0,168,0,0,204,97,268
97,270,35,0,0,0,0,35,97,270
97,274,196,0,0,0,0,196,97,274
97,294,35,0,0,0,0,35,97,294
97,295,0,0,1013,0,0,1013,97,295
97,300,35,0,0,0,0,35,97,300
97,301,35,0,0,0,0,35,97,301
97,304,40,0,0,0,0,40,97,304
97,305,35,0,0,0,0,35,97,305
97,306,0,0,704,0,0,704,97,306
97,308,0,0,220,0,0,220,97,308
97,317,35,0,0,0,0,35,97,317
97,318,41,0,0,0,0,41,97,318
97,319,115,0,44,58,0,217,97,319
97,321,95,0,0,0,0,95,97,321
97,324,0,0,895,0,0,895,97,324
97,328,90,0,0,56,0,146,97,328
97,330,215,0,0,0,0,215,97,330
97,334,23,0,0,0,0,23,97,334
97,335,90,0,305,0,0,395,97,335
97,337,44,0,621,0,0,665,97,337
97,338,35,0,0,0,0,35,97,338
97,339,281,0,0,813,109,1203,97,339
97,340,210,0,29,0,0,239,97,340
97,341,0,0,60,0,0,60,97,341
98,16,0,0,23,0,0,23,98,16
98,23,0,0,7,0,0,7,98,23
98,24,0,0,8,0,0,8,98,24
98,27,0,0,58,0,0,58,98,27
98,28,0,0,0,7,0,7,98,28
98,29,0,0,7,0,0,7,98,29
98,31,0,0,113,0,0,113,98,31
98,36,0,0,252,0,0,252,98,36
98,41,0,0,53,0,0,53,98,41
98,67,0,0,8,0,0,8,98,67
98,68,7,0,0,7,0,14,98,68
98,70,7,0,0,0,0,7,98,70
98,71,7,0,0,0,0,7,98,71
98,72,0,0,76,0,0,76,98,72
98,79,0,0,69,0,0,69,98,79
98,83,19,0,25,69,0,113,98,83
98,86,12,0,0,0,0,12,98,86
98,88,276,0,0,0,0,276,98,88
98,90,106,0,148,0,0,254,98,90
98,91,8,0,0,23,0,31,98,91
98,92,4,0,0,0,0,4,98,92
98,93,15,0,0,0,0,15,98,93
98,94,19,0,25,0,0,44,98,94
98,98,0,997,0,69,0,1066,98,98
98,99,121,0,74,0,0,195,98,99
98,100,720,113,247,108,77,1265,98,100
98,101,7,0,0,9,0,16,98,101
98,102,28,0,0,0,0,28,98,102
98,103,58,22,0,11,0,91,98,103
98,105,216,0,58,0,0,274,98,105
98,107,0,0,8,0,0,8,98,107
98,109,0,0,2567,0,0,2567,98,109
98,110,0,0,919,0,0,919,98,110
98,111,0,0,0,113,0,113,98,111
98,112,0,0,227,0,0,227,98,112
98,113,188,322,58,107,0,675,98,113
98,115,74,0,0,0,0,74,98,115
98,116,0,0,584,0,0,584,98,116
98,117,53,0,0,0,0,53,98,117
98,118,0,0,8,0,0,8,98,118
98,125,0,0,0,0,766,766,98,125
98,127,279,0,0,0,0,279,98,127
98,136,0,0,0,7,0,7,98,136
98,141,360,0,0,0,0,360,98,141
98,160,0,0,53,0,0,53,98,160
98,161,0,0,0,62,0,62,98,161
98,170,21,0,0,0,0,21,98,170
98,173,0,0,272,0,0,272,98,173
98,229,0,0,450,0,0,450,98,229
98,257,7,0,0,0,0,7,98,257
98,271,0,0,0,94,0,94,98,271
98,273,436,0,0,0,0,436,98,273
98,274,0,0,7,0,0,7,98,274
98,276,0,0,437,0,0,437,98,276
98,281,8,0,0,0,0,8,98,281
98,300,0,0,9,0,0,9,98,300
98,334,7,0,0,0,0,7,98,334
99,2,0,0,96,0,0,96,99,2
99,4,58,0,0,0,0,58,99,4
99,5,0,0,151,0,0,151,99,5
99,9,0,0,58,0,0,58,99,9
99,18,0,0,0,96,0,96,99,18
99,21,0,0,429,0,0,429,99,21
99,22,0,0,67,0,0,67,99,22
99,26,214,0,0,0,0,214,99,26
99,28,119,0,41,0,0,160,99,28
99,29,58,0,0,0,0,58,99,29
99,34,58,0,0,0,0,58,99,34
99,35,0,0,58,0,0,58,99,35
99,36,262,0,0,0,0,262,99,36
99,37,0,0,70,0,0,70,99,37
99,39,78,0,0,0,0,78,99,39
99,41,0,0,53,0,0,53,99,41
99,43,0,0,98,0,0,98,99,43
99,44,34,0,0,0,0,34,99,44
99,46,0,0,193,0,0,193,99,46
99,50,38,0,0,0,0,38,99,50
99,51,0,0,161,0,0,161,99,51
99,52,0,0,37,0,0,37,99,52
99,57,58,0,96,0,0,154,99,57
99,64,95,0,0,0,0,95,99,64
99,66,96,0,0,0,0,96,99,66
99,70,58,0,0,0,0,58,99,70
99,71,0,0,118,0,0,118,99,71
99,73,147,0,0,0,0,147,99,73
99,76,38,0,0,0,0,38,99,76
99,77,0,0,374,0,0,374,99,77
99,79,58,0,0,0,0,58,99,79
99,80,96,0,0,214,0,310,99,80
99,82,58,0,0,0,0,58,99,82
99,83,0,0,0,41,0,41,99,83
99,84,204,0,0,0,0,204,99,84
99,85,345,0,165,0,0,510,99,85
99,87,96,0,0,33,0,129,99,87
99,88,276,0,107,0,0,383,99,88
99,89,224,0,0,0,0,224,99,89
99,90,51,0,0,0,0,51,99,90
99,91,338,73,0,23,0,434,99,91
99,93,205,0,428,0,0,633,99,93
99,94,53,62,61,0,0,176,99,94
99,97,35,0,0,0,0,35,99,97
99,98,68,0,132,0,0,200,99,98
99,99,531,3274,0,274,0,4079,99,99
99,100,387,456,281,246,333,1703,99,100
99,101,375,0,0,0,0,375,99,101
99,102,94,0,137,374,0,605,99,102
99,103,31,0,0,0,0,31,99,103
99,104,85,0,0,0,0,85,99,104
99,105,94,0,159,0,0,253,99,105
99,106,151,0,0,0,0,151,99,106
99,108,51,0,63,0,0,114,99,108
99,109,67,0,196,0,0,263,99,109
99,110,2754,0,520,0,0,3274,99,110
99,113,0,0,586,68,0,654,99,113
99,115,0,0,328,0,0,328,99,115
99,116,312,0,452,0,0,764,99,116
99,117,96,0,104,0,0,200,99,117
99,118,64,0,70,0,0,134,99,118
99,119,96,0,0,0,0,96,99,119
99,121,0,0,571,0,0,571,99,121
99,122,274,0,2617,0,0,2891,99,122
99,123,362,0,0,0,0,362,99,123
99,124,0,0,552,0,0,552,99,124
99,125,96,0,1031,532,0,1659,99,125
99,126,0,0,284,0,0,284,99,126
99,127,689,0,63,0,0,752,99,127
99,129,255,0,0,0,0,255,99,129
99,132,0,0,53,0,0,53,99,132
99,136,0,0,214,0,0,214,99,136
99,139,440,0,0,0,0,440,99,139
99,167,0,0,280,0,0,280,99,167
99,173,0,0,272,0,0,272,99,173
99,175,0,0,312,0,0,312,99,175
99,192,0,0,633,0,0,633,99,192
99,204,0,0,835,0,0,835,99,204
99,205,0,0,384,0,0,384,99,205
99,206,0,0,489,0,0,489,99,206
99,217,0,0,699,0,0,699,99,217
99,219,0,0,343,0,0,343,99,219
99,246,0,0,114,0,0,114,99,246
99,265,0,0,0,233,0,233,99,265
99,284,96,0,0,0,0,96,99,284
99,287,106,0,0,0,0,106,99,287
99,289,271,0,0,0,0,271,99,289
99,297,0,0,39,0,0,39,99,297
99,298,0,0,371,0,0,371,99,298
99,300,0,0,118,0,0,118,99,300
99,302,85,0,0,0,0,85,99,302
99,303,26,0,0,0,0,26,99,303
99,313,0,0,0,421,0,421,99,313
99,316,0,0,72,0,0,72,99,316
99,317,7,0,0,0,0,7,99,317
99,326,0,0,456,0,0,456,99,326
99,329,51,0,0,0,0,51,99,329
99,330,267,0,0,0,0,267,99,330
99,335,0,0,73,0,0,73,99,335
99,338,0,0,118,0,0,118,99,338
99,339,58,0,0,0,0,58,99,339
99,340,0,0,37,0,0,37,99,340
100,1,150,0,287,0,0,437,100,1
100,2,0,0,150,0,0,150,100,2
100,3,0,0,229,0,0,229,100,3
100,4,455,0,482,0,0,937,100,4
100,5,7,0,856,0,0,863,100,5
100,6,0,0,249,0,0,249,100,6
100,7,0,0,554,0,0,554,100,7
100,11,0,0,14,0,0,14,100,11
100,17,58,0,26,0,0,84,100,17
100,18,0,0,229,0,0,229,100,18
100,23,0,0,29,0,0,29,100,23
100,28,0,0,28,0,0,28,100,28
100,29,150,0,163,0,0,313,100,29
100,30,35,0,70,0,0,105,100,30
100,31,126,0,276,229,0,631,100,31
100,33,0,0,8,0,0,8,100,33
100,34,39,0,25,0,56,120,100,34
100,37,1837,0,166,0,0,2003,100,37
100,39,150,0,0,0,0,150,100,39
100,43,0,0,642,0,0,642,100,43
100,49,0,0,161,0,0,161,100,49
100,54,294,0,37,0,0,331,100,54
100,55,0,0,126,0,0,126,100,55
100,56,0,0,126,0,0,126,100,56
100,57,0,0,9,0,0,9,100,57
100,60,0,0,102,0,0,102,100,60
100,62,11,0,0,0,0,11,100,62
100,64,120,0,0,0,0,120,100,64
100,65,0,0,0,229,0,229,100,65
100,68,221,0,145,150,0,516,100,68
100,69,80,0,0,0,0,80,100,69
100,71,0,0,143,0,0,143,100,71
100,73,507,0,389,7,0,903,100,73
100,74,0,0,229,0,0,229,100,74
100,75,56,0,0,112,0,168,100,75
100,76,38,0,0,0,0,38,100,76
100,77,178,0,163,0,0,341,100,77
100,79,41,0,0,0,0,41,100,79
100,80,300,0,200,0,0,500,100,80
100,81,432,0,163,0,0,595,100,81
100,82,132,0,0,0,0,132,100,82
100,83,1693,0,23,215,0,1931,100,83
100,84,488,0,277,0,0,765,100,84
100,85,374,0,26,0,0,400,100,85
100,87,335,61,420,0,0,816,100,87
100,88,920,0,894,398,0,2212,100,88
100,89,216,418,183,512,0,1329,100,89
100,90,775,150,510,874,274,2583,100,90
100,91,31,19,68,17,0,135,100,91
100,92,10,0,8,0,0,18,100,92
100,93,229,0,625,0,0,854,100,93
100,94,378,190,347,638,0,1553,100,94
100,95,875,0,111,335,0,1321,100,95
100,96,177,0,0,0,0,177,100,96
100,97,373,0,252,0,0,625,100,97
100,98,706,113,142,175,77,1213,100,98
100,99,654,398,344,150,333,1879,100,99
100,100,2941,17185,610,0,0,20736,100,100
100,101,788,611,297,398,0,2094,100,101
100,102,1583,852,608,36,0,3079,100,102
100,103,203,155,98,16,0,472,100,103
100,104,489,0,104,49,333,975,100,104
100,105,648,0,140,0,0,788,100,105
100,106,182,0,75,109,0,366,100,106
100,107,257,0,643,286,0,1186,100,107
100,108,1016,0,216,96,0,1328,100,108
100,109,0,0,319,0,0,319,100,109
100,110,706,0,2613,0,0,3319,100,110
100,111,649,0,4291,583,0,5523,100,111
100,112,1154,0,835,0,0,1989,100,112
100,113,90,0,98,0,0,188,100,113
100,115,0,0,2446,0,0,2446,100,115
100,116,1638,0,5719,0,0,7357,100,116
100,117,0,0,718,0,0,718,100,117
100,118,87,0,802,0,0,889,100,118
100,119,0,0,1522,0,0,1522,100,119
100,122,477,0,1554,0,0,2031,100,122
100,123,0,0,3999,0,0,3999,100,123
100,124,3809,0,2355,0,0,6164,100,124
100,125,528,0,2084,528,0,3140,100,125
100,126,0,0,1956,0,0,1956,100,126
100,127,2084,0,1256,0,0,3340,100,127
100,128,0,0,10,0,0,10,100,128
100,133,0,0,0,7,0,7,100,133
100,135,0,0,185,0,0,185,100,135
100,137,7,0,0,0,0,7,100,137
100,138,0,0,71,0,0,71,100,138
100,139,561,0,433,0,0,994,100,139
100,140,0,0,340,0,0,340,100,140
100,141,0,0,1488,0,0,1488,100,141
100,145,31,0,34,0,0,65,100,145
100,153,73,0,0,0,0,73,100,153
100,163,92,0,0,0,0,92,100,163
100,167,0,0,740,0,0,740,100,167
100,168,229,0,0,0,0,229,100,168
100,180,0,0,325,0,0,325,100,180
100,187,0,0,273,0,0,273,100,187
100,194,0,0,148,0,0,148,100,194
100,209,0,0,466,0,0,466,100,209
100,210,1450,0,0,0,0,1450,100,210
100,218,0,0,862,0,0,862,100,218
100,227,0,0,1057,0,0,1057,100,227
100,229,0,0,668,0,0,668,100,229
100,236,0,0,224,0,0,224,100,236
100,237,0,0,166,0,0,166,100,237
100,242,0,0,368,0,0,368,100,242
100,249,114,0,0,0,0,114,100,249
100,251,200,0,0,0,0,200,100,251
100,260,0,0,499,0,0,499,100,260
100,266,180,0,0,0,0,180,100,266
100,272,136,0,0,0,0,136,100,272
100,277,0,0,282,0,0,282,100,277
100,280,0,0,185,0,0,185,100,280
100,288,0,0,228,0,0,228,100,288
100,293,0,0,0,657,0,657,100,293
100,296,0,0,19,0,0,19,100,296
100,299,104,0,0,0,0,104,100,299
100,303,0,0,38,0,0,38,100,303
100,309,0,0,153,0,0,153,100,309
100,315,0,0,0,185,0,185,100,315
100,316,0,0,0,53,0,53,100,316
100,319,209,0,0,0,0,209,100,319
100,321,0,0,236,0,0,236,100,321
100,322,77,0,0,364,0,441,100,322
100,323,0,0,539,0,0,539,100,323
100,324,0,0,202,0,0,202,100,324
100,325,0,0,248,0,0,248,100,325
100,328,197,0,0,0,0,197,100,328
100,329,102,0,0,0,0,102,100,329
100,331,227,0,0,0,0,227,100,331
100,332,0,0,1078,0,0,1078,100,332
100,334,502,0,0,0,0,502,100,334
100,335,0,0,757,0,0,757,100,335
100,336,0,0,708,0,0,708,100,336
100,337,132,0,621,0,0,753,100,337
100,338,810,0,563,0,0,1373,100,338
100,339,0,0,347,0,0,347,100,339
100,340,6,0,87,0,0,93,100,340
100,341,0,0,0,112,0,112,100,341
100,342,0,0,140,0,0,140,100,342
101,1,0,0,321,0,0,321,101,1
101,2,0,0,166,0,0,166,101,2
101,4,690,0,0,0,0,690,101,4
101,5,0,0,670,0,0,670,101,5
101,17,0,0,328,0,0,328,101,17
101,24,0,0,130,0,0,130,101,24
101,26,0,0,455,0,0,455,101,26
101,27,95,0,142,0,0,237,101,27
101,28,0,0,117,130,0,247,101,28
101,29,0,0,321,0,0,321,101,29
101,30,0,0,357,328,0,685,101,30
101,32,273,0,142,0,0,415,101,32
101,35,0,0,203,0,0,203,101,35
101,49,0,0,328,0,0,328,101,49
101,50,74,0,0,0,0,74,101,50
101,54,37,0,0,0,0,37,101,54
101,58,508,0,0,0,0,508,101,58
101,64,0,0,321,0,0,321,101,64
101,66,0,0,65,0,0,65,101,66
101,68,368,0,484,0,0,852,101,68
101,69,130,0,0,0,0,130,101,69
101,73,261,0,0,0,0,261,101,73
101,74,130,0,261,0,0,391,101,74
101,75,56,0,0,0,0,56,101,75
101,77,0,0,357,0,0,357,101,77
101,78,102,0,111,0,0,213,101,78
101,80,0,0,480,44,0,524,101,80
101,81,226,0,321,0,0,547,101,81
101,82,416,0,200,130,53,799,101,82
101,83,657,0,129,130,0,916,101,83
101,84,51,0,0,104,0,155,101,84
101,85,0,0,0,361,0,361,101,85
101,87,153,0,450,56,0,659,101,87
101,88,1901,261,611,0,0,2773,101,88
101,89,168,0,158,0,0,326,101,89
101,90,1984,234,0,328,0,2546,101,90
101,91,67,0,180,0,0,247,101,91
101,93,0,0,221,0,0,221,101,93
101,94,377,46,0,328,0,751,101,94
101,95,1575,897,111,430,0,3013,101,95
101,96,328,62,0,0,0,390,101,96
101,97,502,23,0,746,0,1271,101,97
101,98,7,0,0,9,0,16,101,98
101,99,191,0,0,0,0,191,101,99
101,100,832,434,739,296,0,2301,101,100
101,101,985,4905,0,0,0,5890,101,101
101,102,180,290,58,38,0,566,101,102
101,103,0,0,24,11,0,35,101,103
101,104,299,0,0,0,0,299,101,104
101,105,854,0,0,0,0,854,101,105
101,106,261,0,13,14,0,288,101,106
101,107,0,0,142,286,0,428,101,107
101,109,1410,0,0,0,0,1410,101,109
101,110,439,0,0,0,0,439,101,110
101,111,478,0,847,0,0,1325,101,111
101,113,283,0,0,107,0,390,101,113
101,115,130,0,160,0,0,290,101,115
101,116,0,0,1169,0,0,1169,101,116
101,167,0,0,295,0,0,295,101,167
101,187,0,0,222,0,0,222,101,187
101,247,130,0,0,0,0,130,101,247
101,252,0,0,0,62,0,62,101,252
101,254,0,0,220,0,0,220,101,254
101,255,0,0,166,0,0,166,101,255
101,294,0,0,667,0,0,667,101,294
101,300,0,0,404,0,0,404,101,300
101,316,0,0,0,87,0,87,101,316
101,317,0,0,83,0,0,83,101,317
101,324,0,0,521,0,0,521,101,324
101,329,0,0,55,0,0,55,101,329
101,338,0,0,356,87,0,443,101,338
101,339,296,0,321,0,0,617,101,339
101,340,13,0,0,0,0,13,101,340
102,1,0,0,109,0,0,109,102,1
102,5,0,0,251,49,0,300,102,5
102,8,49,0,0,0,0,49,102,8
102,14,36,0,0,0,0,36,102,14
102,27,36,0,236,0,0,272,102,27
102,28,179,0,0,0,0,179,102,28
102,29,21,0,0,0,0,21,102,29
102,30,0,0,61,0,0,61,102,30
102,31,146,0,220,49,0,415,102,31
102,33,0,128,0,0,0,128,102,33
102,34,0,0,42,0,0,42,102,34
102,35,0,0,69,0,0,69,102,35
102,37,114,0,0,0,0,114,102,37
102,43,0,0,114,0,0,114,102,43
102,48,0,0,0,114,0,114,102,48
102,49,0,0,54,0,0,54,102,49
102,54,0,0,97,0,0,97,102,54
102,55,0,0,128,0,0,128,102,55
102,56,0,0,83,0,0,83,102,56
102,59,0,0,49,0,0,49,102,59
102,60,49,0,0,0,0,49,102,60
102,61,56,0,0,0,0,56,102,61
102,62,49,0,0,0,0,49,102,62
102,65,0,49,0,0,0,49,102,65
102,68,239,0,60,0,0,299,102,68
102,69,56,0,0,0,0,56,102,69
102,70,85,0,0,0,0,85,102,70
102,73,0,0,93,0,0,93,102,73
102,75,56,0,0,0,0,56,102,75
102,76,115,0,0,0,0,115,102,76
102,77,0,0,53,0,0,53,102,77
102,78,0,0,72,0,0,72,102,78
102,79,114,0,84,85,0,283,102,79
102,80,136,0,0,0,0,136,102,80
102,81,285,0,0,0,0,285,102,81
102,82,114,0,201,49,0,364,102,82
102,83,49,0,0,302,0,351,102,83
102,84,349,0,0,51,0,400,102,84
102,86,123,0,0,0,0,123,102,86
102,87,33,0,0,47,0,80,102,87
102,88,847,0,42,0,0,889,102,88
102,89,114,0,0,48,0,162,102,89
102,91,106,0,0,0,0,106,102,91
102,93,177,0,53,0,0,230,102,93
102,94,0,0,213,0,0,213,102,94
102,95,172,0,0,0,0,172,102,95
102,96,502,0,53,87,0,642,102,96
102,97,795,611,25,111,0,1542,102,97
102,98,28,0,0,0,0,28,102,98
102,99,94,0,137,0,0,231,102,99
102,100,1530,885,444,154,0,3013,102,100
102,101,310,290,0,92,0,692,102,101
102,102,1794,1778,139,101,0,3812,102,102
102,103,331,81,1071,65,0,1548,102,103
102,104,137,40,0,92,0,269,102,104
102,105,753,312,54,291,0,1410,102,105
102,106,92,0,13,117,0,222,102,106
102,107,195,0,1235,99,0,1529,102,107
102,108,78,0,0,101,0,179,102,108
102,109,573,0,0,0,0,573,102,109
102,110,114,0,0,0,0,114,102,110
102,111,0,0,463,0,0,463,102,111
102,113,114,0,0,38,0,152,102,113
102,116,186,0,584,0,0,770,102,116
102,121,0,0,442,0,0,442,102,121
102,122,0,0,364,0,0,364,102,122
102,124,0,0,552,0,0,552,102,124
102,125,264,0,0,0,0,264,102,125
102,127,36,0,0,0,0,36,102,127
102,136,49,0,157,0,0,206,102,136
102,139,0,0,378,117,0,495,102,139
102,141,128,0,0,0,0,128,102,141
102,195,0,0,317,0,0,317,102,195
102,211,56,0,0,0,0,56,102,211
102,218,105,0,0,0,0,105,102,218
102,239,0,0,170,0,0,170,102,239
102,256,85,0,0,0,0,85,102,256
102,266,0,0,49,0,0,49,102,266
102,268,56,0,0,0,0,56,102,268
102,272,136,0,0,0,0,136,102,272
102,280,49,0,0,0,0,49,102,280
102,285,0,0,0,90,0,90,102,285
102,300,85,0,0,0,0,85,102,300
102,301,0,0,49,0,0,49,102,301
102,303,49,0,60,0,0,109,102,303
102,309,0,0,162,0,0,162,102,309
102,311,49,0,0,0,0,49,102,311
102,317,128,0,0,0,0,128,102,317
102,318,49,0,0,0,0,49,102,318
102,327,22,0,0,0,0,22,102,327
102,328,49,0,0,0,0,49,102,328
102,334,287,0,0,0,0,287,102,334
102,336,87,0,181,0,0,268,102,336
102,338,0,0,249,0,0,249,102,338
102,339,105,0,61,0,0,166,102,339
102,340,0,0,0,37,0,37,102,340
103,1,0,0,11,0,0,11,103,1
103,2,0,0,19,0,0,19,103,2
103,3,0,0,32,0,0,32,103,3
103,5,0,0,97,0,0,97,103,5
103,26,18,0,0,0,0,18,103,26
103,28,35,0,11,0,0,46,103,28
103,30,6,0,0,0,0,6,103,30
103,33,35,0,0,0,0,35,103,33
103,34,0,0,11,0,0,11,103,34
103,35,10,0,0,0,0,10,103,35
103,37,0,0,11,0,0,11,103,37
103,40,35,0,0,0,0,35,103,40
103,44,16,0,0,0,0,16,103,44
103,49,0,0,10,0,0,10,103,49
103,54,10,0,0,0,0,10,103,54
103,56,10,0,10,0,0,20,103,56
103,57,10,0,0,0,0,10,103,57
103,62,11,0,0,0,0,11,103,62
103,63,0,0,18,0,0,18,103,63
103,66,10,0,0,0,0,10,103,66
103,68,35,0,0,0,0,35,103,68
103,71,764,0,0,0,0,764,103,71
103,73,10,0,56,0,0,66,103,73
103,74,0,0,10,0,0,10,103,74
103,77,0,0,25,0,0,25,103,77
103,81,10,0,0,0,0,10,103,81
103,82,53,0,57,14,0,124,103,82
103,83,21,0,0,0,0,21,103,83
103,85,36,0,0,0,0,36,103,85
103,88,0,0,0,72,0,72,103,88
103,90,25,0,6,35,0,66,103,90
103,91,10,0,0,0,0,10,103,91
103,93,70,0,15,0,0,85,103,93
103,94,37,0,0,0,0,37,103,94
103,95,37,0,0,0,0,37,103,95
103,96,0,0,0,555,0,555,103,96
103,97,25,0,15,0,0,40,103,97
103,98,111,22,0,11,0,144,103,98
103,99,31,0,0,0,0,31,103,99
103,100,344,242,104,21,0,711,103,100
103,101,0,0,24,11,0,35,103,101
103,102,296,43,0,11,0,350,103,102
103,103,336,356,0,0,0,692,103,103
103,104,104,170,0,0,0,274,103,104
103,105,170,0,123,0,0,293,103,105
103,106,10,0,11,0,0,21,103,106
103,107,118,0,108,143,0,369,103,107
103,108,24,0,0,0,0,24,103,108
103,109,316,0,0,0,0,316,103,109
103,110,14,0,0,0,0,14,103,110
103,111,10,0,0,0,0,10,103,111
103,112,6,0,0,0,0,6,103,112
103,116,21,0,0,0,0,21,103,116
103,117,0,0,1071,0,0,1071,103,117
103,118,0,0,161,0,0,161,103,118
103,119,0,0,660,0,0,660,103,119
103,125,0,0,0,528,0,528,103,125
103,128,0,0,11,0,0,11,103,128
103,129,0,0,0,10,0,10,103,129
103,131,10,0,0,0,0,10,103,131
103,132,35,0,0,0,0,35,103,132
103,137,31,0,0,0,0,31,103,137
103,178,0,0,45,0,0,45,103,178
103,204,0,0,835,0,0,835,103,204
103,238,0,0,10,0,0,10,103,238
103,300,0,0,26,0,0,26,103,300
103,316,0,0,6,0,0,6,103,316
103,329,443,0,0,0,0,443,103,329
103,338,0,0,15,0,0,15,103,338
103,339,10,0,0,0,0,10,103,339
103,340,43,0,0,0,0,43,103,340
103,341,18,0,0,0,0,18,103,341
103,342,215,0,0,0,0,215,103,342
104,1,21,0,9,0,0,30,104,1
104,5,0,0,44,0,0,44,104,5
104,6,21,0,33,0,0,54,104,6
104,7,9,0,0,0,0,9,104,7
104,17,21,0,0,0,0,21,104,17
104,18,21,0,0,0,0,21,104,18
104,19,0,0,146,0,0,146,104,19
104,26,0,0,377,0,0,377,104,26
104,27,43,0,9,0,0,52,104,27
104,29,21,0,73,0,0,94,104,29
104,31,21,0,100,0,0,121,104,31
104,32,21,0,0,0,0,21,104,32
104,34,21,0,0,0,0,21,104,34
104,35,0,0,27,0,0,27,104,35
104,36,9,0,0,0,0,9,104,36
104,37,0,0,117,0,0,117,104,37
104,41,9,0,0,0,0,9,104,41
104,49,0,0,27,0,0,27,104,49
104,53,21,0,0,0,0,21,104,53
104,55,21,0,0,0,0,21,104,55
104,56,27,0,47,0,0,74,104,56
104,58,0,0,21,0,0,21,104,58
104,59,0,0,21,0,0,21,104,59
104,63,21,0,0,0,0,21,104,63
104,64,0,0,23,0,0,23,104,64
104,66,21,0,0,0,0,21,104,66
104,67,21,0,0,0,0,21,104,67
104,68,42,0,0,138,0,180,104,68
104,69,0,0,22,0,0,22,104,69
104,70,21,0,0,0,0,21,104,70
104,71,21,0,0,0,0,21,104,71
104,72,21,0,0,0,0,21,104,72
104,73,21,0,0,0,0,21,104,73
104,76,237,0,51,0,0,288,104,76
104,77,0,0,9,21,0,30,104,77
104,78,0,0,45,0,0,45,104,78
104,79,21,0,22,43,0,86,104,79
104,80,21,0,0,0,0,21,104,80
104,81,43,0,23,0,0,66,104,81
104,82,130,0,0,0,0,130,104,82
104,83,43,0,0,0,0,43,104,83
104,84,42,0,22,0,0,64,104,84
104,87,0,0,123,56,0,179,104,87
104,88,205,0,0,0,0,205,104,88
104,89,0,0,104,0,0,104,104,89
104,90,43,0,0,30,0,73,104,90
104,91,39,0,0,0,0,39,104,91
104,93,21,0,0,0,0,21,104,93
104,94,9,0,23,0,0,32,104,94
104,95,231,0,0,0,0,231,104,95
104,96,286,0,0,0,0,286,104,96
104,97,237,21,60,0,0,318,104,97
104,99,85,0,0,0,0,85,104,99
104,100,121,0,0,49,333,503,104,100
104,101,369,0,13,25,0,407,104,101
104,102,171,40,0,92,0,303,104,102
104,103,214,198,0,68,0,480,104,103
104,104,1077,915,0,0,0,1992,104,104
104,105,466,27,87,0,0,580,104,105
104,106,39,98,65,68,62,332,104,106
104,107,1250,673,0,118,77,2118,104,107
104,108,126,161,0,21,0,308,104,108
104,109,76,0,0,0,0,76,104,109
104,110,43,0,0,0,0,43,104,110
104,113,95,21,0,0,0,116,104,113
104,115,42,0,569,0,0,611,104,115
104,125,0,0,457,0,0,457,104,125
104,127,21,0,1415,0,0,1436,104,127
104,132,9,0,0,0,0,9,104,132
104,135,21,0,0,0,0,21,104,135
104,136,9,0,0,0,0,9,104,136
104,139,0,0,93,0,0,93,104,139
104,167,95,0,0,0,0,95,104,167
104,170,21,0,0,0,0,21,104,170
104,271,0,0,0,43,0,43,104,271
104,284,21,0,0,0,0,21,104,284
104,299,9,0,0,0,0,9,104,299
104,300,21,0,26,0,0,47,104,300
104,302,9,0,0,0,0,9,104,302
104,305,0,0,621,0,0,621,104,305
104,316,18,0,0,0,0,18,104,316
104,317,9,0,0,0,0,9,104,317
104,318,0,0,26,0,0,26,104,318
104,320,21,0,0,0,0,21,104,320
104,326,9,0,0,0,0,9,104,326
104,328,21,0,0,0,0,21,104,328
104,335,0,0,412,0,0,412,104,335
104,339,21,0,29,0,0,50,104,339
105,1,150,0,184,0,0,334,105,1
105,2,0,0,320,0,0,320,105,2
105,5,128,0,0,0,0,128,105,5
105,6,222,0,0,0,0,222,105,6
105,7,0,0,129,0,0,129,105,7
105,24,0,0,107,50,0,157,105,24
105,27,50,0,0,0,0,50,105,27
105,29,50,0,0,0,0,50,105,29
105,30,0,0,70,0,0,70,105,30
105,34,39,0,0,0,0,39,105,34
105,35,0,0,242,0,0,242,105,35
105,36,0,0,0,50,0,50,105,36
105,41,50,0,0,0,0,50,105,41
105,46,50,0,0,0,0,50,105,46
105,54,50,0,0,0,0,50,105,54
105,59,0,0,440,0,0,440,105,59
105,60,50,0,0,0,0,50,105,60
105,61,50,0,0,0,0,50,105,61
105,62,0,0,85,0,0,85,105,62
105,68,50,0,0,0,0,50,105,68
105,69,50,0,0,0,0,50,105,69
105,70,50,0,0,0,0,50,105,70
105,73,50,0,0,78,0,128,105,73
105,74,0,0,192,0,0,192,105,74
105,75,56,0,0,0,0,56,105,75
105,76,140,0,0,0,0,140,105,76
105,77,50,0,109,0,0,159,105,77
105,79,50,0,44,0,0,94,105,79
105,81,249,0,0,0,0,249,105,81
105,82,609,0,0,50,0,659,105,82
105,83,195,0,373,0,0,568,105,83
105,84,50,0,109,0,0,159,105,84
105,85,0,0,378,0,0,378,105,85
105,87,365,0,245,33,0,643,105,87
105,88,294,0,0,0,0,294,105,88
105,89,276,0,23,28,0,327,105,89
105,90,100,0,0,411,0,511,105,90
105,91,10,0,0,0,0,10,105,91
105,92,50,0,0,0,0,50,105,92
105,93,128,0,54,0,0,182,105,93
105,94,204,0,380,271,0,855,105,94
105,95,581,0,616,0,0,1197,105,95
105,96,412,0,0,80,0,492,105,96
105,97,1203,0,184,0,0,1387,105,97
105,98,216,0,58,0,0,274,105,98
105,99,94,0,0,0,0,94,105,99
105,100,706,0,140,0,0,846,105,100
105,101,854,0,0,0,0,854,105,101
105,102,704,312,54,241,0,1311,105,102
105,103,148,0,123,0,0,271,105,103
105,104,457,91,87,0,0,635,105,104
105,105,906,3396,367,1640,0,6309,105,105
105,106,99,1060,0,33,0,1192,105,106
105,107,3351,2408,64,160,0,5983,105,107
105,108,96,62,0,0,0,158,105,108
105,109,0,0,1347,0,0,1347,105,109
105,111,50,0,0,0,0,50,105,111
105,113,0,0,427,0,0,427,105,113
105,117,0,0,954,0,0,954,105,117
105,119,0,0,1063,0,0,1063,105,119
105,138,50,0,0,0,0,50,105,138
105,144,50,0,0,0,0,50,105,144
105,154,0,0,50,0,0,50,105,154
105,156,49,0,0,0,0,49,105,156
105,157,154,0,0,0,0,154,105,157
105,163,0,0,299,0,0,299,105,163
105,170,50,0,0,0,0,50,105,170
105,172,495,0,0,0,0,495,105,172
105,274,50,0,0,0,0,50,105,274
105,278,0,0,265,0,0,265,105,278
105,291,785,0,0,0,0,785,105,291
105,300,322,0,0,0,0,322,105,300
105,305,0,0,406,0,0,406,105,305
105,316,257,0,0,0,0,257,105,316
105,317,119,0,0,0,0,119,105,317
105,321,161,0,0,0,0,161,105,321
105,328,0,0,215,0,0,215,105,328
105,334,0,0,394,0,0,394,105,334
105,335,715,0,305,0,0,1020,105,335
105,336,0,0,324,0,0,324,105,336
105,337,0,0,953,0,0,953,105,337
105,338,1103,0,344,0,0,1447,105,338
105,339,37,0,202,0,0,239,105,339
105,340,0,0,68,37,0,105,105,340
105,342,167,0,0,0,0,167,105,342
106,1,0,0,0,60,0,60,106,1
106,2,0,0,60,0,0,60,106,2
106,7,0,0,0,16,0,16,106,7
106,22,0,0,88,0,0,88,106,22
106,24,288,0,166,0,0,454,106,24
106,30,47,0,0,0,0,47,106,30
106,31,349,0,28,0,0,377,106,31
106,32,43,0,56,0,0,99,106,32
106,34,0,0,18,0,0,18,106,34
106,35,0,0,65,0,0,65,106,35
106,36,131,0,51,0,0,182,106,36
106,37,0,0,0,0,50,50,106,37
106,43,0,0,35,0,0,35,106,43
106,44,0,0,56,0,0,56,106,44
106,53,0,0,219,0,0,219,106,53
106,61,93,0,0,0,0,93,106,61
106,64,240,0,0,0,0,240,106,64
106,66,101,0,0,0,0,101,106,66
106,68,243,0,0,0,0,243,106,68
106,72,0,288,0,0,0,288,106,72
106,73,60,93,0,0,0,153,106,73
106,74,0,0,54,0,0,54,106,74
106,75,61,0,0,0,0,61,106,75
106,77,0,0,91,0,0,91,106,77
106,79,0,0,41,0,0,41,106,79
106,83,80,0,0,0,0,80,106,83
106,84,51,0,0,0,0,51,106,84
106,85,24,0,0,0,0,24,106,85
106,87,0,0,59,0,0,59,106,87
106,96,71,0,0,0,87,158,106,96
106,97,42,0,0,35,0,77,106,97
106,99,151,0,0,0,0,151,106,99
106,100,133,0,75,0,0,208,106,100
106,101,261,0,0,0,0,261,106,101
106,102,141,0,13,117,0,271,106,102
106,103,0,0,11,0,0,11,106,103
106,104,18,98,79,68,62,325,106,104
106,105,99,1060,0,33,0,1192,106,105
106,106,422,2253,0,169,524,3368,106,106
106,107,0,121,38,25,0,184,106,107
106,108,0,138,0,53,0,191,106,108
106,112,284,0,0,0,0,284,106,112
106,113,0,0,311,269,0,580,106,113
106,126,261,0,268,0,0,529,106,126
106,127,166,0,0,0,0,166,106,127
106,141,0,0,578,0,0,578,106,141
106,153,193,0,0,0,0,193,106,153
106,158,1036,0,0,0,0,1036,106,158
106,168,0,0,98,0,0,98,106,168
106,170,0,0,143,0,0,143,106,170
106,175,0,0,0,545,0,545,106,175
106,202,0,0,766,0,0,766,106,202
106,205,0,0,2185,0,0,2185,106,205
106,237,0,0,26,0,0,26,106,237
106,239,110,0,0,0,0,110,106,239
106,241,120,0,0,0,0,120,106,241
106,262,0,0,360,0,0,360,106,262
106,280,330,0,0,0,0,330,106,280
106,281,0,0,196,0,0,196,106,281
106,287,211,0,0,0,0,211,106,287
106,289,0,0,61,0,0,61,106,289
106,300,255,0,151,0,0,406,106,300
106,305,43,0,0,202,0,245,106,305
106,307,0,0,341,0,0,341,106,307
106,311,0,0,0,84,0,84,106,311
106,312,155,0,176,0,0,331,106,312
106,315,0,0,185,0,0,185,106,315
106,316,72,0,0,0,0,72,106,316
106,318,158,0,0,0,0,158,106,318
106,319,0,0,0,17,0,17,106,319
106,332,237,0,38,0,0,275,106,332
106,334,0,0,312,0,24,336,106,334
106,336,179,0,435,0,0,614,106,336
106,337,181,0,0,0,0,181,106,337
106,338,0,35,507,33,301,876,106,338
106,341,0,0,15,0,0,15,106,341
107,1,0,0,216,0,0,216,107,1
107,2,0,0,99,0,0,99,107,2
107,5,0,0,128,0,0,128,107,5
107,7,99,0,0,0,0,99,107,7
107,8,0,0,102,0,0,102,107,8
107,16,0,0,129,0,0,129,107,16
107,27,99,0,0,0,0,99,107,27
107,29,198,0,0,0,0,198,107,29
107,30,198,0,0,0,0,198,107,30
107,31,302,0,0,0,0,302,107,31
107,32,99,0,108,0,0,207,107,32
107,34,118,0,128,0,0,246,107,34
107,41,198,0,0,0,0,198,107,41
107,52,0,0,330,0,0,330,107,52
107,53,0,0,58,0,0,58,107,53
107,56,0,0,99,0,0,99,107,56
107,57,158,0,392,0,0,550,107,57
107,62,26,0,0,0,0,26,107,62
107,64,99,0,0,0,0,99,107,64
107,66,35,0,0,0,0,35,107,66
107,67,0,0,0,99,0,99,107,67
107,68,342,0,0,0,0,342,107,68
107,69,118,0,0,0,0,118,107,69
107,71,99,0,0,0,0,99,107,71
107,73,198,0,108,0,0,306,107,73
107,76,77,0,0,0,0,77,107,76
107,77,60,0,0,0,0,60,107,77
107,78,0,0,0,118,0,118,107,78
107,79,254,0,0,99,0,353,107,79
107,81,99,0,0,99,0,198,107,81
107,82,1241,0,0,0,0,1241,107,82
107,83,0,0,118,0,0,118,107,83
107,84,99,0,63,0,0,162,107,84
107,88,872,0,153,435,0,1460,107,88
107,91,0,0,31,0,0,31,107,91
107,93,302,0,108,0,0,410,107,93
107,94,198,0,0,0,0,198,107,94
107,95,108,0,0,150,0,258,107,95
107,96,280,0,108,0,0,388,107,96
107,97,537,81,0,40,0,658,107,97
107,98,0,0,8,0,0,8,107,98
107,100,353,0,747,286,0,1386,107,100
107,101,0,0,142,286,0,428,107,101
107,102,195,0,172,0,0,367,107,102
107,103,118,0,108,143,0,369,107,103
107,104,1112,556,0,118,77,1863,107,104
107,105,2557,2400,64,160,0,5181,107,105
107,106,0,121,38,25,0,184,107,106
107,107,58,2526,216,906,0,3706,107,107
107,108,133,384,163,0,0,680,107,108
107,109,3708,0,433,0,0,4141,107,109
107,112,0,0,182,0,0,182,107,112
107,113,303,0,329,0,0,632,107,113
107,116,0,0,944,0,0,944,107,116
107,117,1542,0,0,0,0,1542,107,117
107,119,0,0,1203,0,0,1203,107,119
107,123,0,0,0,649,0,649,107,123
107,125,203,0,0,0,0,203,107,125
107,127,464,0,0,0,0,464,107,127
107,130,198,0,0,0,0,198,107,130
107,132,197,0,0,0,0,197,107,132
107,176,0,0,453,0,0,453,107,176
107,206,486,0,0,0,0,486,107,206
107,208,0,0,142,0,0,142,107,208
107,210,20,0,0,0,0,20,107,210
107,213,0,0,396,0,0,396,107,213
107,226,0,0,641,0,0,641,107,226
107,240,401,0,0,0,0,401,107,240
107,254,0,0,0,248,0,248,107,254
107,255,99,0,0,0,0,99,107,255
107,270,198,0,0,0,0,198,107,270
107,300,37,0,0,0,0,37,107,300
107,307,0,0,367,0,0,367,107,307
107,316,0,0,95,94,0,189,107,316
107,317,99,0,0,0,0,99,107,317
107,320,0,0,299,0,0,299,107,320
107,321,111,0,0,0,0,111,107,321
107,327,0,0,0,49,0,49,107,327
107,335,46,0,0,0,97,143,107,335
107,336,0,0,511,0,0,511,107,336
107,337,1119,0,0,0,0,1119,107,337
107,338,555,0,773,218,0,1546,107,338
107,339,262,0,128,0,0,390,107,339
107,340,198,0,0,0,0,198,107,340
108,1,0,0,14,0,0,14,108,1
108,4,0,0,129,0,0,129,108,4
108,8,21,0,0,0,0,21,108,8
108,11,22,0,0,0,0,22,108,11
108,21,0,0,83,0,0,83,108,21
108,22,0,0,0,300,0,300,108,22
108,28,0,0,23,0,0,23,108,28
108,29,237,0,0,0,0,237,108,29
108,32,0,0,25,0,0,25,108,32
108,37,53,0,0,0,0,53,108,37
108,45,240,0,0,0,0,240,108,45
108,49,74,0,0,0,0,74,108,49
108,50,74,0,0,0,0,74,108,50
108,57,0,0,56,0,0,56,108,57
108,61,190,0,0,0,0,190,108,61
108,65,224,0,0,0,0,224,108,65
108,66,145,0,0,0,0,145,108,66
108,74,0,0,0,23,0,23,108,74
108,78,102,0,0,0,0,102,108,78
108,79,0,0,35,51,0,86,108,79
108,80,39,0,0,0,0,39,108,80
108,82,62,0,86,0,0,148,108,82
108,83,37,0,0,0,0,37,108,83
108,90,123,0,0,0,0,123,108,90
108,91,322,0,0,0,0,322,108,91
108,93,0,0,25,0,0,25,108,93
108,94,218,0,0,0,0,218,108,94
108,95,102,0,0,0,0,102,108,95
108,96,99,0,0,0,0,99,108,96
108,97,58,0,0,0,0,58,108,97
108,99,155,0,63,96,0,314,108,99
108,100,0,0,224,0,0,224,108,100
108,101,0,0,0,14,0,14,108,101
108,102,78,0,0,101,0,179,108,102
108,103,24,0,0,0,0,24,108,103
108,104,82,183,0,0,0,265,108,104
108,105,96,62,56,0,0,214,108,105
108,106,0,138,0,39,0,177,108,106
108,107,184,384,108,0,0,676,108,107
108,108,102,1070,69,187,71,1499,108,108
108,109,0,0,16,0,0,16,108,109
108,111,923,0,0,0,0,923,108,111
108,112,0,0,26,0,0,26,108,112
108,113,316,0,297,211,0,824,108,113
108,115,130,0,0,0,0,130,108,115
108,116,976,0,0,300,0,1276,108,116
108,118,350,0,98,0,0,448,108,118
108,132,102,0,0,0,0,102,108,132
108,137,0,0,363,0,0,363,108,137
108,145,37,0,0,0,0,37,108,145
108,156,0,0,338,0,0,338,108,156
108,170,0,0,143,0,0,143,108,170
108,193,0,0,23,0,0,23,108,193
108,202,0,0,928,0,0,928,108,202
108,212,70,0,0,0,0,70,108,212
108,214,391,0,0,0,0,391,108,214
108,238,135,0,0,0,0,135,108,238
108,240,0,0,51,0,0,51,108,240
108,273,0,0,27,0,0,27,108,273
108,275,0,0,274,0,0,274,108,275
108,296,119,0,0,0,0,119,108,296
108,298,0,0,1315,0,0,1315,108,298
108,300,511,0,0,0,0,511,108,300
108,302,143,0,0,0,0,143,108,302
108,303,26,0,0,0,0,26,108,303
108,312,0,0,0,23,0,23,108,312
108,316,32,0,0,0,0,32,108,316
108,318,128,0,0,0,0,128,108,318
108,319,68,0,0,0,0,68,108,319
108,323,306,0,0,0,0,306,108,323
108,325,409,0,0,0,0,409,108,325
108,328,0,0,215,0,0,215,108,328
108,331,107,0,0,0,0,107,108,331
108,333,0,0,97,0,0,97,108,333
108,335,46,0,0,0,0,46,108,335
108,337,0,0,161,0,0,161,108,337
109,1,0,0,1418,0,0,1418,109,1
109,2,0,0,985,0,0,985,109,2
109,4,0,0,214,0,0,214,109,4
109,5,0,0,968,0,0,968,109,5
109,11,158,0,0,0,0,158,109,11
109,23,0,0,2193,0,0,2193,109,23
109,26,0,0,346,0,0,346,109,26
109,31,0,0,2423,0,0,2423,109,31
109,32,0,0,1962,0,0,1962,109,32
109,35,0,0,527,0,0,527,109,35
109,38,35,0,0,0,0,35,109,38
109,42,0,0,59,0,0,59,109,42
109,52,0,0,123,0,0,123,109,52
109,53,0,0,180,0,0,180,109,53
109,59,0,0,818,0,0,818,109,59
109,60,0,0,306,0,0,306,109,60
109,63,0,0,158,0,0,158,109,63
109,64,120,0,0,0,0,120,109,64
109,74,0,0,725,0,0,725,109,74
109,76,158,0,0,0,0,158,109,76
109,77,0,0,1072,0,0,1072,109,77
109,79,0,0,1143,0,0,1143,109,79
109,83,3708,0,0,0,0,3708,109,83
109,85,0,0,1347,0,0,1347,109,85
109,87,33,0,0,0,0,33,109,87
109,88,276,0,0,0,0,276,109,88
109,90,189,0,0,0,0,189,109,90
109,91,0,0,825,0,0,825,109,91
109,93,613,0,2984,0,0,3597,109,93
109,94,316,0,389,0,0,705,109,94
109,96,67,0,0,0,0,67,109,96
109,97,35,0,0,0,0,35,109,97
109,98,0,0,2567,0,0,2567,109,98
109,99,67,0,196,0,0,263,109,99
109,100,0,0,319,0,0,319,109,100
109,101,1410,0,0,0,0,1410,109,101
109,102,199,0,0,0,0,199,109,102
109,103,316,0,0,0,0,316,109,103
109,104,76,0,0,0,0,76,109,104
109,105,0,0,1347,0,0,1347,109,105
109,107,376,0,196,0,0,572,109,107
109,109,3849,42524,10673,10946,0,67992,109,109
109,110,4710,2437,2524,1104,0,10775,109,110
109,111,2792,2059,1917,218,1129,8115,109,111
109,112,1250,215,2397,970,0,4832,109,112
109,113,269,0,0,0,0,269,109,113
109,115,427,0,2110,0,0,2537,109,115
109,116,3246,0,3173,4038,0,10457,109,116
109,117,1246,0,0,0,0,1246,109,117
109,118,517,0,95,0,0,612,109,118
109,119,292,0,1082,0,0,1374,109,119
109,121,0,0,725,0,0,725,109,121
109,122,678,2422,0,0,0,3100,109,122
109,123,0,0,1162,0,0,1162,109,123
109,124,823,0,895,0,0,1718,109,124
109,125,1361,0,845,423,0,2629,109,125
109,126,158,0,0,0,0,158,109,126
109,127,1296,0,946,1217,0,3459,109,127
109,129,389,0,0,0,0,389,109,129
109,133,367,0,0,0,0,367,109,133
109,137,0,0,141,0,0,141,109,137
109,138,0,0,48,0,0,48,109,138
109,139,882,0,0,0,0,882,109,139
109,141,0,0,1347,0,0,1347,109,141
109,144,374,0,0,0,0,374,109,144
109,160,0,0,725,0,0,725,109,160
109,161,0,0,671,0,0,671,109,161
109,165,646,0,1238,0,0,1884,109,165
109,172,0,0,258,0,0,258,109,172
109,203,0,0,0,429,0,429,109,203
109,208,167,0,0,0,0,167,109,208
109,216,336,0,0,0,0,336,109,216
109,225,0,0,165,0,0,165,109,225
109,227,0,0,674,0,0,674,109,227
109,229,0,0,1347,0,0,1347,109,229
109,239,120,0,968,0,0,1088,109,239
109,240,0,0,1072,0,0,1072,109,240
109,264,518,0,0,0,0,518,109,264
109,284,158,0,0,0,0,158,109,284
109,316,0,0,221,0,0,221,109,316
109,332,158,0,0,0,0,158,109,332
109,334,1238,0,0,0,0,1238,109,334
109,338,0,0,1533,0,0,1533,109,338
109,339,0,0,416,0,0,416,109,339
110,1,877,0,693,0,0,1570,110,1
110,2,0,0,439,0,0,439,110,2
110,5,267,0,0,0,0,267,110,5
110,6,0,0,422,0,0,422,110,6
110,12,0,0,347,0,0,347,110,12
110,19,0,0,329,0,0,329,110,19
110,26,144,0,0,0,0,144,110,26
110,29,0,0,804,0,0,804,110,29
110,31,0,0,274,0,0,274,110,31
110,32,21,0,301,0,0,322,110,32
110,35,0,0,439,0,0,439,110,35
110,43,0,0,683,0,0,683,110,43
110,53,379,0,267,0,0,646,110,53
110,62,0,0,437,0,0,437,110,62
110,63,0,0,454,0,0,454,110,63
110,74,0,0,267,0,0,267,110,74
110,75,0,0,35,0,0,35,110,75
110,79,0,0,453,0,0,453,110,79
110,81,439,0,0,0,0,439,110,81
110,82,877,0,0,0,0,877,110,82
110,85,24,0,0,0,0,24,110,85
110,87,0,0,477,439,0,916,110,87
110,88,25,0,0,0,0,25,110,88
110,90,0,0,0,189,0,189,110,90
110,91,267,0,422,0,0,689,110,91
110,93,0,0,2391,0,0,2391,110,93
110,98,0,0,477,0,0,477,110,98
110,99,2487,0,520,0,0,3007,110,99
110,100,1464,0,2749,0,0,4213,110,100
110,101,439,0,0,0,0,439,110,101
110,102,114,0,0,0,0,114,110,102
110,103,14,0,0,0,0,14,110,103
110,104,43,0,0,0,0,43,110,104
110,109,4710,2437,2720,1104,0,10971,110,109
110,110,3019,21484,2537,2093,0,29133,110,110
110,111,864,0,0,0,0,864,110,111
110,112,0,0,954,0,0,954,110,112
110,113,269,0,0,0,0,269,110,113
110,115,0,0,1665,0,0,1665,110,115
110,116,537,0,1169,236,0,1942,110,116
110,118,0,0,202,0,0,202,110,118
110,119,0,0,454,0,0,454,110,119
110,121,0,0,442,0,0,442,110,121
110,122,477,0,397,0,0,874,110,122
110,125,0,0,457,0,0,457,110,125
110,126,1748,0,143,0,0,1891,110,126
110,127,797,439,540,0,0,1776,110,127
110,128,10,0,0,0,0,10,110,128
110,129,439,0,0,0,0,439,110,129
110,133,0,0,454,0,0,454,110,133
110,136,0,267,0,0,0,267,110,136
110,137,244,0,0,0,0,244,110,137
110,138,1076,0,0,44,0,1120,110,138
110,139,262,0,113,0,0,375,110,139
110,144,439,0,477,0,0,916,110,144
110,145,33,0,0,0,0,33,110,145
110,164,55,0,0,0,0,55,110,164
110,167,0,0,439,0,0,439,110,167
110,187,0,0,0,222,0,222,110,187
110,208,267,0,0,0,0,267,110,208
110,225,0,0,245,0,0,245,110,225
110,230,0,0,377,0,0,377,110,230
110,274,0,0,439,0,0,439,110,274
110,278,0,0,401,0,0,401,110,278
110,300,0,0,540,0,0,540,110,300
110,306,0,0,301,0,0,301,110,306
110,307,0,0,325,0,0,325,110,307
110,326,0,0,0,419,0,419,110,326
111,7,239,0,0,0,0,239,111,7
111,24,0,0,1410,0,0,1410,111,24
111,25,336,0,0,0,0,336,111,25
111,27,0,0,213,0,0,213,111,27
111,29,0,0,365,0,0,365,111,29
111,31,245,0,0,0,0,245,111,31
111,32,0,0,463,0,0,463,111,32
111,33,0,0,0,32,0,32,111,33
111,36,0,0,680,0,0,680,111,36
111,43,0,0,239,0,0,239,111,43
111,52,128,0,0,0,0,128,111,52
111,65,213,0,0,0,0,213,111,65
111,68,336,0,0,0,0,336,111,68
111,69,0,0,84,0,0,84,111,69
111,76,0,0,329,0,0,329,111,76
111,81,128,0,0,0,0,128,111,81
111,82,425,0,0,0,0,425,111,82
111,86,18,0,0,0,0,18,111,86
111,87,0,0,0,117,0,117,111,87
111,89,0,0,625,0,0,625,111,89
111,91,0,0,365,660,0,1025,111,91
111,94,0,0,1142,0,0,1142,111,94
111,98,0,0,123,0,0,123,111,98
111,100,482,0,4031,583,0,5096,111,100
111,101,478,0,847,0,0,1325,111,101
111,102,0,0,463,0,0,463,111,102
111,103,10,0,0,0,0,10,111,103
111,104,21,0,0,0,0,21,111,104
111,105,50,0,0,0,0,50,111,105
111,108,923,0,16,0,0,939,111,108
111,109,2792,2059,695,218,1129,6893,111,109
111,110,864,0,196,0,0,1060,111,110
111,111,8979,21311,1084,4995,974,37343,111,111
111,112,724,1992,657,390,0,3763,111,112
111,113,186,2422,1834,0,0,4442,111,113
111,115,336,0,0,0,0,336,111,115
111,116,312,0,159,292,0,763,111,116
111,117,109,0,0,0,0,109,111,117
111,118,296,0,108,0,0,404,111,118
111,119,0,0,484,0,0,484,111,119
111,124,507,0,0,0,0,507,111,124
111,127,0,0,549,0,0,549,111,127
111,134,575,0,0,0,0,575,111,134
111,135,425,0,0,0,0,425,111,135
111,136,965,0,0,0,0,965,111,136
111,141,239,0,0,0,0,239,111,141
111,144,478,0,0,0,0,478,111,144
111,154,0,0,660,0,0,660,111,154
111,180,0,0,686,0,0,686,111,180
111,186,0,0,232,0,0,232,111,186
111,258,196,0,0,0,0,196,111,258
111,273,109,0,0,0,0,109,111,273
111,294,336,0,0,0,0,336,111,294
111,300,0,0,0,336,0,336,111,300
111,327,254,0,0,0,0,254,111,327
111,334,851,0,0,0,0,851,111,334
111,338,377,0,0,0,0,377,111,338
112,1,0,0,37,0,0,37,112,1
112,4,0,0,182,0,0,182,112,4
112,8,0,45,0,0,0,45,112,8
112,14,0,0,206,0,0,206,112,14
112,34,0,0,312,0,0,312,112,34
112,37,287,0,0,0,0,287,112,37
112,40,18,0,0,0,0,18,112,40
112,57,0,0,434,0,0,434,112,57
112,73,0,0,350,0,0,350,112,73
112,74,0,0,434,0,0,434,112,74
112,90,0,0,667,0,0,667,112,90
112,92,0,0,182,0,0,182,112,92
112,93,0,0,487,0,0,487,112,93
112,94,167,0,0,0,0,167,112,94
112,95,0,0,312,0,0,312,112,95
112,97,453,0,0,0,0,453,112,97
112,98,0,0,219,0,0,219,112,98
112,100,1154,0,1154,0,0,2308,112,100
112,103,6,0,0,0,0,6,112,103
112,105,90,0,182,0,0,272,112,105
112,106,284,0,0,0,0,284,112,106
112,107,0,0,182,0,0,182,112,107
112,108,62,0,26,0,0,88,112,108
112,109,1417,167,2668,970,0,5222,112,109
112,110,0,0,954,0,0,954,112,110
112,111,557,2417,657,390,0,4021,112,111
112,112,1442,20690,3651,1820,0,27603,112,112
112,113,0,857,409,303,0,1569,112,113
112,115,647,469,0,0,0,1116,112,115
112,117,671,0,0,0,0,671,112,117
112,119,0,0,859,0,0,859,112,119
112,127,0,0,0,201,0,201,112,127
112,133,0,0,287,0,0,287,112,133
112,139,0,0,305,0,0,305,112,139
112,148,241,0,0,0,0,241,112,148
112,163,0,0,287,0,0,287,112,163
112,221,0,0,434,0,0,434,112,221
112,254,0,0,167,0,0,167,112,254
113,1,0,0,67,0,0,67,113,1
113,8,0,0,0,84,0,84,113,8
113,9,0,0,236,0,0,236,113,9
113,15,0,0,62,28,0,90,113,15
113,19,284,0,0,0,0,284,113,19
113,27,572,0,0,0,0,572,113,27
113,28,90,0,115,0,0,205,113,28
113,29,0,0,293,0,0,293,113,29
113,31,0,0,879,0,0,879,113,31
113,32,15,0,0,0,0,15,113,32
113,35,33,0,0,0,0,33,113,35
113,36,0,0,329,0,0,329,113,36
113,45,0,0,90,0,0,90,113,45
113,49,0,0,577,0,0,577,113,49
113,60,0,0,372,0,0,372,113,60
113,62,0,0,0,90,0,90,113,62
113,69,0,0,293,0,0,293,113,69
113,77,269,0,300,0,0,569,113,77
113,79,90,0,293,0,0,383,113,79
113,81,269,0,90,0,0,359,113,81
113,83,35,0,0,0,0,35,113,83
113,85,0,0,229,0,0,229,113,85
113,87,64,0,329,0,0,393,113,87
113,88,193,0,0,0,0,193,113,88
113,89,0,0,557,0,0,557,113,89
113,90,0,0,98,0,0,98,113,90
113,91,269,0,265,0,0,534,113,91
113,94,0,0,511,0,0,511,113,94
113,95,90,0,0,0,0,90,113,95
113,96,269,0,0,0,0,269,113,96
113,97,0,0,426,0,0,426,113,97
113,98,188,322,58,201,0,769,113,98
113,99,0,0,586,68,0,654,113,99
113,100,151,0,697,0,0,848,113,100
113,101,0,0,0,107,0,107,113,101
113,102,114,0,0,38,0,152,113,102
113,104,95,21,0,0,0,116,113,104
113,105,0,0,427,0,0,427,113,105
113,106,539,0,311,0,0,850,113,106
113,107,303,0,0,303,0,606,113,107
113,108,527,62,115,211,0,915,113,108
113,109,269,0,539,0,0,808,113,109
113,110,269,0,0,0,0,269,113,110
113,111,186,2422,1834,0,0,4442,113,111
113,112,466,857,0,303,0,1626,113,112
113,113,2275,6583,1295,950,0,11103,113,113
113,115,462,0,260,0,0,722,113,115
113,116,0,0,924,0,0,924,113,116
113,118,34,0,281,0,0,315,113,118
113,124,186,0,552,0,0,738,113,124
113,129,0,0,35,0,0,35,113,129
113,130,0,0,75,0,0,75,113,130
113,136,90,0,0,0,0,90,113,136
113,138,0,0,71,0,0,71,113,138
113,139,0,0,285,0,0,285,113,139
113,142,0,0,400,0,0,400,113,142
113,145,0,0,31,0,0,31,113,145
113,147,0,0,584,0,0,584,113,147
113,164,32,0,0,0,0,32,113,164
113,198,275,0,0,0,0,275,113,198
113,294,0,0,667,0,0,667,113,294
113,316,303,0,0,0,0,303,113,316
113,319,14,0,0,0,0,14,113,319
113,327,0,0,48,0,0,48,113,327
113,334,0,0,98,0,0,98,113,334
113,338,207,0,0,0,0,207,113,338
113,339,0,0,130,0,0,130,113,339
113,340,0,0,117,0,0,117,113,340
113,342,167,0,0,0,0,167,113,342
114,115,0,239,0,0,0,239,114,115
115,5,427,0,427,0,0,854,115,5
115,8,0,0,328,0,0,328,115,8
115,26,0,0,227,0,0,227,115,26
115,30,0,0,329,0,0,329,115,30
115,31,0,0,260,0,0,260,115,31
115,32,0,0,462,0,0,462,115,32
115,35,266,0,0,0,0,266,115,35
115,37,0,0,569,0,0,569,115,37
115,41,0,0,74,0,0,74,115,41
115,55,0,0,462,0,0,462,115,55
115,61,0,0,427,0,0,427,115,61
115,66,60,0,49,0,0,109,115,66
115,69,427,0,0,0,0,427,115,69
115,74,0,0,427,0,0,427,115,74
115,88,138,0,0,0,0,138,115,88
115,91,0,0,318,0,0,318,115,91
115,93,0,0,1610,0,0,1610,115,93
115,94,0,0,526,0,0,526,115,94
115,98,74,0,0,0,0,74,115,98
115,99,0,0,328,0,0,328,115,99
115,100,0,0,1352,0,0,1352,115,100
115,101,130,0,142,0,0,272,115,101
115,104,42,0,503,0,0,545,115,104
115,108,130,0,0,0,0,130,115,108
115,109,958,0,1850,0,0,2808,115,109
115,110,0,0,2349,0,0,2349,115,110
115,111,336,0,0,0,0,336,115,111
115,112,829,287,0,0,0,1116,115,112
115,113,462,0,260,0,0,722,115,113
115,114,0,239,0,0,0,239,115,114
115,115,3648,22323,2688,5118,0,33777,115,115
115,116,1716,999,2735,1716,0,7166,115,116
115,117,266,0,0,0,0,266,115,117
115,118,0,0,0,258,0,258,115,118
115,119,0,0,1101,0,0,1101,115,119
115,131,0,0,266,0,0,266,115,131
115,138,312,0,0,0,0,312,115,138
115,140,152,0,0,0,0,152,115,140
115,158,427,0,0,0,0,427,115,158
115,166,201,0,0,0,0,201,115,166
115,242,0,0,526,0,0,526,115,242
115,250,266,0,0,0,0,266,115,250
115,257,577,0,0,0,0,577,115,257
115,336,0,0,505,0,0,505,115,336
115,338,207,0,0,0,0,207,115,338
115,339,0,0,820,0,0,820,115,339
116,1,0,0,2919,0,0,2919,116,1
116,2,0,0,1390,0,0,1390,116,2
116,5,0,0,773,0,0,773,116,5
116,6,537,0,1009,0,0,1546,116,6
116,7,0,0,0,537,0,537,116,7
116,14,0,0,697,0,0,697,116,14
116,18,0,0,292,0,0,292,116,18
116,22,0,0,537,0,0,537,116,22
116,24,0,0,551,0,0,551,116,24
116,26,0,0,300,0,0,300,116,26
116,27,0,0,924,0,0,924,116,27
116,28,0,0,599,0,0,599,116,28
116,30,0,0,549,0,0,549,116,30
116,31,0,0,779,0,0,779,116,31
116,32,0,0,363,0,0,363,116,32
116,34,0,0,733,0,0,733,116,34
116,35,0,0,342,0,0,342,116,35
116,36,0,0,599,0,0,599,116,36
116,37,0,0,1845,0,0,1845,116,37
116,41,0,0,537,0,0,537,116,41
116,43,0,0,63,0,0,63,116,43
116,54,0,0,599,0,0,599,116,54
116,58,127,0,0,0,0,127,116,58
116,59,0,0,551,0,0,551,116,59
116,60,0,0,537,0,0,537,116,60
116,63,0,0,584,0,0,584,116,63
116,70,118,0,0,0,0,118,116,70
116,71,0,0,372,0,0,372,116,71
116,73,0,0,384,0,0,384,116,73
116,74,0,0,1184,0,0,1184,116,74
116,76,0,0,300,0,0,300,116,76
116,80,0,0,202,0,0,202,116,80
116,81,292,0,340,0,0,632,116,81
116,82,0,0,897,0,0,897,116,82
116,83,0,0,348,0,0,348,116,83
116,85,683,0,0,0,0,683,116,85
116,87,312,0,0,0,0,312,116,87
116,88,0,0,584,0,0,584,116,88
116,90,0,0,407,0,0,407,116,90
116,91,0,0,340,1674,0,2014,116,91
116,93,0,0,3545,0,0,3545,116,93
116,95,0,0,584,0,0,584,116,95
116,96,0,0,584,0,0,584,116,96
116,98,0,0,584,0,0,584,116,98
116,99,312,0,104,0,0,416,116,99
116,100,1638,0,5120,0,0,6758,116,100
116,101,0,0,1169,0,0,1169,116,101
116,102,186,0,584,0,0,770,116,102
116,103,21,0,0,0,0,21,116,103
116,104,0,0,0,449,0,449,116,104
116,107,0,0,944,0,0,944,116,107
116,108,292,0,0,300,0,592,116,108
116,109,3246,0,2631,4038,0,9915,116,109
116,110,537,0,1460,0,0,1997,116,110
116,111,0,0,477,0,0,477,116,111
116,113,0,0,1815,0,0,1815,116,113
116,115,2281,999,2735,1716,0,7731,116,115
116,116,7979,83834,26972,12004,0,130789,116,116
116,117,0,0,1067,0,0,1067,116,117
116,118,298,0,0,0,0,298,116,118
116,119,2013,1805,2360,0,0,6178,116,119
116,121,1998,407,1454,404,0,4263,116,121
116,122,1247,374,2764,1154,0,5539,116,122
116,123,585,498,443,0,0,1526,116,123
116,124,0,498,1109,0,0,1607,116,124
116,125,203,0,0,264,0,467,116,125
116,127,829,0,1160,0,0,1989,116,127
116,128,10,0,0,0,0,10,116,128
116,131,0,0,340,0,0,340,116,131
116,133,0,0,340,0,0,340,116,133
116,134,292,0,0,0,0,292,116,134
116,136,0,0,902,0,0,902,116,136
116,137,0,0,288,0,0,288,116,137
116,138,0,0,372,312,0,684,116,138
116,139,0,0,1311,0,0,1311,116,139
116,140,305,0,373,0,0,678,116,140
116,141,0,0,556,0,0,556,116,141
116,145,37,0,0,0,0,37,116,145
116,148,1220,0,0,0,0,1220,116,148
116,154,0,0,312,0,0,312,116,154
116,158,100,0,0,0,0,100,116,158
116,162,0,0,584,0,0,584,116,162
116,163,0,0,0,407,0,407,116,163
116,165,0,0,348,0,0,348,116,165
116,167,0,0,312,0,0,312,116,167
116,210,0,0,661,0,0,661,116,210
116,217,0,0,0,308,0,308,116,217
116,238,0,0,537,0,0,537,116,238
116,242,0,0,186,0,0,186,116,242
116,271,292,0,0,0,0,292,116,271
116,298,0,0,0,470,0,470,116,298
116,325,0,0,0,289,0,289,116,325
116,333,0,0,584,0,0,584,116,333
116,334,291,0,0,0,0,291,116,334
116,338,0,0,384,0,0,384,116,338
117,24,0,0,309,0,0,309,117,24
117,55,1431,0,0,0,0,1431,117,55
117,72,0,0,826,0,0,826,117,72
117,77,0,0,337,0,0,337,117,77
117,79,2091,0,0,0,0,2091,117,79
117,80,0,0,510,0,0,510,117,80
117,82,1431,0,0,0,0,1431,117,82
117,86,0,0,718,0,0,718,117,86
117,91,0,0,2275,0,0,2275,117,91
117,95,0,0,111,0,0,111,117,95
117,98,53,0,0,0,0,53,117,98
117,99,96,0,104,0,0,200,117,99
117,100,0,0,718,0,0,718,117,100
117,102,0,0,0,985,0,985,117,102
117,105,0,0,954,0,0,954,117,105
117,107,1542,0,0,0,0,1542,117,107
117,109,1246,0,0,0,0,1246,117,109
117,111,109,0,0,0,0,109,117,111
117,112,671,0,0,0,0,671,117,112
117,115,266,0,0,0,0,266,117,115
117,116,0,0,1067,0,0,1067,117,116
117,117,4868,8090,4029,9450,0,26437,117,117
117,118,1066,783,211,210,0,2270,117,118
117,119,309,0,610,0,0,919,117,119
117,127,0,0,0,528,0,528,117,127
117,274,0,0,309,0,0,309,117,274
117,329,0,0,1284,0,0,1284,117,329
117,342,1198,0,0,0,0,1198,117,342
118,10,0,0,281,0,0,281,118,10
118,27,0,0,129,0,0,129,118,27
118,32,0,0,87,0,0,87,118,32
118,35,0,0,141,0,0,141,118,35
118,57,129,0,0,0,0,129,118,57
118,60,129,0,0,0,0,129,118,60
118,69,129,0,0,0,0,129,118,69
118,73,0,0,0,129,0,129,118,73
118,75,15,0,0,0,0,15,118,75
118,78,129,0,0,0,0,129,118,78
118,79,15,0,181,0,0,196,118,79
118,82,0,0,321,0,0,321,118,82
118,88,0,0,181,0,0,181,118,88
118,91,0,0,490,0,0,490,118,91
118,93,0,0,108,0,0,108,118,93
118,98,0,0,8,0,0,8,118,98
118,99,64,0,70,0,0,134,118,99
118,100,586,0,802,0,0,1388,118,100
118,103,0,0,161,0,0,161,118,103
118,106,0,0,181,0,0,181,118,106
118,108,18,0,239,0,0,257,118,108
118,109,517,0,95,0,0,612,118,109
118,110,0,0,202,0,0,202,118,110
118,111,325,0,95,0,0,420,118,111
118,113,34,0,141,0,0,175,118,113
118,115,33,0,0,282,0,315,118,115
118,116,259,0,0,0,0,259,118,116
118,117,1066,783,211,210,0,2270,118,117
118,118,1175,7071,380,0,0,8626,118,118
118,119,676,278,141,0,0,1095,118,119
118,133,0,15,0,0,0,15,118,133
118,138,91,0,0,0,0,91,118,138
118,144,0,0,141,0,0,141,118,144
118,162,129,0,0,0,0,129,118,162
118,301,0,0,166,0,0,166,118,301
118,317,14,0,0,0,0,14,118,317
118,322,77,0,0,0,0,77,118,322
118,330,25,0,0,0,0,25,118,330
118,338,18,0,0,0,0,18,118,338
119,26,0,0,187,0,0,187,119,26
119,32,0,0,1281,0,0,1281,119,32
119,34,23,0,0,0,0,23,119,34
119,37,0,0,0,417,0,417,119,37
119,54,541,0,0,0,0,541,119,54
119,69,0,0,464,0,0,464,119,69
119,75,417,0,0,0,0,417,119,75
119,79,0,0,454,0,0,454,119,79
119,81,0,0,464,0,0,464,119,81
119,82,0,0,417,0,0,417,119,82
119,83,0,0,879,0,0,879,119,83
119,84,0,0,454,0,0,454,119,84
119,88,0,0,504,0,0,504,119,88
119,91,0,0,3357,0,0,3357,119,91
119,92,879,0,0,0,0,879,119,92
119,93,0,0,610,0,0,610,119,93
119,99,96,0,0,0,0,96,119,99
119,100,0,0,2028,0,0,2028,119,100
119,102,0,0,1063,0,0,1063,119,102
119,103,0,0,660,0,0,660,119,103
119,105,0,0,1063,0,0,1063,119,105
119,109,0,0,1082,0,0,1082,119,109
119,110,0,0,454,0,0,454,119,110
119,111,0,0,484,0,0,484,119,111
119,112,0,0,859,0,0,859,119,112
119,115,0,0,1161,0,0,1161,119,115
119,116,2305,1805,2360,0,0,6470,119,116
119,117,309,0,0,0,0,309,119,117
119,118,676,278,141,0,0,1095,119,118
119,119,4969,32628,15924,16160,0,69681,119,119
119,122,0,0,519,0,0,519,119,122
119,138,0,0,0,44,0,44,119,138
119,232,0,0,513,0,0,513,119,232
119,254,0,0,879,0,0,879,119,254
119,256,0,0,417,0,0,417,119,256
119,273,0,0,977,0,0,977,119,273
119,280,143,0,0,0,0,143,119,280
119,313,230,0,0,0,0,230,119,313
119,338,1342,0,0,0,0,1342,119,338
121,4,0,0,542,0,0,542,121,4
121,5,0,0,1059,0,0,1059,121,5
121,7,0,0,882,0,0,882,121,7
121,8,0,0,442,0,0,442,121,8
121,12,0,0,0,666,0,666,121,12
121,26,0,0,292,0,0,292,121,26
121,28,0,0,442,0,0,442,121,28
121,36,406,0,0,0,0,406,121,36
121,37,0,0,442,0,0,442,121,37
121,45,666,0,0,0,0,666,121,45
121,49,0,0,74,0,0,74,121,49
121,53,0,0,666,0,0,666,121,53
121,57,0,0,666,0,0,666,121,57
121,71,0,0,376,0,0,376,121,71
121,79,0,0,0,406,0,406,121,79
121,82,0,0,590,0,0,590,121,82
121,86,0,0,590,0,0,590,121,86
121,88,666,0,1032,0,0,1698,121,88
121,91,0,0,725,337,0,1062,121,91
121,92,0,0,1180,0,0,1180,121,92
121,93,0,0,442,0,0,442,121,93
121,95,0,0,725,0,0,725,121,95
121,98,0,0,442,0,0,442,121,98
121,99,0,0,571,0,0,571,121,99
121,102,0,0,442,0,0,442,121,102
121,109,0,0,1315,0,0,1315,121,109
121,116,1998,407,1454,404,0,4263,121,116
121,121,1482,29394,3021,0,0,33897,121,121
121,122,1328,2107,740,0,0,4175,121,122
121,123,0,767,818,767,0,2352,121,123
121,124,3064,6592,4445,0,0,14101,121,124
121,126,334,0,0,0,0,334,121,126
121,127,436,0,0,0,0,436,121,127
121,129,0,0,725,0,0,725,121,129
121,134,0,208,439,0,0,647,121,134
121,135,0,0,442,0,0,442,121,135
121,137,0,0,968,0,0,968,121,137
121,138,406,0,29,24,0,459,121,138
121,139,1475,0,855,1324,0,3654,121,139
121,141,1641,0,1882,0,0,3523,121,141
121,142,2540,74,0,248,0,2862,121,142
121,144,0,0,1060,0,0,1060,121,144
121,152,0,0,818,0,0,818,121,152
121,154,0,0,725,0,0,725,121,154
121,161,0,0,442,0,0,442,121,161
121,177,189,0,0,0,0,189,121,177
121,188,0,0,0,152,0,152,121,188
121,251,0,0,889,0,0,889,121,251
121,281,24,0,0,0,0,24,121,281
121,301,0,0,376,0,0,376,121,301
121,329,51,0,0,0,0,51,121,329
122,1,0,0,384,0,0,384,122,1
122,5,0,0,698,0,0,698,122,5
122,6,0,0,364,0,0,364,122,6
122,15,0,0,197,0,0,197,122,15
122,27,669,0,0,0,0,669,122,27
122,31,0,0,519,0,0,519,122,31
122,35,0,0,364,0,0,364,122,35
122,66,0,0,0,555,0,555,122,66
122,76,0,1098,0,0,0,1098,122,76
122,77,0,0,423,0,0,423,122,77
122,79,0,0,789,0,0,789,122,79
122,82,0,0,0,334,0,334,122,82
122,84,0,0,141,0,0,141,122,84
122,87,0,0,141,0,0,141,122,87
122,93,555,0,527,0,0,1082,122,93
122,96,0,0,603,0,0,603,122,96
122,99,274,0,2453,0,0,2727,122,99
122,100,477,0,1294,0,0,1771,122,100
122,102,0,0,364,0,0,364,122,102
122,109,678,2422,423,0,0,3523,122,109
122,110,477,0,397,0,0,874,122,110
122,116,88,353,2727,1154,0,4322,122,116
122,119,0,0,519,0,0,519,122,119
122,121,1811,1632,1821,0,0,5264,122,121
122,122,3610,20466,1889,0,0,25965,122,122
122,123,0,1726,364,0,0,2090,122,123
122,124,477,0,2507,0,0,2984,122,124
122,125,0,1441,901,184,0,2526,122,125
122,127,810,0,1111,184,0,2105,122,127
122,132,0,0,519,0,0,519,122,132
122,134,551,0,0,0,0,551,122,134
122,136,0,0,364,0,0,364,122,136
122,139,0,0,364,0,0,364,122,139
122,140,0,0,519,0,485,1004,122,140
122,141,0,0,298,0,0,298,122,141
122,154,0,0,389,0,0,389,122,154
122,161,0,0,364,0,0,364,122,161
122,165,0,0,163,0,0,163,122,165
122,168,0,0,0,421,0,421,122,168
122,208,204,0,0,0,0,204,122,208
122,274,0,0,274,0,0,274,122,274
122,300,0,0,587,0,0,587,122,300
122,302,389,0,0,0,0,389,122,302
122,319,389,0,364,0,0,753,122,319
122,331,0,0,0,389,0,389,122,331
122,339,0,0,519,0,0,519,122,339
123,7,0,0,878,0,0,878,123,7
123,8,0,0,706,0,0,706,123,8
123,9,0,0,71,0,0,71,123,9
123,19,0,0,647,0,0,647,123,19
123,29,0,0,594,0,0,594,123,29
123,35,0,0,776,0,0,776,123,35
123,36,0,0,706,0,0,706,123,36
123,39,594,0,0,0,0,594,123,39
123,54,0,0,706,0,0,706,123,54
123,56,0,0,713,0,0,713,123,56
123,77,0,0,594,0,0,594,123,77
123,90,0,0,0,367,0,367,123,90
123,91,0,0,2119,0,0,2119,123,91
123,93,0,0,1142,0,0,1142,123,93
123,94,594,0,0,367,0,961,123,94
123,99,362,0,0,0,0,362,123,99
123,100,594,0,3999,0,0,4593,123,100
123,107,0,0,0,649,0,649,123,107
123,109,841,0,647,0,0,1488,123,109
123,116,585,498,443,0,0,1526,123,116
123,121,406,767,818,767,0,2758,123,121
123,122,0,1726,0,0,0,1726,123,122
123,123,0,19400,0,11912,0,31312,123,123
123,124,507,6527,2311,1241,0,10586,123,124
123,125,0,3158,0,0,0,3158,123,125
123,126,362,726,1276,961,0,3325,123,126
123,127,594,0,1971,649,0,3214,123,127
123,133,0,0,706,0,0,706,123,133
123,136,0,0,0,367,0,367,123,136
123,144,0,0,237,0,0,237,123,144
123,153,0,0,647,0,0,647,123,153
123,188,0,0,647,0,0,647,123,188
123,204,0,0,647,0,0,647,123,204
123,224,0,0,0,1535,0,1535,123,224
123,275,0,0,594,0,0,594,123,275
123,280,0,0,647,0,0,647,123,280
123,286,0,0,706,0,0,706,123,286
123,302,300,0,0,0,0,300,123,302
123,318,0,0,103,0,0,103,123,318
123,320,274,0,0,0,0,274,123,320
123,338,0,0,399,0,0,399,123,338
123,339,0,0,237,0,0,237,123,339
124,1,135,0,1375,0,0,1510,124,1
124,4,0,0,507,0,0,507,124,4
124,5,0,0,1375,0,0,1375,124,5
124,6,1014,0,1189,0,0,2203,124,6
124,19,146,0,0,0,0,146,124,19
124,26,0,0,914,0,0,914,124,26
124,28,0,0,439,0,0,439,124,28
124,29,0,0,878,0,0,878,124,29
124,30,0,0,552,0,0,552,124,30
124,31,60,0,0,0,0,60,124,31
124,32,0,0,552,0,0,552,124,32
124,37,807,0,316,0,0,1123,124,37
124,40,18,0,0,0,0,18,124,40
124,66,507,0,0,0,0,507,124,66
124,77,183,0,0,0,0,183,124,77
124,84,74,0,0,0,0,74,124,84
124,91,507,0,552,0,0,1059,124,91
124,93,404,0,943,0,0,1347,124,93
124,94,0,0,552,0,0,552,124,94
124,95,102,0,0,0,0,102,124,95
124,97,0,0,316,0,0,316,124,97
124,99,0,0,552,0,0,552,124,99
124,100,3722,0,2604,0,0,6326,124,100
124,102,0,0,552,0,0,552,124,102
124,109,823,0,895,0,0,1718,124,109
124,111,507,0,0,0,0,507,124,111
124,113,186,0,0,507,0,693,124,113
124,116,0,498,1109,0,0,1607,124,116
124,121,3726,6592,5618,0,0,15936,124,121
124,122,477,0,1988,0,0,2465,124,122
124,123,1101,6527,2311,1241,0,11180,124,123
124,124,5524,24556,0,4686,0,34766,124,124
124,125,0,3313,143,319,0,3775,124,125
124,126,2463,2480,1518,0,0,6461,124,126
124,127,2266,0,2100,408,0,4774,124,127
124,129,507,0,0,0,0,507,124,129
124,131,0,0,895,0,0,895,124,131
124,133,0,0,552,0,0,552,124,133
124,135,0,0,552,0,0,552,124,135
124,136,320,0,0,0,0,320,124,136
124,137,0,0,732,0,0,732,124,137
124,138,1014,0,47,0,0,1061,124,138
124,139,911,0,1443,317,0,2671,124,139
124,140,797,0,0,292,0,1089,124,140
124,141,2028,683,1815,291,0,4817,124,141
124,142,0,455,351,1824,0,2630,124,142
124,144,460,0,250,0,0,710,124,144
124,148,241,0,0,0,0,241,124,148
124,151,230,0,0,0,0,230,124,151
124,155,0,0,315,0,0,315,124,155
124,167,0,0,823,0,0,823,124,167
124,300,507,0,0,0,0,507,124,300
124,303,0,0,1103,0,0,1103,124,303
124,329,0,0,552,0,0,552,124,329
124,334,0,0,0,354,0,354,124,334
125,5,131,0,1049,0,0,1180,125,5
125,6,0,0,457,0,0,457,125,6
125,7,0,0,143,0,0,143,125,7
125,9,0,0,593,0,0,593,125,9
125,27,0,0,203,0,0,203,125,27
125,32,528,0,0,0,0,528,125,32
125,33,0,0,457,0,0,457,125,33
125,44,131,0,0,0,0,131,125,44
125,62,0,0,457,0,0,457,125,62
125,65,528,0,0,0,0,528,125,65
125,79,203,0,0,0,0,203,125,79
125,83,0,0,420,0,0,420,125,83
125,84,0,0,0,0,74,74,125,84
125,88,420,0,457,0,0,877,125,88
125,91,0,0,0,434,0,434,125,91
125,93,0,0,575,0,0,575,125,93
125,98,0,0,0,0,766,766,125,98
125,99,96,0,1031,532,0,1659,125,99
125,100,0,0,2027,528,0,2555,125,100
125,102,264,0,0,0,0,264,125,102
125,103,0,0,0,528,0,528,125,103
125,104,21,0,457,0,0,478,125,104
125,107,203,0,0,0,0,203,125,107
125,109,1890,0,845,423,0,3158,125,109
125,110,0,0,599,0,0,599,125,110
125,112,0,0,463,0,0,463,125,112
125,116,203,0,0,264,0,467,125,116
125,122,0,1441,1265,184,0,2890,125,122
125,123,0,2399,221,0,0,2620,125,123
125,124,0,3313,143,319,0,3775,125,124
125,125,0,32362,4246,0,0,36608,125,125
125,126,3327,970,1321,744,0,6362,125,126
125,127,0,1305,579,1064,0,2948,125,127
125,129,249,0,0,0,0,249,125,129
125,134,211,0,0,0,0,211,125,134
125,136,0,0,271,0,0,271,125,136
125,140,0,0,507,0,0,507,125,140
125,141,1399,0,0,0,0,1399,125,141
125,148,95,0,0,0,0,95,125,148
125,153,0,0,152,0,0,152,125,153
125,161,0,0,686,0,0,686,125,161
125,268,420,0,0,0,0,420,125,268
125,277,161,0,0,0,0,161,125,277
125,304,203,0,0,0,0,203,125,304
125,316,0,0,0,528,0,528,125,316
125,337,0,0,457,0,0,457,125,337
126,3,0,0,41,0,0,41,126,3
126,5,0,0,402,0,0,402,126,5
126,14,1045,0,0,0,0,1045,126,14
126,19,0,0,394,200,0,594,126,19
126,22,0,0,341,0,0,341,126,22
126,24,261,0,0,0,0,261,126,24
126,29,100,0,362,0,0,462,126,29
126,30,0,0,599,0,0,599,126,30
126,31,0,0,304,0,0,304,126,31
126,36,361,0,196,0,0,557,126,36
126,39,261,0,0,0,0,261,126,39
126,47,123,0,0,0,0,123,126,47
126,59,0,0,261,0,0,261,126,59
126,61,0,0,261,0,0,261,126,61
126,64,188,0,0,0,0,188,126,64
126,70,0,0,371,0,0,371,126,70
126,74,0,0,362,0,0,362,126,74
126,77,0,0,89,0,0,89,126,77
126,88,100,0,0,0,0,100,126,88
126,92,0,0,268,0,0,268,126,92
126,93,0,0,746,0,0,746,126,93
126,99,0,0,284,0,0,284,126,99
126,100,0,0,1956,0,0,1956,126,100
126,106,507,0,0,0,0,507,126,106
126,109,158,0,0,0,0,158,126,109
126,110,1748,0,0,0,0,1748,126,110
126,122,334,0,0,0,0,334,126,122
126,123,362,726,1055,961,0,3104,126,123
126,124,3132,2480,1623,0,0,7235,126,124
126,125,3014,970,938,744,0,5666,126,125
126,126,1247,14287,568,565,0,16667,126,126
126,127,4848,1444,1039,878,0,8209,126,127
126,129,0,0,268,0,0,268,126,129
126,138,0,0,465,0,0,465,126,138
126,139,1475,1689,371,283,0,3818,126,139
126,140,0,0,1462,0,0,1462,126,140
126,141,362,179,1431,680,770,3422,126,141
126,142,0,444,728,0,0,1172,126,142
126,144,261,0,221,0,0,482,126,144
126,150,0,0,0,460,0,460,126,150
126,153,0,0,284,0,0,284,126,153
126,161,449,0,0,0,0,449,126,161
126,163,362,0,0,0,0,362,126,163
126,165,261,0,0,0,0,261,126,165
126,171,0,0,247,0,0,247,126,171
126,254,0,0,341,0,0,341,126,254
126,256,0,0,246,0,0,246,126,256
126,264,261,0,0,0,0,261,126,264
126,275,0,0,72,0,0,72,126,275
126,280,261,0,0,0,0,261,126,280
126,290,0,0,0,283,0,283,126,290
126,302,0,0,284,0,0,284,126,302
126,328,0,0,394,0,0,394,126,328
126,338,0,0,478,0,0,478,126,338
126,339,507,0,0,0,0,507,126,339
126,341,77,0,0,0,0,77,126,341
127,5,427,0,912,0,0,1339,127,5
127,6,0,0,348,0,0,348,127,6
127,7,0,0,745,0,0,745,127,7
127,10,0,0,0,246,0,246,127,10
127,14,320,0,912,0,0,1232,127,14
127,23,0,0,0,360,0,360,127,23
127,24,0,0,1300,0,0,1300,127,24
127,28,0,0,529,0,0,529,127,28
127,32,320,0,94,0,0,414,127,32
127,36,274,0,0,0,0,274,127,36
127,37,778,0,0,0,0,778,127,37
127,43,195,0,0,0,0,195,127,43
127,49,0,0,391,0,0,391,127,49
127,52,0,0,912,0,0,912,127,52
127,54,37,0,0,0,0,37,127,54
127,56,838,0,320,0,0,1158,127,56
127,57,719,0,0,137,0,856,127,57
127,62,0,0,137,0,0,137,127,62
127,67,80,0,0,0,0,80,127,67
127,68,0,0,348,0,0,348,127,68
127,73,0,0,914,0,0,914,127,73
127,74,153,0,0,0,0,153,127,74
127,76,214,0,149,0,0,363,127,76
127,79,0,0,540,0,0,540,127,79
127,84,51,0,0,0,0,51,127,84
127,88,0,0,295,0,0,295,127,88
127,90,0,0,67,0,0,67,127,90
127,91,671,1775,1637,46,0,4129,127,91
127,92,0,0,5,0,0,5,127,92
127,93,261,0,0,0,0,261,127,93
127,94,0,0,939,0,0,939,127,94
127,95,75,0,0,0,0,75,127,95
127,96,0,0,348,0,0,348,127,96
127,97,35,0,0,0,393,428,127,97
127,98,279,0,0,0,0,279,127,98
127,99,689,0,63,0,0,752,127,99
127,100,2084,0,1256,0,0,3340,127,100
127,102,36,0,0,0,0,36,127,102
127,104,21,0,1415,0,0,1436,127,104
127,105,0,0,103,0,0,103,127,105
127,106,166,0,0,0,0,166,127,106
127,107,464,0,0,0,0,464,127,107
127,109,1296,0,946,1217,0,3459,127,109
127,110,1575,439,1431,0,0,3445,127,110
127,111,0,0,549,0,0,549,127,111
127,112,0,0,0,201,0,201,127,112
127,116,829,0,1160,0,0,1989,127,116
127,117,0,0,0,528,0,528,127,117
127,122,810,0,1111,184,0,2105,127,122
127,123,594,0,1971,649,0,3214,127,123
127,124,2105,0,1542,408,0,4055,127,124
127,125,313,1305,579,1064,0,3261,127,125
127,126,3448,1154,1433,1575,0,7610,127,126
127,127,12142,27537,659,2185,1375,43898,127,127
127,128,0,0,130,0,0,130,127,128
127,135,18,0,0,0,0,18,127,135
127,136,685,145,745,0,0,1575,127,136
127,138,864,1581,158,438,0,3041,127,138
127,139,269,3453,1940,156,0,5818,127,139
127,140,1052,0,0,1032,0,2084,127,140
127,141,2880,0,0,0,0,2880,127,141
127,142,559,0,0,0,0,559,127,142
127,145,37,0,60,0,0,97,127,145
127,148,0,0,0,331,0,331,127,148
127,151,0,0,814,0,0,814,127,151
127,153,0,0,543,0,0,543,127,153
127,160,0,0,398,0,0,398,127,160
127,163,320,0,0,0,0,320,127,163
127,245,127,0,0,0,0,127,127,245
127,282,0,0,201,0,0,201,127,282
127,291,1570,0,0,0,0,1570,127,291
127,292,838,0,0,0,0,838,127,292
127,300,320,0,0,0,0,320,127,300
127,334,0,0,312,0,0,312,127,334
127,336,21,0,0,0,0,21,127,336
127,338,436,0,348,0,0,784,127,338
127,339,0,0,295,0,0,295,127,339
128,1,0,0,43,0,0,43,128,1
128,2,0,0,10,0,0,10,128,2
128,5,0,0,81,0,0,81,128,5
128,6,10,0,10,0,0,20,128,6
128,9,0,0,310,0,0,310,128,9
128,10,1453,49,0,0,0,1502,128,10
128,12,10,83,0,0,0,93,128,12
128,13,0,0,0,13,0,13,128,13
128,23,0,0,38,0,0,38,128,23
128,24,0,0,19,0,0,19,128,24
128,29,0,0,10,0,0,10,128,29
128,32,10,0,10,0,0,20,128,32
128,33,0,0,0,0,31,31,128,33
128,37,710,0,0,0,0,710,128,37
128,38,0,0,38,0,0,38,128,38
128,43,0,0,8,0,0,8,128,43
128,44,26,0,0,0,0,26,128,44
128,45,19,0,0,0,0,19,128,45
128,49,0,0,55,0,0,55,128,49
128,53,0,0,128,0,0,128,128,53
128,55,38,0,0,0,0,38,128,55
128,57,1988,0,0,0,0,1988,128,57
128,61,10,0,0,0,0,10,128,61
128,72,38,0,0,0,0,38,128,72
128,73,0,0,10,0,0,10,128,73
128,74,0,0,56,0,0,56,128,74
128,78,102,0,0,0,0,102,128,78
128,79,0,0,10,0,0,10,128,79
128,83,0,0,11,0,0,11,128,83
128,86,0,0,19,0,0,19,128,86
128,90,0,0,10,0,0,10,128,90
128,91,0,0,10,0,0,10,128,91
128,92,10,0,10,0,0,20,128,92
128,93,0,0,63,0,0,63,128,93
128,96,0,0,10,0,0,10,128,96
128,100,0,0,10,0,0,10,128,100
128,103,0,0,11,0,0,11,128,103
128,110,10,0,0,0,0,10,128,110
128,116,10,0,0,0,0,10,128,116
128,127,0,0,130,0,0,130,128,127
128,128,0,1193,0,0,0,1193,128,128
128,129,35,887,0,0,0,922,128,129
128,130,14,326,28,0,0,368,128,130
128,131,0,61,0,0,0,61,128,131
128,132,0,86,23,0,0,109,128,132
128,133,4983,736,0,0,0,5719,128,133
128,134,45,211,253,0,0,509,128,134
128,135,53,0,212,0,0,265,128,135
128,136,0,0,10,0,0,10,128,136
128,137,981,38,992,0,0,2011,128,137
128,141,0,0,761,0,0,761,128,141
128,144,1442,0,1235,0,0,2677,128,144
128,148,0,0,1038,0,0,1038,128,148
128,151,10,0,2795,0,0,2805,128,151
128,152,0,0,10,0,0,10,128,152
128,153,152,0,139,0,0,291,128,153
128,154,77,0,22,0,0,99,128,154
128,156,10,0,328,0,0,338,128,156
128,159,522,0,0,0,0,522,128,159
128,160,233,0,0,0,0,233,128,160
128,161,435,0,0,0,0,435,128,161
128,162,50,0,524,0,0,574,128,162
128,163,336,0,238,0,0,574,128,163
128,165,12,0,0,0,0,12,128,165
128,166,0,0,201,0,0,201,128,166
128,167,0,0,10,0,0,10,128,167
128,168,0,0,10,0,0,10,128,168
128,170,21,0,0,0,0,21,128,170
128,176,10,0,0,0,0,10,128,176
128,192,0,0,276,0,0,276,128,192
128,195,0,0,317,0,0,317,128,195
128,208,0,0,255,0,0,255,128,208
128,209,0,0,10,0,0,10,128,209
128,214,10,0,0,0,0,10,128,214
128,218,0,0,460,0,0,460,128,218
128,226,0,0,521,0,0,521,128,226
128,235,0,0,484,0,0,484,128,235
128,236,0,0,41,0,0,41,128,236
128,238,0,0,26,0,0,26,128,238
128,244,0,0,337,0,0,337,128,244
128,246,0,0,114,0,0,114,128,246
128,274,0,0,0,10,0,10,128,274
128,293,0,0,869,0,0,869,128,293
128,339,0,0,24,0,0,24,128,339
129,1,0,0,45,0,0,45,129,1
129,2,0,0,58,0,0,58,129,2
129,3,0,0,35,0,0,35,129,3
129,5,0,0,71,0,0,71,129,5
129,6,0,0,67,0,0,67,129,6
129,7,0,0,643,0,0,643,129,7
129,8,0,0,309,0,0,309,129,8
129,9,0,0,305,0,0,305,129,9
129,10,0,0,32,0,0,32,129,10
129,16,0,0,35,0,0,35,129,16
129,17,601,0,0,0,0,601,129,17
129,18,0,0,74,0,0,74,129,18
129,24,0,0,213,0,0,213,129,24
129,27,0,0,35,0,0,35,129,27
129,28,0,0,26,0,0,26,129,28
129,29,0,0,90,0,0,90,129,29
129,31,0,0,81,0,0,81,129,31
129,35,35,0,527,0,0,562,129,35
129,36,44,0,0,0,0,44,129,36
129,37,0,0,70,0,0,70,129,37
129,38,70,0,0,0,0,70,129,38
129,41,0,0,169,0,0,169,129,41
129,42,0,0,81,0,0,81,129,42
129,49,74,0,85,0,0,159,129,49
129,51,0,0,89,0,0,89,129,51
129,55,0,0,58,0,0,58,129,55
129,56,0,0,22,0,0,22,129,56
129,57,155,0,0,0,0,155,129,57
129,61,0,0,72,0,0,72,129,61
129,63,0,0,98,0,0,98,129,63
129,67,0,0,55,0,0,55,129,67
129,68,0,0,177,0,0,177,129,68
129,74,35,0,124,98,0,257,129,74
129,76,0,0,31,0,0,31,129,76
129,77,38,0,0,0,0,38,129,77
129,79,0,0,54,0,0,54,129,79
129,83,0,0,69,0,0,69,129,83
129,91,0,0,26,0,0,26,129,91
129,93,0,0,80,0,0,80,129,93
129,94,0,0,45,0,0,45,129,94
129,103,0,0,0,10,0,10,129,103
129,110,439,0,0,0,0,439,129,110
129,113,0,0,35,0,0,35,129,113
129,122,778,0,0,0,0,778,129,122
129,124,507,0,725,0,0,1232,129,124
129,125,249,0,0,0,0,249,129,125
129,128,308,93,24,0,0,425,129,128
129,129,318,4331,72,0,0,4721,129,129
129,130,0,160,59,0,0,219,129,130
129,131,0,67,0,15,0,82,129,131
129,133,162,2760,92,71,0,3085,129,133
129,134,255,282,666,742,0,1945,129,134
129,135,421,2213,185,22,0,2841,129,135
129,136,0,0,352,0,0,352,129,136
129,137,0,0,1477,0,0,1477,129,137
129,139,0,0,454,0,0,454,129,139
129,140,0,0,1365,0,0,1365,129,140
129,142,45,0,2045,0,0,2090,129,142
129,144,8481,0,2744,0,0,11225,129,144
129,145,31,0,35,977,0,1043,129,145
129,147,199,0,0,0,0,199,129,147
129,148,0,0,0,219,0,219,129,148
129,150,0,0,1000,0,0,1000,129,150
129,151,0,0,2317,0,0,2317,129,151
129,153,0,0,846,0,0,846,129,153
129,154,56,0,904,0,0,960,129,154
129,155,0,0,55,0,0,55,129,155
129,156,0,0,317,0,0,317,129,156
129,158,0,0,1847,0,0,1847,129,158
129,162,296,0,0,0,0,296,129,162
129,163,3181,0,124,0,0,3305,129,163
129,164,0,0,129,0,0,129,129,164
129,165,1030,67,100,0,0,1197,129,165
129,166,330,0,63,0,0,393,129,166
129,169,0,0,41,0,0,41,129,169
129,170,0,0,45,0,0,45,129,170
129,172,35,0,0,0,0,35,129,172
129,177,0,0,62,0,0,62,129,177
129,208,0,0,109,0,0,109,129,208
129,210,35,0,0,0,0,35,129,210
129,216,0,0,439,0,0,439,129,216
129,218,0,0,639,0,0,639,129,218
129,219,591,0,594,0,0,1185,129,219
129,242,0,0,97,0,0,97,129,242
129,256,0,0,261,0,0,261,129,256
129,258,333,0,0,0,0,333,129,258
129,261,0,0,464,0,0,464,129,261
129,273,0,0,640,0,0,640,129,273
129,281,204,0,0,0,0,204,129,281
129,302,35,0,0,0,0,35,129,302
129,318,0,0,45,0,0,45,129,318
129,329,51,0,18,0,0,69,129,329
130,1,0,0,45,0,0,45,130,1
130,2,0,0,45,0,0,45,130,2
130,5,0,0,28,0,0,28,130,5
130,7,0,0,49,0,0,49,130,7
130,15,0,0,15,0,0,15,130,15
130,18,0,0,49,0,0,49,130,18
130,19,0,0,90,0,0,90,130,19
130,20,0,0,281,0,0,281,130,20
130,25,0,0,45,0,0,45,130,25
130,27,0,0,45,0,0,45,130,27
130,29,0,0,138,0,0,138,130,29
130,31,0,0,59,0,0,59,130,31
130,36,0,0,45,0,0,45,130,36
130,37,0,0,0,30,0,30,130,37
130,39,0,0,45,0,0,45,130,39
130,41,0,0,30,0,0,30,130,41
130,55,0,0,6,0,0,6,130,55
130,67,21,0,0,0,0,21,130,67
130,73,0,0,14,0,0,14,130,73
130,74,0,0,14,0,0,14,130,74
130,89,0,0,114,0,0,114,130,89
130,91,0,0,30,0,0,30,130,91
130,107,198,0,0,0,0,198,130,107
130,113,0,0,75,0,0,75,130,113
130,128,26,326,0,0,0,352,130,128
130,129,0,160,59,0,0,219,130,129
130,130,0,235,0,0,0,235,130,130
130,131,0,355,60,0,27,442,130,131
130,132,0,0,23,0,44,67,130,132
130,133,0,199,0,0,0,199,130,133
130,134,0,45,15,0,0,60,130,134
130,135,408,45,15,0,0,468,130,135
130,136,87,0,0,0,0,87,130,136
130,142,338,0,0,0,0,338,130,142
130,144,14,0,0,0,0,14,130,144
130,145,0,0,45,0,0,45,130,145
130,152,207,75,0,0,0,282,130,152
130,156,0,0,49,0,0,49,130,156
130,158,1036,0,0,0,0,1036,130,158
130,159,0,0,49,0,0,49,130,159
130,163,352,0,42,0,0,394,130,163
130,165,49,42,0,0,0,91,130,165
130,167,0,0,30,0,0,30,130,167
130,182,473,0,0,0,0,473,130,182
130,188,293,0,0,0,0,293,130,188
130,198,0,0,75,0,0,75,130,198
130,218,0,0,460,0,0,460,130,218
130,246,0,0,140,0,0,140,130,246
130,253,0,0,45,0,0,45,130,253
130,254,0,0,14,0,0,14,130,254
130,264,0,0,613,0,0,613,130,264
130,275,0,0,30,0,0,30,130,275
130,302,0,0,85,0,0,85,130,302
130,315,0,0,0,185,0,185,130,315
130,329,51,0,0,0,0,51,130,329
131,1,0,0,512,0,0,512,131,1
131,2,53,0,40,32,0,125,131,2
131,4,7,0,198,0,0,205,131,4
131,5,0,0,15,0,0,15,131,5
131,7,0,0,46,0,0,46,131,7
131,8,0,0,173,0,55,228,131,8
131,9,0,0,95,0,0,95,131,9
131,10,0,0,20,0,0,20,131,10
131,14,0,0,20,0,0,20,131,14
131,16,0,0,11,0,0,11,131,16
131,23,0,0,13,0,0,13,131,23
131,25,0,0,434,0,0,434,131,25
131,27,0,0,8,0,0,8,131,27
131,30,0,0,0,64,0,64,131,30
131,32,0,0,93,0,0,93,131,32
131,34,0,0,23,0,0,23,131,34
131,43,0,0,0,11,0,11,131,43
131,45,240,0,0,0,0,240,131,45
131,49,0,0,50,0,0,50,131,49
131,54,0,0,15,0,0,15,131,54
131,57,0,0,120,0,0,120,131,57
131,58,0,0,306,0,0,306,131,58
131,59,0,0,368,0,0,368,131,59
131,61,0,0,415,0,0,415,131,61
131,62,26,0,0,0,0,26,131,62
131,67,0,0,0,80,0,80,131,67
131,69,0,0,8,0,0,8,131,69
131,73,0,0,8,0,0,8,131,73
131,74,0,0,242,0,0,242,131,74
131,78,0,0,72,102,0,174,131,78
131,79,0,0,19,0,0,19,131,79
131,80,0,0,44,0,0,44,131,80
131,81,0,0,7,0,0,7,131,81
131,82,0,0,31,0,0,31,131,82
131,88,276,0,0,0,0,276,131,88
131,90,62,0,0,0,0,62,131,90
131,94,224,0,0,0,0,224,131,94
131,95,0,0,0,102,0,102,131,95
131,103,10,0,0,0,0,10,131,103
131,116,0,0,340,0,0,340,131,116
131,124,0,0,895,0,0,895,131,124
131,128,0,69,0,0,0,69,131,128
131,129,0,22,0,15,0,37,131,129
131,130,0,355,60,0,27,442,131,130
131,131,0,4711,0,22,0,4733,131,131
131,132,11,12,0,14,0,37,131,132
131,133,143,162,0,0,0,305,131,133
131,135,0,0,13,0,0,13,131,135
131,136,0,0,8,0,0,8,131,136
131,137,37,0,0,265,0,302,131,137
131,141,19,0,1563,0,0,1582,131,141
131,142,0,0,1063,0,0,1063,131,142
131,144,824,0,15,0,0,839,131,144
131,145,0,0,37,0,0,37,131,145
131,147,0,0,305,0,0,305,131,147
131,148,0,0,103,0,0,103,131,148
131,151,313,0,0,0,0,313,131,151
131,154,0,0,0,601,0,601,131,154
131,158,0,0,109,0,0,109,131,158
131,159,11,0,568,0,0,579,131,159
131,163,2118,0,17,0,0,2135,131,163
131,164,0,7,0,0,0,7,131,164
131,165,12,173,0,0,0,185,131,165
131,167,0,0,7,0,0,7,131,167
131,171,526,0,0,0,0,526,131,171
131,178,8,0,0,0,0,8,131,178
131,185,0,0,179,0,0,179,131,185
131,191,0,0,493,0,0,493,131,191
131,192,0,0,242,0,0,242,131,192
131,195,0,0,367,0,0,367,131,195
131,201,237,0,0,0,0,237,131,201
131,214,0,0,423,0,0,423,131,214
131,223,0,0,391,0,0,391,131,223
131,227,0,0,674,0,0,674,131,227
131,229,0,0,1225,0,0,1225,131,229
131,237,0,0,26,11,0,37,131,237
131,246,114,0,114,0,0,228,131,246
131,252,0,0,62,0,0,62,131,252
131,254,0,0,294,0,0,294,131,254
131,265,0,0,343,0,0,343,131,265
131,271,0,0,8,0,0,8,131,271
131,272,0,0,11,0,0,11,131,272
131,282,78,0,0,0,0,78,131,282
131,290,0,0,231,0,0,231,131,290
131,294,1083,0,0,0,0,1083,131,294
131,298,0,0,250,0,0,250,131,298
131,309,0,0,176,0,0,176,131,309
131,317,11,0,0,0,0,11,131,317
131,321,0,0,158,0,0,158,131,321
131,329,0,0,18,0,0,18,131,329
131,337,198,0,0,0,0,198,131,337
131,338,0,0,0,0,934,934,131,338
131,339,0,0,15,0,0,15,131,339
131,340,0,0,13,0,0,13,131,340
131,341,0,0,140,0,0,140,131,341
132,1,138,0,0,0,0,138,132,1
132,3,76,0,0,0,0,76,132,3
132,6,0,0,511,0,0,511,132,6
132,7,621,0,0,0,0,621,132,7
132,17,58,0,0,0,0,58,132,17
132,29,21,0,0,0,0,21,132,29
132,34,23,0,0,0,0,23,132,34
132,36,191,0,0,0,0,191,132,36
132,47,352,0,0,0,0,352,132,47
132,54,14,0,0,0,0,14,132,54
132,59,267,0,0,0,0,267,132,59
132,60,284,0,0,0,0,284,132,60
132,61,0,0,415,0,0,415,132,61
132,79,82,0,0,0,0,82,132,79
132,81,87,0,0,0,0,87,132,81
132,87,0,0,0,0,49,49,132,87
132,88,297,0,0,0,0,297,132,88
132,93,0,0,13,0,0,13,132,93
132,97,35,0,0,0,0,35,132,97
132,103,35,0,0,0,0,35,132,103
132,107,197,0,0,0,0,197,132,107
132,108,155,0,0,0,0,155,132,108
132,118,129,0,0,0,0,129,132,118
132,122,0,0,519,0,0,519,132,122
132,128,0,86,10,0,0,96,132,128
132,129,0,45,0,0,0,45,132,129
132,130,0,0,21,0,44,65,132,130
132,131,11,12,7,7,0,37,132,131
132,133,0,414,0,0,0,414,132,133
132,134,1643,0,0,0,0,1643,132,134
132,135,0,0,1626,0,0,1626,132,135
132,136,33,0,176,0,0,209,132,136
132,138,49,0,23,0,0,72,132,138
132,142,0,0,589,0,0,589,132,142
132,150,0,0,0,314,0,314,132,150
132,154,0,0,601,0,0,601,132,154
132,159,0,0,0,689,0,689,132,159
132,163,138,0,0,0,0,138,132,163
132,210,9,0,0,0,0,9,132,210
132,221,0,0,225,0,0,225,132,221
132,225,0,0,134,0,0,134,132,225
132,226,0,0,521,0,0,521,132,226
132,232,0,0,195,0,0,195,132,232
132,262,841,0,0,0,0,841,132,262
132,299,0,0,104,0,0,104,132,299
132,327,120,0,0,0,0,120,132,327
132,333,0,0,101,0,0,101,132,333
133,1,0,0,1648,0,0,1648,133,1
133,2,465,0,0,0,0,465,133,2
133,3,0,0,90,0,0,90,133,3
133,5,0,0,1425,0,0,1425,133,5
133,7,176,0,660,0,0,836,133,7
133,8,0,0,0,38,0,38,133,8
133,9,95,0,0,0,0,95,133,9
133,10,45,8,0,0,0,53,133,10
133,16,0,0,229,0,0,229,133,16
133,17,0,0,26,0,0,26,133,17
133,19,0,0,162,0,0,162,133,19
133,24,0,0,162,0,0,162,133,24
133,26,0,0,405,0,0,405,133,26
133,28,0,0,517,0,0,517,133,28
133,29,0,0,1066,0,0,1066,133,29
133,31,0,0,176,0,0,176,133,31
133,32,0,0,725,0,0,725,133,32
133,33,15,0,0,0,0,15,133,33
133,35,0,0,292,162,0,454,133,35
133,36,131,0,1126,0,0,1257,133,36
133,37,53,0,20,0,94,167,133,37
133,38,162,0,0,0,0,162,133,38
133,41,0,0,286,0,0,286,133,41
133,43,167,0,0,0,0,167,133,43
133,48,0,0,0,69,0,69,133,48
133,54,0,0,229,0,0,229,133,54
133,56,162,0,517,0,0,679,133,56
133,57,162,0,0,90,0,252,133,57
133,63,0,0,456,0,0,456,133,63
133,65,116,0,0,0,0,116,133,65
133,66,106,0,0,0,0,106,133,66
133,68,265,0,0,0,0,265,133,68
133,76,1035,0,0,0,0,1035,133,76
133,80,44,0,0,0,0,44,133,80
133,82,0,0,98,0,0,98,133,82
133,83,0,0,795,0,0,795,133,83
133,85,42,0,0,0,0,42,133,85
133,90,446,0,0,0,0,446,133,90
133,93,0,0,0,109,0,109,133,93
133,97,0,0,412,0,0,412,133,97
133,98,0,0,0,7,0,7,133,98
133,110,0,0,454,0,0,454,133,110
133,112,0,0,287,0,0,287,133,112
133,116,0,0,340,0,0,340,133,116
133,123,367,0,706,0,0,1073,133,123
133,124,0,0,552,0,0,552,133,124
133,128,4938,748,0,0,0,5686,133,128
133,129,431,2055,92,71,0,2649,133,129
133,130,0,199,0,0,0,199,133,130
133,131,143,162,0,0,0,305,133,131
133,132,1031,414,0,0,0,1445,133,132
133,133,1130,10196,1792,1054,0,14172,133,133
133,134,5266,1518,1054,159,0,7997,133,134
133,135,728,195,276,452,0,1651,133,135
133,136,2428,0,624,162,0,3214,133,136
133,137,1420,2038,2307,2068,0,7833,133,137
133,139,97,0,0,0,0,97,133,139
133,140,229,0,0,899,0,1128,133,140
133,141,589,0,890,0,0,1479,133,141
133,142,0,0,1251,0,0,1251,133,142
133,144,709,0,1147,954,0,2810,133,144
133,145,125,0,105,31,0,261,133,145
133,147,0,0,332,0,0,332,133,147
133,148,840,0,185,0,0,1025,133,148
133,150,497,0,970,0,0,1467,133,150
133,151,882,0,340,0,0,1222,133,151
133,152,1209,0,69,0,0,1278,133,152
133,153,93,0,1424,0,0,1517,133,153
133,154,0,0,542,143,0,685,133,154
133,155,290,0,317,0,0,607,133,155
133,156,235,0,0,0,0,235,133,156
133,157,0,0,266,0,0,266,133,157
133,158,2117,0,570,0,0,2687,133,158
133,160,0,0,546,0,0,546,133,160
133,162,0,0,177,0,0,177,133,162
133,165,62,0,35,0,0,97,133,165
133,167,0,0,456,0,0,456,133,167
133,170,0,0,156,0,0,156,133,170
133,200,0,0,149,0,0,149,133,200
133,203,0,0,190,0,0,190,133,203
133,215,0,0,0,285,0,285,133,215
133,220,296,0,0,0,0,296,133,220
133,231,0,0,149,0,0,149,133,231
133,238,135,0,0,0,0,135,133,238
133,254,0,0,153,0,0,153,133,254
133,269,0,0,162,0,0,162,133,269
133,270,76,0,0,0,0,76,133,270
133,274,229,0,159,0,0,388,133,274
133,276,0,0,0,162,0,162,133,276
133,278,0,0,416,0,0,416,133,278
133,288,0,0,75,0,0,75,133,288
133,300,0,0,368,0,0,368,133,300
133,303,0,0,517,0,0,517,133,303
133,333,517,0,101,0,0,618,133,333
133,339,0,0,229,0,0,229,133,339
134,2,443,0,469,0,0,912,134,2
134,3,0,0,14,0,0,14,134,3
134,5,0,0,233,0,0,233,134,5
134,6,0,0,612,0,0,612,134,6
134,8,233,0,0,0,0,233,134,8
134,9,0,0,154,0,0,154,134,9
134,10,233,0,0,0,0,233,134,10
134,27,1001,0,612,0,0,1613,134,27
134,30,0,0,211,0,0,211,134,30
134,31,0,0,380,612,0,992,134,31
134,32,0,0,233,0,0,233,134,32
134,34,39,0,0,0,0,39,134,34
134,35,650,0,292,142,0,1084,134,35
134,36,0,0,208,0,0,208,134,36
134,61,0,0,415,0,0,415,134,61
134,63,0,0,211,0,0,211,134,63
134,68,0,0,307,0,0,307,134,68
134,69,0,0,307,0,0,307,134,69
134,73,211,0,0,0,0,211,134,73
134,79,0,0,253,0,0,253,134,79
134,80,0,0,233,0,0,233,134,80
134,82,0,0,282,0,0,282,134,82
134,83,211,0,0,0,0,211,134,83
134,95,0,0,465,0,0,465,134,95
134,99,255,0,0,0,0,255,134,99
134,111,575,0,0,0,0,575,134,111
134,116,292,0,0,0,0,292,134,116
134,121,0,208,439,0,0,647,134,121
134,122,551,0,0,0,0,551,134,122
134,128,242,211,253,778,0,1484,134,128
134,129,0,514,666,0,0,1180,134,129
134,130,0,45,15,0,0,60,134,130
134,132,612,0,0,0,0,612,134,132
134,133,6908,2374,0,159,0,9441,134,133
134,134,6205,6067,406,1848,0,14526,134,134
134,135,1904,866,0,276,0,3046,134,135
134,136,1154,156,180,453,0,1943,134,136
134,137,1434,686,1372,927,0,4419,134,137
134,138,0,0,47,0,0,47,134,138
134,139,0,0,229,0,0,229,134,139
134,140,575,0,253,0,0,828,134,140
134,141,247,0,392,367,0,1006,134,141
134,142,541,0,0,367,0,908,134,142
134,144,5048,37,4383,902,0,10370,134,144
134,145,0,0,67,0,0,67,134,145
134,147,0,0,184,0,0,184,134,147
134,148,30,0,263,0,0,293,134,148
134,150,0,0,1000,0,0,1000,134,150
134,151,0,0,278,0,0,278,134,151
134,153,863,0,0,0,0,863,134,153
134,154,128,0,601,0,0,729,134,154
134,156,491,0,0,0,0,491,134,156
134,157,0,0,253,0,0,253,134,157
134,158,0,0,570,565,0,1135,134,158
134,159,237,0,0,208,0,445,134,159
134,161,0,0,807,0,0,807,134,161
134,163,0,0,1016,0,0,1016,134,163
134,167,233,0,0,0,0,233,134,167
134,169,202,0,0,0,0,202,134,169
134,188,518,0,0,0,0,518,134,188
134,199,299,0,0,0,0,299,134,199
134,218,0,0,482,0,0,482,134,218
134,243,0,0,620,0,0,620,134,243
134,254,233,0,0,0,0,233,134,254
134,283,183,0,0,0,0,183,134,283
134,339,0,0,666,0,0,666,134,339
135,1,0,0,170,0,0,170,135,1
135,2,0,0,75,565,0,640,135,2
135,3,0,0,93,0,0,93,135,3
135,5,0,0,75,0,0,75,135,5
135,7,100,0,234,0,0,334,135,7
135,9,18,0,0,0,0,18,135,9
135,10,0,0,0,15,0,15,135,10
135,12,0,0,1142,0,0,1142,135,12
135,15,179,0,0,0,0,179,135,15
135,16,0,0,125,0,0,125,135,16
135,23,0,0,639,0,0,639,135,23
135,26,0,0,75,0,0,75,135,26
135,29,0,0,778,0,0,778,135,29
135,31,75,0,0,0,0,75,135,31
135,35,0,0,218,0,0,218,135,35
135,37,112,0,15,0,0,127,135,37
135,41,0,0,0,301,0,301,135,41
135,43,63,0,0,0,0,63,135,43
135,63,0,0,81,0,0,81,135,63
135,66,170,0,0,0,0,170,135,66
135,70,170,0,0,0,0,170,135,70
135,72,0,0,170,0,0,170,135,72
135,73,0,0,565,0,0,565,135,73
135,74,0,0,565,0,0,565,135,74
135,78,0,0,565,0,0,565,135,78
135,79,0,0,170,41,0,211,135,79
135,83,0,0,565,0,0,565,135,83
135,84,51,0,0,0,0,51,135,84
135,88,0,0,73,0,0,73,135,88
135,89,0,0,0,59,0,59,135,89
135,90,170,0,0,0,0,170,135,90
135,91,340,0,656,0,0,996,135,91
135,93,191,0,0,0,0,191,135,93
135,100,300,0,185,0,0,485,135,100
135,111,425,0,0,0,0,425,135,111
135,124,0,0,552,0,0,552,135,124
135,128,78,0,212,0,0,290,135,128
135,129,2261,2213,185,0,0,4659,135,129
135,130,408,45,15,0,0,468,135,130
135,131,0,0,13,0,0,13,135,131
135,132,0,0,1626,0,0,1626,135,132
135,133,728,195,276,452,0,1651,135,133
135,134,2114,866,263,276,0,3519,135,134
135,135,5502,15324,1230,1103,0,23159,135,135
135,136,170,0,1311,0,0,1481,135,136
135,137,55,0,0,0,0,55,135,137
135,141,590,0,522,0,0,1112,135,141
135,144,2909,1779,1219,75,0,5982,135,144
135,147,662,0,462,75,0,1199,135,147
135,148,0,0,652,0,0,652,135,148
135,150,0,0,1516,919,0,2435,135,150
135,151,0,0,1189,170,0,1359,135,151
135,152,611,358,22,163,0,1154,135,152
135,153,849,93,413,936,0,2291,135,153
135,154,1024,0,1294,0,0,2318,135,154
135,155,0,0,185,0,0,185,135,155
135,156,0,0,449,0,0,449,135,156
135,159,0,0,1339,0,0,1339,135,159
135,161,565,0,0,0,0,565,135,161
135,163,876,1382,351,2231,1271,6111,135,163
135,164,0,0,600,0,0,600,135,164
135,165,212,0,393,0,0,605,135,165
135,166,477,0,0,0,0,477,135,166
135,167,72,0,0,0,0,72,135,167
135,168,204,0,0,0,0,204,135,168
135,169,0,0,312,0,0,312,135,169
135,170,0,0,731,0,0,731,135,170
135,176,0,0,394,0,0,394,135,176
135,180,0,0,212,248,0,460,135,180
135,187,0,0,222,0,0,222,135,187
135,189,0,0,195,0,0,195,135,189
135,216,503,0,0,0,0,503,135,216
135,221,364,0,0,0,0,364,135,221
135,238,0,0,282,0,0,282,135,238
135,239,75,0,0,0,0,75,135,239
135,255,170,0,0,0,0,170,135,255
135,269,59,0,0,0,0,59,135,269
135,272,0,0,0,38,0,38,135,272
135,281,159,0,0,0,0,159,135,281
135,316,0,0,53,0,0,53,135,316
135,327,0,0,27,0,0,27,135,327
135,340,0,0,37,0,0,37,135,340
136,1,0,0,717,0,0,717,136,1
136,2,145,0,46,0,0,191,136,2
136,5,0,0,493,0,0,493,136,5
136,7,0,0,0,140,0,140,136,7
136,8,968,581,0,122,0,1671,136,8
136,12,0,0,176,0,0,176,136,12
136,16,68,0,0,0,0,68,136,16
136,17,0,0,64,0,0,64,136,17
136,20,0,0,480,0,0,480,136,20
136,21,83,0,0,0,0,83,136,21
136,24,0,0,338,0,0,338,136,24
136,25,0,0,0,90,0,90,136,25
136,26,229,0,0,0,0,229,136,26
136,30,249,0,0,0,0,249,136,30
136,31,0,0,206,0,0,206,136,31
136,34,39,0,0,0,0,39,136,34
136,35,0,0,865,612,0,1477,136,35
136,36,0,0,79,0,0,79,136,36
136,37,72,0,0,178,0,250,136,37
136,41,0,0,26,0,0,26,136,41
136,43,0,0,76,63,0,139,136,43
136,45,162,0,0,0,0,162,136,45
136,48,497,0,0,0,0,497,136,48
136,54,0,0,995,0,0,995,136,54
136,59,0,0,480,0,0,480,136,59
136,61,0,0,70,0,0,70,136,61
136,66,0,0,0,49,0,49,136,66
136,67,318,0,0,0,0,318,136,67
136,69,73,0,0,0,0,73,136,69
136,73,162,0,480,168,0,810,136,73
136,74,0,0,170,0,0,170,136,74
136,75,0,0,139,0,0,139,136,75
136,76,200,0,0,0,0,200,136,76
136,77,162,0,0,0,0,162,136,77
136,79,162,0,0,0,0,162,136,79
136,81,0,0,304,0,0,304,136,81
136,84,89,0,0,0,0,89,136,84
136,85,24,0,0,0,0,24,136,85
136,88,156,0,489,0,0,645,136,88
136,89,0,0,243,0,0,243,136,89
136,90,62,0,0,0,0,62,136,90
136,91,9,0,196,0,0,205,136,91
136,92,26,995,205,0,0,1226,136,92
136,94,35,0,153,0,0,188,136,94
136,95,189,0,0,0,0,189,136,95
136,97,0,0,38,0,0,38,136,97
136,98,0,0,0,7,0,7,136,98
136,99,0,0,214,0,0,214,136,99
136,102,49,0,157,0,0,206,136,102
136,104,18,0,0,0,0,18,136,104
136,110,0,267,0,0,0,267,136,110
136,111,965,0,0,0,0,965,136,111
136,113,90,0,0,0,0,90,136,113
136,116,0,0,902,0,0,902,136,116
136,122,0,0,364,0,0,364,136,122
136,123,0,0,0,367,0,367,136,123
136,124,320,0,0,0,0,320,136,124
136,125,0,0,271,0,0,271,136,125
136,127,1090,145,0,0,0,1235,136,127
136,128,0,0,10,0,0,10,136,128
136,129,0,0,352,0,0,352,136,129
136,130,87,0,0,0,0,87,136,130
136,131,0,0,25,0,0,25,136,131
136,132,58,0,176,0,0,234,136,132
136,133,2041,0,468,305,0,2814,136,133
136,134,867,653,180,453,0,2153,136,134
136,135,170,0,1390,0,0,1560,136,135
136,136,7903,21404,352,3256,0,32915,136,136
136,137,3036,1308,1165,1907,0,7416,136,137
136,138,698,1091,0,97,0,1886,136,138
136,139,0,0,1447,0,0,1447,136,139
136,140,969,570,373,215,0,2127,136,140
136,142,0,0,368,0,0,368,136,142
136,144,2252,0,0,0,0,2252,136,144
136,145,0,0,0,33,0,33,136,145
136,147,199,0,0,0,0,199,136,147
136,151,1476,0,0,0,0,1476,136,151
136,152,0,0,542,498,0,1040,136,152
136,155,0,0,193,0,0,193,136,155
136,156,0,0,0,0,423,423,136,156
136,162,0,0,0,162,0,162,136,162
136,169,0,0,0,90,0,90,136,169
136,174,0,0,357,0,0,357,136,174
136,181,888,0,0,0,0,888,136,181
136,189,0,0,79,0,0,79,136,189
136,190,0,0,20,0,0,20,136,190
136,210,0,0,0,117,0,117,136,210
136,219,0,0,343,0,0,343,136,219
136,238,0,0,480,0,0,480,136,238
136,249,114,0,0,0,0,114,136,249
136,257,631,0,0,0,0,631,136,257
136,271,87,0,0,0,0,87,136,271
136,273,0,0,673,0,0,673,136,273
136,276,0,0,1525,0,0,1525,136,276
136,289,162,0,0,0,0,162,136,289
136,300,0,0,0,247,0,247,136,300
136,303,0,0,192,0,0,192,136,303
136,316,87,0,0,0,0,87,136,316
136,319,87,0,0,497,0,584,136,319
136,322,77,0,0,0,0,77,136,322
136,336,0,0,0,162,0,162,136,336
137,1,0,0,673,0,0,673,137,1
137,2,0,0,230,0,0,230,137,2
137,5,841,0,1404,0,0,2245,137,5
137,8,0,0,107,0,0,107,137,8
137,12,0,0,732,0,0,732,137,12
137,13,0,0,0,227,0,227,137,13
137,14,0,0,535,0,0,535,137,14
137,17,0,0,840,0,0,840,137,17
137,18,673,0,0,0,0,673,137,18
137,30,0,0,333,0,0,333,137,30
137,32,0,0,673,0,0,673,137,32
137,34,333,0,0,0,0,333,137,34
137,35,1289,0,0,0,0,1289,137,35
137,36,0,0,143,0,0,143,137,36
137,43,333,0,0,0,0,333,137,43
137,45,237,0,0,0,0,237,137,45
137,56,0,0,83,0,0,83,137,56
137,60,102,0,0,0,0,102,137,60
137,63,0,0,747,0,0,747,137,63
137,68,0,0,475,36,0,511,137,68
137,77,0,0,507,0,0,507,137,77
137,80,0,0,732,0,0,732,137,80
137,81,0,0,673,0,0,673,137,81
137,87,33,0,0,24,0,57,137,87
137,88,0,0,0,138,0,138,137,88
137,91,0,0,1466,0,0,1466,137,91
137,93,0,0,552,0,0,552,137,93
137,94,0,0,1114,0,0,1114,137,94
137,98,7,0,0,0,0,7,137,98
137,103,31,0,0,0,0,31,137,103
137,108,0,0,363,0,0,363,137,108
137,110,244,0,0,0,0,244,137,110
137,116,0,0,288,0,0,288,137,116
137,121,0,0,968,0,0,968,137,121
137,125,211,0,0,0,0,211,137,125
137,127,427,0,0,0,0,427,137,127
137,128,1692,38,992,0,0,2722,137,128
137,129,333,0,1477,0,0,1810,137,129
137,131,37,0,0,265,0,302,137,131
137,133,1650,2076,2307,1800,0,7833,137,133
137,134,1224,2289,1372,303,0,5188,137,134
137,136,660,3804,803,1907,0,7174,137,136
137,137,14273,19682,1014,3282,150,38401,137,137
137,138,218,0,0,0,0,218,137,138
137,139,1104,0,121,0,150,1375,137,139
137,140,458,2820,0,0,0,3278,137,140
137,141,1692,1725,578,0,0,3995,137,141
137,144,3082,0,2569,1098,0,6749,137,144
137,145,33,0,0,0,0,33,137,145
137,152,0,0,542,0,0,542,137,152
137,154,0,0,0,333,0,333,137,154
137,155,192,0,0,0,0,192,137,155
137,156,0,0,317,0,0,317,137,156
137,164,55,0,0,0,0,55,137,164
137,193,0,0,151,0,0,151,137,193
137,223,0,0,168,0,0,168,137,223
137,225,0,0,0,134,0,134,137,225
137,261,0,0,464,0,0,464,137,261
137,268,35,0,0,0,0,35,137,268
137,283,0,0,99,0,0,99,137,283
137,287,234,0,0,0,0,234,137,287
137,291,0,0,0,248,0,248,137,291
137,300,0,0,237,0,0,237,137,300
137,319,0,0,732,0,0,732,137,319
137,321,0,0,0,408,0,408,137,321
137,330,0,0,221,0,0,221,137,330
137,338,0,0,333,0,0,333,137,338
137,339,0,0,333,0,0,333,137,339
138,1,0,0,71,0,0,71,138,1
138,4,0,0,21,0,0,21,138,4
138,5,0,0,57,0,0,57,138,5
138,7,0,0,52,0,0,52,138,7
138,8,221,0,0,0,0,221,138,8
138,24,45,0,0,0,0,45,138,24
138,28,0,0,27,0,0,27,138,28
138,30,0,0,0,58,0,58,138,30
138,31,0,0,120,0,0,120,138,31
138,32,531,0,0,0,0,531,138,32
138,38,0,0,18,0,0,18,138,38
138,43,0,0,44,0,0,44,138,43
138,50,0,0,74,0,0,74,138,50
138,57,24,0,0,0,0,24,138,57
138,59,0,0,0,267,0,267,138,59
138,61,49,0,0,0,0,49,138,61
138,74,312,0,94,0,0,406,138,74
138,78,0,0,26,0,0,26,138,78
138,79,65,0,94,0,0,159,138,79
138,80,65,0,0,0,0,65,138,80
138,83,131,0,0,0,0,131,138,83
138,84,0,0,55,0,0,55,138,84
138,85,0,0,71,0,0,71,138,85
138,86,18,0,0,0,0,18,138,86
138,87,67,0,0,0,0,67,138,87
138,90,62,0,0,0,0,62,138,90
138,91,247,0,0,0,35,282,138,91
138,92,0,0,124,0,0,124,138,92
138,94,62,0,207,0,0,269,138,94
138,100,0,0,71,0,0,71,138,100
138,101,24,0,0,0,0,24,138,101
138,102,0,0,0,85,0,85,138,102
138,103,10,0,0,0,0,10,138,103
138,105,325,0,0,0,0,325,138,105
138,109,0,0,48,0,0,48,138,109
138,110,637,0,0,44,0,681,138,110
138,113,0,0,71,0,0,71,138,113
138,116,305,0,372,312,0,989,138,116
138,118,91,0,0,0,0,91,138,118
138,119,0,0,0,44,0,44,138,119
138,121,949,0,29,24,0,1002,138,121
138,124,0,0,599,0,0,599,138,124
138,126,0,0,465,0,0,465,138,126
138,127,1302,1581,41,545,0,3469,138,127
138,132,0,0,23,0,0,23,138,132
138,134,0,0,47,0,0,47,138,134
138,136,723,1091,0,97,0,1911,138,136
138,137,439,0,0,24,0,463,138,137
138,138,166,7257,0,683,0,8106,138,138
138,139,1389,547,229,447,0,2612,138,139
138,140,1612,895,266,152,0,2925,138,140
138,142,0,0,298,0,0,298,138,142
138,144,0,0,52,44,0,96,138,144
138,145,56,0,40,0,0,96,138,145
138,147,0,0,165,0,0,165,138,147
138,156,243,0,0,0,0,243,138,156
138,160,0,0,630,0,0,630,138,160
138,161,124,0,47,0,0,171,138,161
138,163,0,0,238,0,0,238,138,163
138,164,0,0,35,0,0,35,138,164
138,167,0,0,44,0,0,44,138,167
138,169,0,0,420,0,0,420,138,169
138,188,0,0,71,0,0,71,138,188
138,193,278,0,0,0,0,278,138,193
138,195,0,0,451,0,0,451,138,195
138,242,0,0,48,0,0,48,138,242
138,273,65,0,0,0,0,65,138,273
138,278,0,0,453,0,0,453,138,278
138,316,0,0,87,0,0,87,138,316
138,322,77,0,0,0,0,77,138,322
138,329,135,0,0,0,0,135,138,329
138,338,0,0,124,0,0,124,138,338
138,342,0,0,167,0,0,167,138,342
139,1,0,0,262,0,0,262,139,1
139,5,0,0,624,0,0,624,139,5
139,6,0,0,79,0,0,79,139,6
139,7,96,0,93,0,0,189,139,7
139,8,0,0,595,0,0,595,139,8
139,9,0,0,93,0,0,93,139,9
139,30,0,0,0,0,381,381,139,30
139,31,0,0,606,0,0,606,139,31
139,38,0,0,285,0,0,285,139,38
139,49,74,0,0,0,0,74,139,49
139,62,0,0,113,0,0,113,139,62
139,73,0,0,119,0,0,119,139,73
139,74,0,0,113,0,0,113,139,74
139,75,0,0,97,0,0,97,139,75
139,77,262,0,262,0,0,524,139,77
139,79,0,0,433,0,0,433,139,79
139,80,0,0,97,0,0,97,139,80
139,82,0,0,391,0,0,391,139,82
139,84,0,0,113,607,0,720,139,84
139,85,47,0,0,0,0,47,139,85
139,90,0,0,213,0,0,213,139,90
139,91,0,0,644,0,0,644,139,91
139,92,4,0,0,0,0,4,139,92
139,93,97,0,294,0,0,391,139,93
139,94,104,0,0,0,0,104,139,94
139,99,344,0,0,0,0,344,139,99
139,100,561,0,433,0,0,994,139,100
139,102,0,0,285,117,0,402,139,102
139,104,0,0,93,0,0,93,139,104
139,109,882,0,0,0,0,882,139,109
139,110,262,0,113,0,0,375,139,110
139,111,262,0,0,0,0,262,139,111
139,112,0,0,305,0,0,305,139,112
139,113,0,0,520,0,0,520,139,113
139,116,0,0,1311,0,0,1311,139,116
139,121,1475,0,855,1324,0,3654,139,121
139,124,404,0,1338,317,0,2059,139,124
139,125,170,0,0,0,0,170,139,125
139,126,1132,2032,477,283,0,3924,139,126
139,127,1928,3020,2113,0,0,7061,139,127
139,129,0,0,454,0,0,454,139,129
139,133,97,0,0,0,0,97,139,133
139,134,0,0,229,0,0,229,139,134
139,136,0,0,1447,0,0,1447,139,136
139,137,1104,0,121,0,150,1375,139,137
139,138,1389,547,229,447,0,2612,139,138
139,139,1102,9498,133,244,0,10977,139,139
139,140,1069,2718,0,575,0,4362,139,140
139,141,427,1396,2917,0,0,4740,139,141
139,142,1424,0,728,0,0,2152,139,142
139,148,97,0,0,0,0,97,139,148
139,169,0,0,97,0,0,97,139,169
139,171,0,0,526,0,0,526,139,171
139,208,122,0,0,0,0,122,139,208
139,242,0,0,178,0,0,178,139,242
139,244,55,0,55,0,0,110,139,244
139,263,0,0,365,0,0,365,139,263
139,339,0,0,234,0,0,234,139,339
139,342,373,0,0,0,0,373,139,342
140,1,0,0,957,0,0,957,140,1
140,4,0,0,455,0,0,455,140,4
140,5,0,0,799,0,0,799,140,5
140,6,0,0,0,899,0,899,140,6
140,8,0,0,166,0,0,166,140,8
140,9,0,0,343,0,0,343,140,9
140,13,174,0,0,0,0,174,140,13
140,17,0,0,48,0,0,48,140,17
140,19,4,0,0,0,0,4,140,19
140,24,0,0,392,0,0,392,140,24
140,27,0,0,503,0,0,503,140,27
140,28,0,0,392,0,0,392,140,28
140,32,0,0,373,0,0,373,140,32
140,34,0,0,426,0,0,426,140,34
140,35,0,0,979,0,0,979,140,35
140,36,299,0,0,0,0,299,140,36
140,44,0,0,152,0,0,152,140,44
140,48,247,0,0,0,0,247,140,48
140,57,0,0,166,0,0,166,140,57
140,59,0,0,152,0,0,152,140,59
140,62,392,0,0,0,0,392,140,62
140,70,152,0,0,0,0,152,140,70
140,74,0,0,152,0,0,152,140,74
140,79,0,0,175,130,0,305,140,79
140,81,0,0,152,0,0,152,140,81
140,82,343,0,0,0,0,343,140,82
140,83,343,0,0,0,0,343,140,83
140,86,64,0,0,0,0,64,140,86
140,90,62,0,0,0,0,62,140,90
140,91,8,0,1010,0,0,1018,140,91
140,92,20,0,431,0,0,451,140,92
140,93,343,0,0,0,0,343,140,93
140,96,152,0,0,0,0,152,140,96
140,100,0,0,340,0,0,340,140,100
140,116,0,0,373,0,0,373,140,116
140,122,0,0,519,0,485,1004,140,122
140,124,797,0,0,292,0,1089,140,124
140,125,0,0,507,0,0,507,140,125
140,126,0,0,1462,0,0,1462,140,126
140,127,1052,0,0,1032,0,2084,140,127
140,129,0,0,1365,0,0,1365,140,129
140,133,229,0,0,899,0,1128,140,133
140,134,575,0,253,0,0,828,140,134
140,136,969,570,526,215,0,2280,140,136
140,137,555,3153,0,0,0,3708,140,137
140,138,1692,1211,195,31,0,3129,140,138
140,139,1069,2718,0,575,0,4362,140,139
140,140,2061,39590,340,0,0,41991,140,140
140,141,0,0,2219,0,1015,3234,140,141
140,142,0,0,381,227,0,608,140,142
140,144,313,0,166,0,0,479,140,144
140,145,0,0,0,1029,0,1029,140,145
140,153,93,0,0,0,0,93,140,153
140,162,0,0,373,0,0,373,140,162
140,168,0,0,899,0,0,899,140,168
140,183,0,0,894,0,0,894,140,183
140,184,159,0,185,0,0,344,140,184
140,191,0,0,1029,0,0,1029,140,191
140,207,0,0,343,0,0,343,140,207
140,226,625,0,0,0,0,625,140,226
140,338,0,0,190,0,0,190,140,338
141,1,0,0,730,0,0,730,141,1
141,2,0,0,958,0,0,958,141,2
141,3,0,0,427,0,0,427,141,3
141,4,0,0,1829,0,0,1829,141,4
141,5,0,0,1522,0,0,1522,141,5
141,7,0,0,578,0,0,578,141,7
141,10,0,0,0,903,0,903,141,10
141,16,0,0,241,0,0,241,141,16
141,23,0,0,29,0,0,29,141,23
141,24,0,0,982,0,0,982,141,24
141,26,0,0,1369,0,0,1369,141,26
141,30,64,0,0,0,0,64,141,30
141,32,0,0,700,0,0,700,141,32
141,35,0,0,861,0,0,861,141,35
141,36,131,0,0,0,0,131,141,36
141,37,0,0,47,0,0,47,141,37
141,54,0,0,0,792,0,792,141,54
141,57,0,0,578,0,0,578,141,57
141,66,58,0,0,0,0,58,141,66
141,69,0,0,985,0,0,985,141,69
141,73,0,0,0,360,0,360,141,73
141,74,0,0,700,0,0,700,141,74
141,79,0,0,700,0,0,700,141,79
141,90,62,0,0,0,0,62,141,90
141,91,9,0,0,0,0,9,141,91
141,94,0,0,578,0,0,578,141,94
141,98,360,0,0,0,0,360,141,98
141,100,0,0,1488,0,0,1488,141,100
141,102,659,0,0,0,0,659,141,102
141,106,0,0,578,0,0,578,141,106
141,109,0,0,1347,0,0,1347,141,109
141,111,239,0,0,0,0,239,141,111
141,116,0,0,556,0,0,556,141,116
141,121,889,0,2258,0,0,3147,141,121
141,122,0,0,298,0,0,298,141,122
141,123,406,0,0,0,0,406,141,123
141,124,1521,683,2257,291,0,4752,141,124
141,125,1399,0,0,0,0,1399,141,125
141,126,362,179,1431,680,770,3422,141,126
141,127,1317,0,0,0,0,1317,141,127
141,128,0,0,761,0,0,761,141,128
141,131,19,0,1649,0,0,1668,141,131
141,133,751,0,890,0,0,1641,141,133
141,134,0,0,995,0,0,995,141,134
141,135,590,0,80,0,0,670,141,135
141,137,2118,1725,578,0,0,4421,141,137
141,139,2727,1396,1937,0,0,6060,141,139
141,140,0,0,2219,0,1015,3234,141,140
141,141,11790,42108,2252,3404,0,59554,141,141
141,142,4174,5469,5255,4731,0,19629,141,142
141,144,1251,6243,2983,683,0,11160,141,144
141,145,3344,27,109,683,0,4163,141,145
141,147,107,0,0,0,0,107,141,147
141,148,0,0,0,226,0,226,141,148
141,152,1998,0,0,0,0,1998,141,152
141,153,239,0,0,0,0,239,141,153
141,156,243,0,0,0,0,243,141,156
141,166,0,0,531,0,0,531,141,166
141,168,0,0,427,0,0,427,141,168
141,212,437,0,0,0,0,437,141,212
141,268,0,0,300,0,0,300,141,268
141,328,531,0,0,0,0,531,141,328
141,335,0,0,578,0,0,578,141,335
141,341,125,0,0,0,0,125,141,341
142,2,0,0,298,0,0,298,142,2
142,3,0,0,297,0,0,297,142,3
142,6,0,0,323,0,0,323,142,6
142,7,669,0,0,0,0,669,142,7
142,9,0,0,728,0,0,728,142,9
142,14,677,0,589,0,0,1266,142,14
142,31,0,0,323,0,0,323,142,31
142,35,0,0,368,0,0,368,142,35
142,45,0,0,1082,0,0,1082,142,45
142,77,0,0,811,0,0,811,142,77
142,78,0,0,541,0,0,541,142,78
142,82,0,0,695,0,0,695,142,82
142,84,338,0,0,0,0,338,142,84
142,90,0,0,0,669,0,669,142,90
142,91,0,0,1079,0,0,1079,142,91
142,93,0,0,728,0,0,728,142,93
142,113,0,0,400,0,0,400,142,113
142,121,1999,74,589,248,0,2910,142,121
142,124,323,455,0,1824,0,2602,142,124
142,126,0,444,728,0,0,1172,142,126
142,127,559,0,0,0,0,559,142,127
142,129,45,0,2045,0,0,2090,142,129
142,130,338,0,0,0,0,338,142,130
142,131,0,0,368,0,0,368,142,131
142,133,0,0,1251,0,0,1251,142,133
142,134,247,0,0,367,0,614,142,134
142,136,0,0,368,0,0,368,142,136
142,138,0,0,298,0,0,298,142,138
142,139,755,0,1456,0,0,2211,142,139
142,140,0,0,381,227,0,608,142,140
142,141,4377,5019,5255,4363,0,19014,142,141
142,142,6714,33868,3089,2334,0,46005,142,142
142,144,2743,0,1685,0,0,4428,142,144
142,145,0,119,408,0,0,527,142,145
142,165,0,0,298,0,0,298,142,165
142,302,541,0,0,273,0,814,142,302
142,303,31,0,0,0,0,31,142,303
144,1,0,0,564,0,0,564,144,1
144,2,162,0,671,0,0,833,144,2
144,6,0,0,350,712,0,1062,144,6
144,7,137,0,206,0,0,343,144,7
144,9,742,0,59,0,0,801,144,9
144,10,0,0,1110,0,0,1110,144,10
144,12,742,0,0,0,0,742,144,12
144,14,0,0,807,0,0,807,144,14
144,21,0,0,111,0,0,111,144,21
144,23,1021,0,85,0,0,1106,144,23
144,24,742,0,919,0,0,1661,144,24
144,28,0,0,919,0,0,919,144,28
144,31,374,0,0,0,0,374,144,31
144,36,501,0,0,0,0,501,144,36
144,37,0,0,1339,0,0,1339,144,37
144,41,26,0,0,0,0,26,144,41
144,43,0,0,604,100,0,704,144,43
144,49,0,0,50,0,0,50,144,49
144,52,0,0,994,0,0,994,144,52
144,53,0,0,58,0,0,58,144,53
144,54,37,0,0,0,0,37,144,54
144,55,824,0,0,0,0,824,144,55
144,59,0,0,416,0,0,416,144,59
144,62,0,0,807,0,0,807,144,62
144,69,994,0,350,0,0,1344,144,69
144,72,350,0,0,0,0,350,144,72
144,74,416,0,897,0,0,1313,144,74
144,78,51,0,742,0,0,793,144,78
144,80,0,0,807,0,0,807,144,80
144,82,919,0,0,0,0,919,144,82
144,88,0,0,807,0,0,807,144,88
144,90,994,0,0,0,0,994,144,90
144,91,824,0,671,0,0,1495,144,91
144,99,0,0,0,374,0,374,144,99
144,105,50,0,0,0,0,50,144,105
144,110,439,0,477,0,0,916,144,110
144,111,478,0,0,0,0,478,144,111
144,118,129,0,0,0,0,129,144,118
144,121,0,0,1060,0,0,1060,144,121
144,123,0,0,237,0,0,237,144,123
144,124,460,0,250,0,0,710,144,124
144,126,261,0,221,0,0,482,144,126
144,128,2338,0,1235,350,0,3923,144,128
144,129,6785,0,2744,0,0,9529,144,129
144,130,14,0,0,0,0,14,144,130
144,131,824,0,15,0,0,839,144,131
144,132,212,0,0,0,0,212,144,132
144,133,709,0,1147,1696,0,3552,144,133
144,134,4054,37,3779,902,0,8772,144,134
144,135,5170,1779,604,0,0,7553,144,135
144,136,2252,0,0,0,0,2252,144,136
144,137,3082,0,2569,1098,0,6749,144,137
144,138,0,0,52,44,0,96,144,138
144,139,97,0,0,0,0,97,144,139
144,140,313,0,166,0,0,479,144,140
144,141,1251,7497,2983,683,0,12414,144,141
144,142,2743,0,1685,0,0,4428,144,142
144,144,8047,24765,4775,5453,0,43040,144,144
144,145,1952,0,65,1100,0,3117,144,145
144,147,123,0,0,204,0,327,144,147
144,148,1263,0,263,0,0,1526,144,148
144,150,0,0,352,0,0,352,144,150
144,151,994,0,960,0,0,1954,144,151
144,152,742,0,960,0,0,1702,144,152
144,153,73,824,101,0,0,998,144,153
144,154,542,0,203,0,0,745,144,154
144,155,0,0,315,192,0,507,144,155
144,156,921,0,1110,0,0,2031,144,156
144,157,59,0,0,0,0,59,144,157
144,158,806,0,999,0,0,1805,144,158
144,160,0,0,910,0,0,910,144,160
144,162,0,0,67,0,0,67,144,162
144,163,0,0,824,0,0,824,144,163
144,165,92,0,0,0,0,92,144,165
144,166,0,0,742,0,0,742,144,166
144,168,742,0,0,0,0,742,144,168
144,172,701,0,0,0,0,701,144,172
144,185,0,0,230,0,0,230,144,185
144,210,222,0,0,0,0,222,144,210
144,227,21,0,0,0,0,21,144,227
144,232,601,0,0,0,0,601,144,232
144,239,0,0,617,0,0,617,144,239
144,242,0,0,178,0,0,178,144,242
144,250,0,0,824,0,0,824,144,250
144,254,0,0,742,0,0,742,144,254
144,271,0,0,1021,0,0,1021,144,271
144,275,274,0,0,0,0,274,144,275
144,293,0,0,714,0,0,714,144,293
144,294,0,0,824,0,0,824,144,294
144,300,994,0,0,0,0,994,144,300
144,303,0,0,824,0,0,824,144,303
144,305,0,0,0,1231,0,1231,144,305
144,326,422,0,0,0,0,422,144,326
145,1,0,0,35,0,0,35,145,1
145,2,31,0,0,0,0,31,145,2
145,3,0,0,37,0,0,37,145,3
145,5,0,0,60,0,0,60,145,5
145,6,37,0,0,0,0,37,145,6
145,7,78,0,0,0,0,78,145,7
145,8,0,0,28,0,0,28,145,8
145,22,0,0,31,0,0,31,145,22
145,24,0,0,27,31,0,58,145,24
145,27,0,0,49,0,0,49,145,27
145,29,31,0,31,0,0,62,145,29
145,31,0,0,25,0,0,25,145,31
145,32,0,0,35,0,0,35,145,32
145,35,33,0,64,0,0,97,145,35
145,36,0,0,91,0,0,91,145,36
145,37,0,0,40,0,0,40,145,37
145,39,0,0,34,0,0,34,145,39
145,54,0,0,29,0,0,29,145,54
145,55,0,0,31,0,0,31,145,55
145,59,0,0,23,0,0,23,145,59
145,76,0,0,34,0,0,34,145,76
145,77,0,0,25,0,0,25,145,77
145,79,0,0,29,0,0,29,145,79
145,82,0,0,25,0,0,25,145,82
145,91,0,0,31,0,0,31,145,91
145,93,0,0,23,0,0,23,145,93
145,100,0,0,34,0,0,34,145,100
145,108,37,0,0,0,0,37,145,108
145,110,33,0,0,0,0,33,145,110
145,116,37,0,0,0,0,37,145,116
145,127,37,0,60,0,0,97,145,127
145,129,31,0,35,0,0,66,145,129
145,130,0,0,45,0,0,45,145,130
145,131,0,0,26,0,0,26,145,131
145,133,94,0,74,31,0,199,145,133
145,134,0,0,67,0,0,67,145,134
145,135,37,0,0,0,0,37,145,135
145,136,0,0,0,33,0,33,145,136
145,137,33,0,0,0,0,33,145,137
145,138,56,0,40,0,0,96,145,138
145,140,0,0,0,1029,0,1029,145,140
145,141,2442,27,1065,683,0,4217,145,141
145,142,0,119,408,0,0,527,145,142
145,144,1977,0,65,1100,0,3142,145,144
145,145,816,1463,51,189,0,2519,145,145
145,147,657,0,1135,0,1513,3305,145,147
145,148,993,0,71,0,0,1064,145,148
145,150,0,0,516,0,0,516,145,150
145,151,0,0,49,0,0,49,145,151
145,152,102,0,0,0,0,102,145,152
145,153,37,0,27,0,0,64,145,153
145,154,68,0,81,0,0,149,145,154
145,158,94,0,0,0,0,94,145,158
145,198,0,0,31,0,0,31,145,198
145,210,0,0,48,0,0,48,145,210
145,271,31,0,0,0,0,31,145,271
145,319,0,0,65,0,0,65,145,319
147,2,479,0,0,0,0,479,147,2
147,5,0,0,199,0,0,199,147,5
147,7,0,0,635,0,0,635,147,7
147,12,0,0,305,0,0,305,147,12
147,24,0,0,281,0,0,281,147,24
147,28,53,0,0,0,0,53,147,28
147,29,0,0,75,0,0,75,147,29
147,30,119,0,0,0,0,119,147,30
147,31,0,0,169,0,0,169,147,31
147,36,63,0,281,0,0,344,147,36
147,39,0,0,87,0,0,87,147,39
147,42,0,0,432,0,0,432,147,42
147,43,0,0,289,0,0,289,147,43
147,44,0,0,0,63,0,63,147,44
147,57,119,0,0,0,0,119,147,57
147,60,0,0,129,0,0,129,147,60
147,63,584,0,0,0,0,584,147,63
147,71,0,0,432,0,0,432,147,71
147,76,119,0,0,0,0,119,147,76
147,85,0,0,305,0,0,305,147,85
147,86,32,0,0,0,0,32,147,86
147,113,0,0,584,0,0,584,147,113
147,129,199,0,0,0,0,199,147,129
147,131,0,0,305,0,0,305,147,131
147,133,0,0,332,0,0,332,147,133
147,134,0,0,184,0,0,184,147,134
147,135,662,0,462,151,0,1275,147,135
147,136,62,0,0,0,0,62,147,136
147,141,107,0,0,0,0,107,147,141
147,144,182,0,0,0,0,182,147,144
147,145,657,1043,0,0,1513,3213,147,145
147,147,2932,22212,1181,1616,0,27941,147,147
147,148,278,1698,2817,289,0,5082,147,148
147,150,0,0,500,0,0,500,147,150
147,151,4122,3631,1674,1323,0,10750,147,151
147,152,1312,0,1077,0,0,2389,147,152
147,153,637,480,2250,129,0,3496,147,153
147,154,2910,53,1735,0,0,4698,147,154
147,155,53,0,401,0,0,454,147,155
147,156,0,0,368,0,0,368,147,156
147,157,214,0,0,0,0,214,147,157
147,158,0,0,0,116,0,116,147,158
147,161,0,0,130,0,0,130,147,161
147,162,0,0,130,0,0,130,147,162
147,165,63,0,130,0,0,193,147,165
147,176,36,0,0,0,0,36,147,176
147,177,36,0,0,0,0,36,147,177
147,184,0,0,92,0,0,92,147,184
147,242,0,0,305,0,0,305,147,242
147,290,0,0,432,0,0,432,147,290
147,300,432,0,826,0,0,1258,147,300
147,303,0,0,318,0,0,318,147,303
147,339,0,0,151,0,0,151,147,339
148,1,0,0,241,0,0,241,148,1
148,4,0,0,263,0,0,263,148,4
148,29,95,0,0,0,0,95,148,29
148,32,0,0,95,0,0,95,148,32
148,40,0,0,241,0,0,241,148,40
148,44,0,0,241,0,0,241,148,44
148,46,95,0,0,0,0,95,148,46
148,54,0,0,30,0,0,30,148,54
148,75,0,0,82,0,0,82,148,75
148,112,241,0,0,0,0,241,148,112
148,116,1220,0,0,0,0,1220,148,116
148,124,241,0,0,0,0,241,148,124
148,125,95,0,0,0,0,95,148,125
148,127,0,0,0,331,0,331,148,127
148,128,0,0,1038,0,0,1038,148,128
148,129,0,0,32,190,0,222,148,129
148,131,0,0,103,0,0,103,148,131
148,133,672,0,82,0,0,754,148,133
148,134,387,0,0,0,0,387,148,134
148,135,0,0,914,0,0,914,148,135
148,139,97,0,0,0,0,97,148,139
148,141,0,0,0,226,0,226,148,141
148,144,568,0,937,75,0,1580,148,144
148,145,993,0,71,0,0,1064,148,145
148,147,278,1698,2817,289,0,5082,148,147
148,148,7536,18505,1854,520,0,28415,148,148
148,149,0,0,0,0,350,350,148,149
148,153,504,0,101,260,0,865,148,153
148,154,150,241,810,0,0,1201,148,154
148,156,0,0,424,0,0,424,148,156
148,159,241,0,0,0,0,241,148,159
148,162,0,0,798,0,0,798,148,162
148,183,0,0,361,0,0,361,148,183
148,251,0,0,278,0,0,278,148,251
148,254,241,0,0,0,0,241,148,254
149,148,0,0,0,0,350,350,149,148
149,160,78,0,0,0,0,78,149,160
150,1,0,0,474,0,0,474,150,1
150,5,324,0,38,0,0,362,150,5
150,9,460,0,0,0,0,460,150,9
150,11,0,0,352,0,0,352,150,11
150,12,0,0,500,0,0,500,150,12
150,16,0,0,500,0,0,500,150,16
150,23,0,0,474,0,0,474,150,23
150,31,0,0,324,0,0,324,150,31
150,34,460,0,0,0,0,460,150,34
150,40,0,0,342,0,0,342,150,40
150,42,0,0,401,0,0,401,150,42
150,45,0,0,0,1286,0,1286,150,45
150,53,0,0,934,0,0,934,150,53
150,58,0,0,460,0,0,460,150,58
150,77,0,0,314,0,0,314,150,77
150,86,18,0,0,0,0,18,150,86
150,126,0,0,0,460,0,460,150,126
150,129,0,0,1000,0,0,1000,150,129
150,132,0,0,0,314,0,314,150,132
150,133,497,0,970,0,0,1467,150,133
150,134,0,0,1000,0,0,1000,150,134
150,135,0,0,1516,919,0,2435,150,135
150,144,0,0,352,0,0,352,150,144
150,145,0,0,516,0,0,516,150,145
150,147,0,0,500,0,0,500,150,147
150,150,919,17309,5957,1082,0,25267,150,150
150,151,720,4824,1000,1449,0,7993,150,151
150,154,0,0,2418,0,0,2418,150,154
150,155,0,0,1032,0,0,1032,150,155
150,156,0,0,1301,685,0,1986,150,156
150,159,460,0,0,0,0,460,150,159
150,160,314,0,0,0,0,314,150,160
150,161,628,0,500,0,0,1128,150,161
150,165,0,0,352,0,0,352,150,165
150,167,1224,0,0,0,0,1224,150,167
150,241,0,0,460,0,0,460,150,241
150,251,200,0,0,0,0,200,150,251
150,312,0,0,540,0,0,540,150,312
151,1,0,0,1476,0,0,1476,151,1
151,2,0,0,882,0,0,882,151,2
151,5,0,0,814,0,0,814,151,5
151,6,0,0,401,0,0,401,151,6
151,7,0,0,0,0,1133,1133,151,7
151,10,0,0,0,11,0,11,151,10
151,13,0,0,1422,0,0,1422,151,13
151,20,0,0,313,0,0,313,151,20
151,31,49,0,0,0,0,49,151,31
151,34,0,0,277,0,0,277,151,34
151,35,571,0,313,0,0,884,151,35
151,36,0,0,804,0,0,804,151,36
151,38,35,0,32,0,0,67,151,38
151,39,0,0,784,0,0,784,151,39
151,41,1476,0,121,0,0,1597,151,41
151,43,55,0,45,0,0,100,151,43
151,53,201,0,0,0,0,201,151,53
151,61,882,0,0,0,0,882,151,61
151,79,322,0,0,0,0,322,151,79
151,84,0,0,727,0,0,727,151,84
151,88,0,0,885,0,0,885,151,88
151,94,0,0,720,0,0,720,151,94
151,124,230,0,0,0,0,230,151,124
151,127,0,0,885,0,0,885,151,127
151,128,10,0,2271,0,0,2281,151,128
151,129,0,0,2317,0,0,2317,151,129
151,133,882,0,340,0,0,1222,151,133
151,134,0,0,278,0,0,278,151,134
151,135,0,0,885,0,0,885,151,135
151,144,994,0,960,0,0,1954,151,144
151,147,4122,2817,3279,1323,0,11541,151,147
151,150,0,6357,1000,1449,0,8806,151,150
151,151,14382,62780,0,7570,0,84732,151,151
151,152,55,0,524,0,0,579,151,152
151,153,2907,185,2669,0,0,5761,151,153
151,154,2424,1392,2174,438,0,6428,151,154
151,155,279,1492,304,330,423,2828,151,155
151,156,9753,185,7046,1323,0,18307,151,156
151,158,882,0,622,0,0,1504,151,158
151,159,626,0,0,0,0,626,151,159
151,163,0,0,340,0,0,340,151,163
151,165,727,0,0,0,0,727,151,165
151,169,0,0,1606,0,0,1606,151,169
151,174,372,0,0,0,0,372,151,174
151,183,0,0,392,0,0,392,151,183
151,226,0,0,170,0,0,170,151,226
151,229,0,0,452,0,0,452,151,229
151,275,0,0,1476,0,0,1476,151,275
151,282,0,0,882,0,0,882,151,282
151,298,0,0,581,0,0,581,151,298
151,314,0,0,899,0,0,899,151,314
151,326,0,0,882,0,0,882,151,326
152,1,0,0,187,0,0,187,152,1
152,2,0,0,921,0,0,921,152,2
152,5,498,0,498,0,0,996,152,5
152,7,0,0,921,0,0,921,152,7
152,9,0,0,92,0,0,92,152,9
152,12,182,0,0,0,0,182,152,12
152,16,226,0,0,0,0,226,152,16
152,18,187,0,0,0,0,187,152,18
152,22,0,0,346,0,0,346,152,22
152,24,0,0,781,0,0,781,152,24
152,26,0,0,139,0,0,139,152,26
152,27,0,0,426,0,0,426,152,27
152,28,0,0,193,0,0,193,152,28
152,31,0,0,346,0,0,346,152,31
152,32,0,0,549,0,0,549,152,32
152,36,0,0,193,0,0,193,152,36
152,44,380,0,0,0,0,380,152,44
152,53,0,0,45,0,0,45,152,53
152,54,0,0,10,0,0,10,152,54
152,56,0,0,375,0,0,375,152,56
152,57,498,0,226,0,0,724,152,57
152,68,0,0,174,0,0,174,152,68
152,72,0,0,187,0,0,187,152,72
152,74,0,0,187,0,0,187,152,74
152,75,0,0,226,0,0,226,152,75
152,77,0,0,474,0,0,474,152,77
152,79,0,0,380,0,0,380,152,79
152,87,33,0,498,0,0,531,152,87
152,92,0,0,187,0,0,187,152,92
152,93,0,0,539,0,0,539,152,93
152,94,0,0,187,0,0,187,152,94
152,121,0,0,442,0,0,442,152,121
152,128,0,0,482,0,0,482,152,128
152,129,215,0,49,0,0,264,152,129
152,130,207,75,0,0,0,282,152,130
152,133,1016,0,69,0,0,1085,152,133
152,135,448,521,0,163,0,1132,152,135
152,136,0,0,542,498,0,1040,152,136
152,137,0,0,542,0,0,542,152,137
152,141,700,0,1412,0,0,2112,152,141
152,144,742,0,960,0,0,1702,152,144
152,145,163,0,0,0,0,163,152,145
152,147,1007,0,1293,0,0,2300,152,147
152,151,55,0,0,0,0,55,152,151
152,152,3785,17198,0,193,0,21176,152,152
152,153,710,998,1833,0,0,3541,152,153
152,154,4752,5593,428,0,0,10773,152,154
152,155,393,0,201,0,0,594,152,155
152,156,0,0,394,0,0,394,152,156
152,158,0,4664,0,1246,0,5910,152,158
152,159,187,0,0,744,0,931,152,159
152,161,187,0,0,0,0,187,152,161
152,163,5285,601,355,0,272,6513,152,163
152,164,267,0,0,0,0,267,152,164
152,165,0,0,762,0,0,762,152,165
152,167,0,0,206,0,0,206,152,167
152,174,372,0,0,0,0,372,152,174
152,239,0,0,346,0,0,346,152,239
152,300,0,0,533,0,0,533,152,300
152,302,0,0,85,0,0,85,152,302
152,316,0,0,94,0,0,94,152,316
152,338,0,0,498,0,0,498,152,338
152,341,0,0,125,0,0,125,152,341
153,1,0,0,559,0,0,559,153,1
153,3,0,0,152,0,0,152,153,3
153,9,0,0,152,0,0,152,153,9
153,13,152,0,0,0,0,152,153,13
153,22,0,0,67,0,0,67,153,22
153,23,0,0,522,0,0,522,153,23
153,26,0,0,212,0,0,212,153,26
153,27,0,0,22,0,0,22,153,27
153,29,0,0,73,0,0,73,153,29
153,31,0,0,379,0,0,379,153,31
153,32,73,0,303,0,0,376,153,32
153,36,0,0,73,0,0,73,153,36
153,39,166,0,0,0,0,166,153,39
153,43,98,0,0,0,0,98,153,43
153,45,0,0,240,0,0,240,153,45
153,50,74,0,0,0,0,74,153,50
153,57,0,0,152,0,0,152,153,57
153,63,0,0,89,0,0,89,153,63
153,64,0,0,93,0,0,93,153,64
153,67,80,0,0,0,0,80,153,67
153,68,152,0,0,0,0,152,153,68
153,75,56,0,0,0,0,56,153,75
153,77,0,0,314,0,0,314,153,77
153,82,45,0,0,0,0,45,153,82
153,84,45,0,0,0,0,45,153,84
153,89,152,0,0,0,0,152,153,89
153,90,0,0,0,152,0,152,153,90
153,91,245,0,0,0,0,245,153,91
153,92,93,0,0,0,0,93,153,92
153,94,0,0,0,35,0,35,153,94
153,97,35,0,0,0,0,35,153,97
153,100,73,0,0,0,0,73,153,100
153,106,193,0,0,0,0,193,153,106
153,125,0,0,152,0,0,152,153,125
153,126,0,0,284,0,0,284,153,126
153,127,0,0,543,0,0,543,153,127
153,128,152,0,139,0,0,291,153,128
153,129,0,0,846,0,0,846,153,129
153,131,552,0,0,0,0,552,153,131
153,133,93,0,1424,0,0,1517,153,133
153,134,979,0,0,0,0,979,153,134
153,135,1267,93,435,936,0,2731,153,135
153,136,1476,0,0,0,0,1476,153,136
153,138,0,0,165,0,0,165,153,138
153,140,93,0,0,0,0,93,153,140
153,144,356,824,101,0,0,1281,153,144
153,145,37,0,27,0,0,64,153,145
153,147,637,480,2391,129,0,3637,153,147
153,148,599,0,101,260,0,960,153,148
153,151,245,185,3052,0,0,3482,153,151
153,152,559,998,1732,0,0,3289,153,152
153,153,2169,1991,101,0,0,4261,153,153
153,154,601,751,0,422,0,1774,153,154
153,155,0,0,185,0,0,185,153,155
153,156,73,0,0,0,0,73,153,156
153,158,1210,0,0,0,0,1210,153,158
153,160,0,0,0,129,0,129,153,160
153,162,91,0,0,0,0,91,153,162
153,165,152,0,17,68,0,237,153,165
153,187,0,0,222,0,0,222,153,187
153,197,0,0,333,0,0,333,153,197
153,227,0,0,618,0,0,618,153,227
153,269,152,0,0,0,0,152,153,269
153,286,152,0,0,0,0,152,153,286
153,300,0,0,152,0,0,152,153,300
153,316,0,0,73,0,0,73,153,316
153,329,0,0,152,0,0,152,153,329
154,1,0,0,1143,0,0,1143,154,1
154,2,0,0,1325,0,0,1325,154,2
154,5,0,0,601,152,0,753,154,5
154,6,1423,0,0,0,0,1423,154,6
154,7,0,0,223,0,0,223,154,7
154,9,154,0,219,0,0,373,154,9
154,14,0,0,226,0,0,226,154,14
154,15,0,0,288,0,0,288,154,15
154,16,0,0,129,0,0,129,154,16
154,21,83,0,0,0,0,83,154,21
154,23,0,0,226,0,0,226,154,23
154,24,0,0,149,0,0,149,154,24
154,54,0,0,226,0,0,226,154,54
154,59,601,0,710,0,0,1311,154,59
154,64,0,0,451,0,0,451,154,64
154,68,0,0,498,0,0,498,154,68
154,73,0,0,0,601,0,601,154,73
154,76,451,0,0,0,0,451,154,76
154,81,0,0,393,0,0,393,154,81
154,82,0,0,226,0,0,226,154,82
154,84,187,0,0,0,0,187,154,84
154,87,0,0,30,0,0,30,154,87
154,88,253,0,0,0,0,253,154,88
154,90,0,0,226,0,0,226,154,90
154,97,601,0,105,0,0,706,154,97
154,100,0,0,389,0,0,389,154,100
154,105,0,0,50,0,0,50,154,105
154,111,0,0,660,0,0,660,154,111
154,116,0,0,312,0,0,312,154,116
154,121,0,0,725,0,0,725,154,121
154,128,1238,0,0,0,0,1238,154,128
154,129,1259,0,908,0,0,2167,154,129
154,131,0,0,0,601,0,601,154,131
154,133,0,0,0,143,0,143,154,133
154,134,128,0,0,0,0,128,154,134
154,135,1024,0,640,0,0,1664,154,135
154,137,0,0,0,333,0,333,154,137
154,144,498,0,203,0,0,701,154,144
154,145,68,0,81,0,0,149,154,145
154,147,3096,53,130,0,0,3279,154,147
154,148,150,241,810,0,0,1201,154,148
154,150,0,0,2820,0,0,2820,154,150
154,151,3653,601,3780,0,0,8034,154,151
154,152,6872,3167,428,0,0,10467,154,152
154,153,646,751,0,270,0,1667,154,153
154,154,10278,7783,2691,438,0,21190,154,154
154,155,53,0,185,263,0,501,154,155
154,156,3825,4346,1941,0,0,10112,154,156
154,157,228,245,326,0,0,799,154,157
154,158,0,0,106,583,0,689,154,158
154,159,226,0,654,0,0,880,154,159
154,160,226,0,0,0,0,226,154,160
154,161,435,0,1082,0,0,1517,154,161
154,162,0,0,866,0,0,866,154,162
154,163,994,0,245,0,0,1239,154,163
154,164,0,0,593,0,0,593,154,164
154,165,32,0,1294,0,0,1326,154,165
154,181,225,0,0,0,0,225,154,181
154,204,0,0,1308,0,0,1308,154,204
154,210,0,0,121,0,0,121,154,210
154,213,0,0,601,0,0,601,154,213
154,215,1099,0,0,0,0,1099,154,215
154,223,0,0,120,0,0,120,154,223
154,271,601,0,0,0,0,601,154,271
154,275,0,0,0,967,0,967,154,275
154,300,0,0,1073,0,0,1073,154,300
154,306,283,0,0,0,0,283,154,306
154,317,0,0,0,226,0,226,154,317
154,340,0,0,119,0,0,119,154,340
155,1,0,0,579,0,0,579,155,1
155,5,290,0,279,0,0,569,155,5
155,22,0,0,290,0,0,290,155,22
155,24,0,0,290,0,0,290,155,24
155,31,0,0,122,290,0,412,155,31
155,37,290,0,0,0,0,290,155,37
155,45,279,0,0,0,0,279,155,45
155,89,168,0,0,0,0,168,155,89
155,92,292,0,0,0,0,292,155,92
155,124,0,0,315,0,0,315,155,124
155,129,0,0,55,0,0,55,155,129
155,133,290,0,317,0,0,607,155,133
155,135,0,0,488,0,0,488,155,135
155,137,192,0,0,0,0,192,155,137
155,144,0,0,315,192,0,507,155,144
155,147,53,0,0,0,0,53,155,147
155,150,0,0,1032,0,0,1032,155,150
155,151,279,1492,0,330,423,2524,155,151
155,152,393,0,417,0,0,810,155,152
155,153,0,0,185,0,0,185,155,153
155,154,53,0,185,263,0,501,155,154
155,155,888,11164,630,2330,0,15012,155,155
155,156,1266,3016,1633,290,0,6205,155,156
155,157,393,0,0,0,0,393,155,157
155,158,0,0,0,263,0,263,155,158
155,159,0,0,57,279,0,336,155,159
155,162,0,0,256,53,0,309,155,162
155,166,0,0,53,0,0,53,155,166
155,171,170,0,0,0,0,170,155,171
155,210,0,0,170,0,0,170,155,210
155,243,0,0,275,0,0,275,155,243
155,269,258,0,0,0,0,258,155,269
156,1,0,0,243,0,0,243,156,1
156,3,0,0,292,0,0,292,156,3
156,5,0,0,122,0,0,122,156,5
156,6,0,0,122,0,0,122,156,6
156,11,0,0,1736,0,0,1736,156,11
156,13,0,0,13,0,0,13,156,13
156,17,0,0,498,0,0,498,156,17
156,29,0,0,292,0,0,292,156,29
156,31,73,0,0,0,0,73,156,31
156,32,0,0,543,0,0,543,156,32
156,36,0,0,141,0,0,141,156,36
156,39,0,0,317,0,0,317,156,39
156,43,0,0,338,0,0,338,156,43
156,77,0,0,98,0,0,98,156,77
156,91,0,0,292,0,0,292,156,91
156,93,0,0,113,0,0,113,156,93
156,94,0,0,338,0,0,338,156,94
156,108,0,0,338,0,0,338,156,108
156,128,10,0,328,0,0,338,156,128
156,129,0,0,317,0,0,317,156,129
156,130,0,0,0,45,0,45,156,130
156,133,235,0,0,0,0,235,156,133
156,134,98,0,0,0,0,98,156,134
156,135,0,0,317,0,0,317,156,135
156,136,0,0,368,162,423,953,156,136
156,137,0,0,317,0,0,317,156,137
156,138,243,0,0,0,0,243,156,138
156,141,243,0,0,0,0,243,156,141
156,144,921,0,1110,0,0,2031,156,144
156,147,0,0,368,0,0,368,156,147
156,148,0,0,449,0,0,449,156,148
156,150,0,0,1301,685,0,1986,156,150
156,151,8296,912,7839,1323,0,18370,156,151
156,152,0,0,394,0,0,394,156,152
156,153,73,0,0,0,0,73,156,153
156,154,3684,3849,1941,0,0,9474,156,154
156,155,1266,3016,1633,290,0,6205,156,155
156,156,2398,13281,317,0,0,15996,156,156
156,157,2519,154,280,0,0,2953,156,157
156,158,1078,0,2071,0,0,3149,156,158
156,159,685,2576,1087,583,0,4931,156,159
156,160,0,0,315,0,0,315,156,160
156,161,0,0,0,630,0,630,156,161
156,162,68,0,132,416,0,616,156,162
156,163,410,0,0,0,0,410,156,163
156,164,49,0,547,0,0,596,156,164
156,165,0,0,471,0,0,471,156,165
156,174,357,0,0,0,0,357,156,174
156,189,269,0,0,0,0,269,156,189
156,190,0,0,122,0,0,122,156,190
156,199,0,0,324,0,0,324,156,199
156,206,486,0,0,0,0,486,156,206
156,213,0,0,292,0,0,292,156,213
156,237,0,0,0,145,0,145,156,237
156,266,292,0,0,0,0,292,156,266
156,278,0,0,348,0,0,348,156,278
156,309,0,0,427,0,0,427,156,309
156,324,0,0,521,0,0,521,156,324
157,2,0,0,167,0,0,167,157,2
157,5,0,0,368,154,0,522,157,5
157,6,154,0,59,0,0,213,157,6
157,7,0,0,70,0,0,70,157,7
157,13,0,0,380,0,0,380,157,13
157,26,0,0,307,0,0,307,157,26
157,35,0,0,1078,0,0,1078,157,35
157,43,0,0,214,0,0,214,157,43
157,52,0,0,228,0,0,228,157,52
157,54,0,0,154,0,0,154,157,54
157,68,59,0,0,0,0,59,157,68
157,73,0,0,390,0,0,390,157,73
157,79,154,0,0,0,0,154,157,79
157,80,0,0,214,0,0,214,157,80
157,82,154,0,342,0,0,496,157,82
157,105,154,0,0,0,0,154,157,105
157,133,0,0,280,0,0,280,157,133
157,137,0,0,253,0,0,253,157,137
157,147,214,0,0,0,0,214,157,147
157,151,342,0,0,0,0,342,157,151
157,154,382,245,326,0,0,953,157,154
157,155,393,0,0,0,0,393,157,155
157,156,2519,154,280,0,0,2953,157,156
157,157,0,7520,635,1996,0,10151,157,157
157,158,411,0,76,0,356,843,157,158
157,159,3621,2217,1158,689,0,7685,157,159
157,160,154,0,863,0,0,1017,157,160
157,162,427,0,167,0,0,594,157,162
157,165,154,0,0,0,0,154,157,165
157,167,0,0,0,521,0,521,157,167
157,169,154,0,0,0,0,154,157,169
157,258,0,0,0,154,0,154,157,258
157,339,0,0,228,154,0,382,157,339
157,340,0,0,0,154,0,154,157,340
158,1,0,0,1058,0,0,1058,158,1
158,5,0,0,1036,0,0,1036,158,5
158,10,0,0,3143,0,0,3143,158,10
158,16,0,0,85,0,0,85,158,16
158,24,0,0,3830,0,0,3830,158,24
158,31,0,0,1036,0,0,1036,158,31
158,32,0,0,1058,0,0,1058,158,32
158,53,0,0,22,0,0,22,158,53
158,54,524,0,0,0,0,524,158,54
158,62,0,0,806,0,0,806,158,62
158,93,0,0,1133,0,0,1133,158,93
158,106,1036,0,0,0,0,1036,158,106
158,116,100,0,0,0,0,100,158,116
158,129,0,0,1192,0,0,1192,158,129
158,130,1036,0,0,0,0,1036,158,130
158,131,0,0,109,0,0,109,158,131
158,133,2117,0,570,0,0,2687,158,133
158,134,0,0,570,565,0,1135,158,134
158,144,806,0,999,0,0,1805,158,144
158,145,94,0,0,0,0,94,158,145
158,147,63,0,58,0,0,121,158,147
158,151,882,0,622,0,0,1504,158,151
158,152,226,4489,355,1246,0,6316,158,152
158,153,1210,0,0,0,0,1210,158,153
158,154,226,601,106,583,0,1516,158,154
158,155,0,0,0,263,0,263,158,155
158,156,786,0,2071,0,0,2857,158,156
158,157,564,0,76,257,356,1253,158,157
158,158,0,13249,0,63,0,13312,158,158
158,159,3688,436,424,0,0,4548,158,159
158,160,0,2440,0,1802,0,4242,158,160
158,161,0,0,294,0,0,294,158,161
158,163,0,3899,811,0,0,4710,158,163
158,164,55,0,35,0,0,90,158,164
158,165,0,0,1773,1058,0,2831,158,165
158,167,1058,0,0,0,0,1058,158,167
158,170,0,0,570,0,0,570,158,170
158,220,0,0,296,0,0,296,158,220
158,233,0,0,338,0,0,338,158,233
158,263,427,0,0,0,0,427,158,263
158,279,0,0,524,0,0,524,158,279
158,319,1058,0,0,0,0,1058,158,319
158,332,646,0,0,0,0,646,158,332
159,2,787,0,119,0,0,906,159,2
159,8,0,0,38,0,0,38,159,8
159,10,0,0,1005,0,0,1005,159,10
159,12,1125,0,0,0,0,1125,159,12
159,14,0,0,1861,0,0,1861,159,14
159,22,1181,0,0,0,0,1181,159,22
159,27,787,0,0,0,0,787,159,27
159,31,0,0,1487,0,0,1487,159,31
159,35,787,0,0,0,0,787,159,35
159,39,0,0,481,0,0,481,159,39
159,44,56,0,0,0,0,56,159,44
159,80,44,0,0,0,0,44,159,80
159,91,59,0,0,0,0,59,159,91
159,128,522,0,0,0,0,522,159,128
159,130,0,0,49,0,0,49,159,130
159,131,11,0,568,0,0,579,159,131
159,132,0,0,0,689,0,689,159,132
159,134,237,0,601,208,0,1046,159,134
159,135,0,0,1339,0,0,1339,159,135
159,148,241,0,0,0,0,241,159,148
159,150,460,0,0,0,0,460,159,150
159,151,626,0,0,0,0,626,159,151
159,152,187,0,0,744,0,931,159,152
159,155,0,0,57,279,0,336,159,155
159,156,685,2576,1087,292,0,4640,159,156
159,157,5096,1271,945,885,0,8197,159,157
159,158,3913,411,731,0,0,5055,159,158
159,159,3933,33438,0,3896,0,41267,159,159
159,160,557,811,328,1039,0,2735,159,160
159,161,4604,0,858,292,0,5754,159,161
159,162,0,0,1052,404,0,1456,159,162
159,163,746,0,0,0,0,746,159,163
159,164,0,0,326,0,0,326,159,164
159,165,522,0,1711,0,0,2233,159,165
159,170,0,0,499,0,0,499,159,170
159,175,0,0,730,0,0,730,159,175
159,204,924,0,677,0,0,1601,159,204
159,214,0,0,1035,0,0,1035,159,214
159,215,0,0,234,0,0,234,159,215
159,229,0,0,398,0,0,398,159,229
159,233,634,0,0,0,0,634,159,233
159,236,0,0,0,41,0,41,159,236
159,243,173,0,0,0,0,173,159,243
159,262,0,0,0,331,0,331,159,262
160,9,0,0,77,0,0,77,160,9
160,10,0,0,546,0,0,546,160,10
160,18,0,0,484,0,0,484,160,18
160,28,502,0,0,0,0,502,160,28
160,29,0,0,837,0,0,837,160,29
160,31,0,0,1081,0,0,1081,160,31
160,38,35,1733,0,0,0,1768,160,38
160,40,502,0,630,0,0,1132,160,40
160,41,0,0,910,0,0,910,160,41
160,43,205,0,0,0,0,205,160,43
160,46,367,0,0,0,0,367,160,46
160,47,184,0,0,0,0,184,160,47
160,48,0,0,546,0,0,546,160,48
160,58,78,0,0,0,0,78,160,58
160,68,78,0,0,0,0,78,160,68
160,79,0,0,502,0,0,502,160,79
160,82,966,0,0,0,0,966,160,82
160,90,0,0,422,0,0,422,160,90
160,98,0,0,53,0,0,53,160,98
160,109,0,0,725,0,0,725,160,109
160,127,365,0,0,0,0,365,160,127
160,133,0,0,546,0,0,546,160,133
160,134,465,0,0,0,0,465,160,134
160,138,0,0,630,0,0,630,160,138
160,144,0,0,910,0,0,910,160,144
160,149,78,0,0,0,0,78,160,149
160,150,314,0,0,0,0,314,160,150
160,153,0,0,0,129,0,129,160,153
160,154,869,0,0,0,0,869,160,154
160,156,0,0,315,0,0,315,160,156
160,157,0,0,863,0,0,863,160,157
160,158,379,2440,0,1802,0,4621,160,158
160,159,557,811,328,1039,0,2735,160,159
160,160,985,5501,0,554,0,7040,160,160
160,161,5010,334,1771,694,0,7809,160,161
160,162,656,4855,1258,734,0,7503,160,162
160,163,365,0,1221,0,0,1586,160,163
160,164,556,0,0,0,0,556,160,164
160,165,108,0,0,579,0,687,160,165
160,166,194,0,0,0,0,194,160,166
160,167,0,0,546,0,0,546,160,167
160,171,0,0,0,619,0,619,160,171
160,176,670,0,0,0,0,670,160,176
160,181,0,0,302,0,0,302,160,181
160,228,0,0,495,0,0,495,160,228
160,242,0,0,155,0,0,155,160,242
160,246,0,0,113,0,0,113,160,246
160,254,22,0,0,0,0,22,160,254
161,2,0,0,628,0,0,628,161,2
161,5,0,0,270,0,0,270,161,5
161,9,77,0,0,0,0,77,161,9
161,11,23,0,0,0,0,23,161,11
161,13,877,0,0,0,0,877,161,13
161,14,0,0,41,0,0,41,161,14
161,15,719,0,0,0,0,719,161,15
161,22,0,0,29,0,0,29,161,22
161,23,0,0,590,0,0,590,161,23
161,27,1188,0,307,0,0,1495,161,27
161,30,0,0,296,0,0,296,161,30
161,34,39,0,0,0,0,39,161,34
161,39,547,0,0,0,0,547,161,39
161,40,643,0,0,0,0,643,161,40
161,42,74,0,0,0,0,74,161,42
161,48,73,0,0,0,0,73,161,48
161,55,0,0,270,0,0,270,161,55
161,57,0,0,307,0,0,307,161,57
161,65,116,0,0,0,0,116,161,65
161,70,0,0,294,0,0,294,161,70
161,90,0,0,0,62,0,62,161,90
161,109,0,0,671,0,0,671,161,109
161,121,0,0,442,0,0,442,161,121
161,122,0,0,364,0,0,364,161,122
161,125,0,0,686,0,0,686,161,125
161,126,449,0,0,0,0,449,161,126
161,128,727,0,0,0,0,727,161,128
161,135,565,0,0,0,0,565,161,135
161,137,0,0,807,0,0,807,161,137
161,138,2128,0,47,0,0,2175,161,138
161,147,0,0,130,0,0,130,161,147
161,150,1088,0,500,0,0,1588,161,150
161,152,187,0,0,0,0,187,161,152
161,153,0,0,0,270,0,270,161,153
161,154,727,0,1082,0,0,1809,161,154
161,156,140,0,0,921,0,1061,161,156
161,158,0,0,294,0,0,294,161,158
161,159,4604,0,858,0,0,5462,161,159
161,160,4146,334,1771,694,0,6945,161,160
161,161,13309,41444,2107,363,4407,61630,161,161
161,162,697,1581,1000,1490,849,5617,161,162
161,163,0,0,294,0,0,294,161,163
161,164,0,0,59,0,856,915,161,164
161,165,0,0,33,0,0,33,161,165
161,166,270,0,642,0,0,912,161,166
161,167,0,0,605,0,0,605,161,167
161,169,26,506,397,0,0,929,161,169
161,170,643,459,0,46,0,1148,161,170
161,173,16,0,0,0,0,16,161,173
161,174,0,0,233,357,0,590,161,174
161,176,988,0,0,0,0,988,161,176
161,180,630,0,686,0,0,1316,161,180
161,182,0,0,403,0,0,403,161,182
161,184,159,0,0,0,0,159,161,184
161,190,0,0,364,0,0,364,161,190
161,191,0,0,600,0,0,600,161,191
161,194,0,0,274,0,0,274,161,194
161,206,0,0,528,0,0,528,161,206
161,207,0,0,445,0,0,445,161,207
161,208,268,0,334,0,0,602,161,208
161,210,97,0,0,0,0,97,161,210
161,211,0,0,564,0,0,564,161,211
161,214,0,0,197,0,0,197,161,214
161,216,439,0,0,0,0,439,161,216
161,218,0,0,738,0,0,738,161,218
161,221,0,0,0,297,0,297,161,221
161,227,0,0,1080,0,0,1080,161,227
161,229,0,0,450,0,0,450,161,229
161,266,0,0,196,0,0,196,161,266
161,267,0,0,299,0,0,299,161,267
161,303,26,0,0,494,0,520,161,303
161,321,111,0,0,0,0,111,161,321
161,333,0,0,0,135,0,135,161,333
161,338,295,0,0,0,0,295,161,338
162,1,0,0,325,0,0,325,162,1
162,6,0,0,87,0,0,87,162,6
162,7,0,0,100,0,0,100,162,7
162,9,26,0,0,0,0,26,162,9
162,10,0,0,266,0,0,266,162,10
162,11,32,0,0,0,0,32,162,11
162,12,0,83,63,0,0,146,162,12
162,14,0,0,257,0,0,257,162,14
162,15,0,0,257,0,0,257,162,15
162,16,0,0,660,0,0,660,162,16
162,20,0,0,0,43,0,43,162,20
162,30,91,0,0,0,0,91,162,30
162,38,394,29,39,0,0,462,162,38
162,39,0,0,337,0,0,337,162,39
162,40,120,0,10,0,0,130,162,40
162,41,417,0,257,0,0,674,162,41
162,42,0,0,72,0,342,414,162,42
162,43,0,0,315,0,0,315,162,43
162,46,404,0,0,0,0,404,162,46
162,48,0,0,162,0,0,162,162,48
162,54,6,0,0,0,0,6,162,54
162,64,95,0,0,0,0,95,162,64
162,73,0,0,25,0,0,25,162,73
162,74,98,0,0,0,0,98,162,74
162,76,0,0,340,0,0,340,162,76
162,79,0,0,65,0,0,65,162,79
162,84,0,0,43,0,0,43,162,84
162,88,253,0,0,0,0,253,162,88
162,93,0,0,239,0,0,239,162,93
162,116,0,0,584,0,0,584,162,116
162,128,50,0,267,0,0,317,162,128
162,129,236,0,0,0,0,236,162,129
162,131,237,0,0,0,0,237,162,131
162,132,129,0,0,0,0,129,162,132
162,133,0,0,542,0,0,542,162,133
162,136,0,0,0,162,0,162,162,136
162,140,0,0,373,0,0,373,162,140
162,144,0,0,67,0,0,67,162,144
162,147,0,0,130,0,0,130,162,147
162,148,0,0,798,0,0,798,162,148
162,153,642,0,0,0,0,642,162,153
162,154,0,0,325,0,0,325,162,154
162,155,0,0,256,53,0,309,162,155
162,156,0,0,132,416,0,548,162,156
162,157,427,0,167,0,0,594,162,157
162,159,0,0,1052,404,0,1456,162,159
162,160,656,4855,1258,734,0,7503,162,160
162,161,332,1978,569,1490,849,5218,162,161
162,162,2425,11244,65,615,0,14349,162,162
162,163,3239,114,71,0,0,3424,162,163
162,164,748,703,432,442,0,2325,162,164
162,165,25,0,0,0,0,25,162,165
162,166,628,0,683,0,0,1311,162,166
162,167,62,0,43,0,0,105,162,167
162,169,34,0,77,0,0,111,162,169
162,170,0,0,499,0,0,499,162,170
162,171,91,0,0,0,0,91,162,171
162,180,0,0,776,0,0,776,162,180
162,183,303,0,0,0,0,303,162,183
162,185,0,0,351,0,0,351,162,185
162,187,0,0,0,342,0,342,162,187
162,193,0,0,278,0,0,278,162,193
162,202,0,0,483,0,0,483,162,202
162,203,0,0,289,0,0,289,162,203
162,209,0,0,507,0,0,507,162,209
162,212,0,0,58,0,0,58,162,212
162,213,236,0,0,0,0,236,162,213
162,214,846,0,0,0,0,846,162,214
162,218,0,0,424,0,0,424,162,218
162,226,0,0,607,0,0,607,162,226
162,227,618,0,0,0,0,618,162,227
162,231,0,0,165,0,0,165,162,231
162,232,0,0,494,0,0,494,162,232
162,233,311,0,0,0,0,311,162,233
162,241,0,0,190,0,0,190,162,241
162,244,0,0,195,0,0,195,162,244
162,263,582,0,0,0,0,582,162,263
162,264,518,0,0,0,0,518,162,264
162,278,251,0,430,0,0,681,162,278
162,292,60,0,0,0,0,60,162,292
162,307,0,0,325,0,0,325,162,307
162,309,153,0,0,0,0,153,162,309
162,318,0,0,67,0,0,67,162,318
162,321,111,0,0,0,0,111,162,321
162,327,0,0,30,0,0,30,162,327
162,339,0,0,313,0,0,313,162,339
163,1,0,0,914,0,0,914,163,1
163,5,0,0,238,0,0,238,163,5
163,10,0,0,676,0,0,676,163,10
163,11,0,0,49,0,0,49,163,11
163,12,0,0,0,590,0,590,163,12
163,13,0,0,100,0,0,100,163,13
163,17,0,0,24,0,0,24,163,17
163,19,114,0,0,0,0,114,163,19
163,23,0,0,114,0,0,114,163,23
163,29,0,0,477,0,0,477,163,29
163,32,0,0,336,0,0,336,163,32
163,34,2876,0,0,0,0,2876,163,34
163,38,0,18,58,0,0,76,163,38
163,39,0,0,914,0,0,914,163,39
163,40,18,0,0,0,0,18,163,40
163,49,0,0,0,50,0,50,163,49
163,59,0,0,65,0,0,65,163,59
163,63,0,0,621,0,0,621,163,63
163,68,0,0,676,0,0,676,163,68
163,70,621,0,953,0,0,1574,163,70
163,73,0,0,953,0,0,953,163,73
163,78,238,0,0,0,0,238,163,78
163,81,0,0,621,0,0,621,163,81
163,84,353,0,0,0,0,353,163,84
163,88,138,0,32,0,0,170,163,88
163,93,28,0,1155,0,0,1183,163,93
163,100,92,0,0,0,0,92,163,100
163,105,0,0,299,0,0,299,163,105
163,108,336,0,0,0,0,336,163,108
163,112,167,0,287,0,0,454,163,112
163,116,0,0,0,407,0,407,163,116
163,126,362,0,0,0,0,362,163,126
163,127,320,0,0,0,0,320,163,127
163,128,336,0,238,0,0,574,163,128
163,129,3142,0,124,0,0,3266,163,129
163,130,352,0,42,0,0,394,163,130
163,131,1497,0,0,0,0,1497,163,131
163,132,621,0,0,0,0,621,163,132
163,134,968,0,0,0,0,968,163,134
163,135,876,761,351,2852,1271,6111,163,135
163,136,0,0,17,0,0,17,163,136
163,137,0,0,914,0,0,914,163,137
163,138,0,0,238,0,0,238,163,138
163,144,0,0,897,0,0,897,163,144
163,151,313,0,0,0,0,313,163,151
163,152,5523,601,190,0,272,6586,163,152
163,154,844,0,245,0,0,1089,163,154
163,158,0,3899,976,0,0,4875,163,158
163,159,445,0,328,0,0,773,163,159
163,160,365,0,1221,0,0,1586,163,160
163,161,0,0,294,0,0,294,163,161
163,162,3239,114,71,0,0,3424,163,162
163,163,12626,11244,2351,359,3813,30393,163,163
163,164,772,302,0,38,251,1363,163,164
163,165,168,18,1446,111,0,1743,163,165
163,166,2271,0,0,0,0,2271,163,166
163,167,0,0,676,0,0,676,163,167
163,169,0,0,914,0,0,914,163,169
163,170,298,0,0,0,0,298,163,170
163,176,453,0,0,0,0,453,163,176
163,188,293,0,0,0,0,293,163,188
163,193,151,0,0,0,0,151,163,193
163,198,0,0,298,0,0,298,163,198
163,199,0,0,621,0,0,621,163,199
163,227,618,0,0,0,0,618,163,227
163,237,0,0,176,0,0,176,163,237
163,254,561,0,0,0,0,561,163,254
163,275,0,62,0,0,0,62,163,275
163,304,336,0,0,0,0,336,163,304
163,341,277,0,0,125,0,402,163,341
164,2,32,0,59,0,0,91,164,2
164,5,0,0,47,0,0,47,164,5
164,6,0,0,111,0,79,190,164,6
164,8,0,0,80,0,0,80,164,8
164,9,92,0,0,0,0,92,164,9
164,10,8,0,53,0,0,61,164,10
164,11,163,0,0,0,0,163,164,11
164,12,0,178,59,0,125,362,164,12
164,13,0,0,106,0,0,106,164,13
164,14,0,0,31,0,0,31,164,14
164,16,0,0,59,0,0,59,164,16
164,24,63,0,55,0,0,118,164,24
164,27,0,0,43,0,0,43,164,27
164,28,0,0,109,0,0,109,164,28
164,38,0,18,0,22,0,40,164,38
164,39,221,0,64,0,0,285,164,39
164,40,0,0,80,0,27,107,164,40
164,42,55,0,94,0,0,149,164,42
164,48,922,0,0,0,0,922,164,48
164,49,0,0,55,0,0,55,164,49
164,52,32,0,0,0,0,32,164,52
164,63,0,0,35,0,0,35,164,63
164,68,0,0,32,55,0,87,164,68
164,69,0,0,64,0,0,64,164,69
164,76,28,0,0,0,0,28,164,76
164,81,55,0,0,55,0,110,164,81
164,91,0,0,74,0,0,74,164,91
164,92,0,0,59,0,0,59,164,92
164,94,52,0,0,0,0,52,164,94
164,100,0,0,60,0,0,60,164,100
164,105,49,0,0,0,0,49,164,105
164,110,55,0,0,0,0,55,164,110
164,113,32,0,0,0,0,32,164,113
164,129,0,0,94,0,0,94,164,129
164,131,0,7,0,0,0,7,164,131
164,135,55,0,597,0,0,652,164,135
164,138,0,0,35,0,0,35,164,138
164,152,267,0,0,0,0,267,164,152
164,154,396,0,162,0,0,558,164,154
164,156,0,0,547,0,0,547,164,156
164,158,55,0,35,0,0,90,164,158
164,159,0,0,326,0,0,326,164,159
164,160,556,1733,0,0,0,2289,164,160
164,161,0,0,0,0,856,856,164,161
164,162,793,665,432,374,0,2264,164,162
164,163,747,271,0,38,251,1307,164,163
164,164,637,2480,0,0,125,3242,164,164
164,165,175,484,94,0,57,810,164,165
164,173,28,0,0,0,0,28,164,173
164,174,0,0,0,276,0,276,164,174
164,180,458,0,0,0,0,458,164,180
164,188,225,0,0,0,0,225,164,188
164,213,0,0,431,0,0,431,164,213
164,229,1060,0,557,0,0,1617,164,229
164,230,0,0,377,0,0,377,164,230
164,252,0,0,137,0,0,137,164,252
164,263,743,0,0,0,0,743,164,263
164,275,396,0,0,0,0,396,164,275
164,300,0,0,0,32,0,32,164,300
164,316,174,0,0,0,0,174,164,316
165,1,0,0,72,0,0,72,165,1
165,2,88,0,32,0,0,120,165,2
165,4,0,0,32,0,0,32,165,4
165,5,0,0,32,30,0,62,165,5
165,6,0,0,32,0,0,32,165,6
165,7,0,0,229,0,0,229,165,7
165,8,0,0,0,45,0,45,165,8
165,9,0,141,40,0,0,181,165,9
165,12,64,0,0,0,0,64,165,12
165,14,32,0,17,0,0,49,165,14
165,15,53,0,0,0,0,53,165,15
165,16,0,0,129,0,0,129,165,16
165,18,66,0,124,0,0,190,165,18
165,19,0,0,128,0,0,128,165,19
165,23,0,0,19,0,0,19,165,23
165,24,0,0,336,0,0,336,165,24
165,27,93,0,0,0,0,93,165,27
165,30,0,0,0,47,0,47,165,30
165,31,32,0,498,0,0,530,165,31
165,32,0,0,0,21,0,21,165,32
165,34,0,0,0,39,0,39,165,34
165,39,0,87,0,0,0,87,165,39
165,40,0,0,27,0,0,27,165,40
165,42,93,0,26,32,0,151,165,42
165,43,0,0,106,0,0,106,165,43
165,53,0,0,25,0,0,25,165,53
165,58,0,0,100,0,0,100,165,58
165,62,32,0,0,0,0,32,165,62
165,66,0,0,0,32,0,32,165,66
165,67,0,0,69,0,0,69,165,67
165,69,0,0,35,0,0,35,165,69
165,72,176,0,0,0,0,176,165,72
165,73,227,0,0,0,0,227,165,73
165,75,0,0,35,0,0,35,165,75
165,77,0,0,30,0,0,30,165,77
165,81,56,0,0,0,0,56,165,81
165,87,0,0,142,0,0,142,165,87
165,88,18,0,0,0,0,18,165,88
165,90,0,0,0,25,0,25,165,90
165,109,0,0,1238,0,0,1238,165,109
165,116,0,0,348,0,0,348,165,116
165,122,0,0,163,0,0,163,165,122
165,126,261,0,0,0,0,261,165,126
165,128,12,0,0,0,0,12,165,128
165,129,1054,67,134,0,0,1255,165,129
165,130,49,42,0,0,0,91,165,130
165,131,239,173,0,0,0,412,165,131
165,133,62,0,35,0,0,97,165,133
165,134,0,0,972,0,0,972,165,134
165,135,212,0,0,994,0,1206,165,135
165,136,0,0,20,0,0,20,165,136
165,142,0,0,298,0,0,298,165,142
165,144,30,0,67,0,0,97,165,144
165,147,63,0,130,0,0,193,165,147
165,150,324,0,0,0,0,324,165,150
165,151,727,0,0,0,0,727,165,151
165,152,0,0,762,0,0,762,165,152
165,153,152,0,0,68,0,220,165,153
165,154,0,0,98,0,0,98,165,154
165,156,0,0,471,0,0,471,165,156
165,157,154,0,0,0,0,154,165,157
165,158,0,0,1773,1058,0,2831,165,158
165,159,522,0,1711,0,0,2233,165,159
165,160,108,0,0,579,0,687,165,160
165,161,0,0,33,0,0,33,165,161
165,162,0,38,0,0,0,38,165,162
165,163,231,18,449,111,0,809,165,163
165,164,214,457,59,0,57,787,165,164
165,165,407,3632,0,64,0,4103,165,165
165,172,0,0,0,258,0,258,165,172
165,174,372,0,0,0,0,372,165,174
165,175,0,0,247,0,0,247,165,175
165,177,0,0,80,0,0,80,165,177
165,181,0,0,447,0,0,447,165,181
165,184,185,0,0,0,0,185,165,184
165,187,0,0,220,0,0,220,165,187
165,194,0,0,139,0,0,139,165,194
165,208,0,0,826,0,0,826,165,208
165,220,0,0,184,0,0,184,165,220
165,221,0,0,35,0,0,35,165,221
165,222,0,0,128,0,0,128,165,222
165,249,0,0,483,0,0,483,165,249
165,255,740,0,0,0,0,740,165,255
165,260,0,0,267,0,0,267,165,260
165,268,161,0,0,0,0,161,165,268
165,269,0,0,0,396,0,396,165,269
165,274,0,0,546,0,0,546,165,274
165,300,25,0,0,0,0,25,165,300
165,303,0,0,58,0,0,58,165,303
165,307,0,0,298,0,0,298,165,307
165,312,32,0,0,0,0,32,165,312
165,317,14,0,0,0,0,14,165,317
165,328,0,0,32,0,0,32,165,328
165,329,0,0,0,51,0,51,165,329
165,332,646,0,0,0,0,646,165,332
165,336,0,0,320,0,0,320,165,336
165,338,295,0,0,0,0,295,165,338
165,342,0,0,373,0,0,373,165,342
166,1,201,0,568,330,0,1099,166,1
166,2,85,0,792,0,0,877,166,2
166,3,0,0,368,0,0,368,166,3
166,5,0,0,763,0,0,763,166,5
166,8,38,0,0,0,0,38,166,8
166,11,0,0,21,0,0,21,166,11
166,16,0,0,273,0,0,273,166,16
166,17,660,0,25,201,0,886,166,17
166,18,0,0,143,0,0,143,166,18
166,25,0,0,74,0,0,74,166,25
166,27,60,0,0,0,0,60,166,27
166,30,64,0,0,0,0,64,166,30
166,32,0,0,294,0,0,294,166,32
166,35,0,0,247,0,0,247,166,35
166,36,0,0,531,0,0,531,166,36
166,39,0,0,85,0,0,85,166,39
166,40,270,0,279,0,0,549,166,40
166,41,417,0,0,0,0,417,166,41
166,43,669,0,145,0,0,814,166,43
166,45,1306,0,0,0,0,1306,166,45
166,46,0,0,440,521,0,961,166,46
166,47,2215,0,0,0,0,2215,166,47
166,48,0,498,318,0,0,816,166,48
166,49,147,0,105,0,0,252,166,49
166,52,103,0,0,0,0,103,166,52
166,53,330,0,166,0,0,496,166,53
166,54,63,0,0,0,0,63,166,54
166,58,0,0,100,0,0,100,166,58
166,59,628,0,0,0,0,628,166,59
166,62,0,0,330,0,0,330,166,62
166,63,0,0,25,0,0,25,166,63
166,65,116,0,0,0,0,116,166,65
166,68,201,0,0,0,0,201,166,68
166,73,201,0,546,0,0,747,166,73
166,78,102,0,0,0,0,102,166,78
166,79,0,0,185,0,0,185,166,79
166,81,0,0,0,275,0,275,166,81
166,84,330,0,51,0,0,381,166,84
166,87,0,0,560,0,0,560,166,87
166,93,0,0,258,0,0,258,166,93
166,94,108,0,0,0,0,108,166,94
166,115,201,0,0,0,0,201,166,115
166,128,0,0,201,0,0,201,166,128
166,129,330,0,35,28,0,393,166,129
166,131,116,0,0,0,0,116,166,131
166,141,0,0,531,0,0,531,166,141
166,144,0,0,807,0,0,807,166,144
166,155,0,0,57,0,0,57,166,155
166,160,194,0,0,0,0,194,166,160
166,161,286,0,642,0,0,928,166,161
166,162,1256,0,47,239,0,1542,166,162
166,163,1795,0,0,0,0,1795,166,163
166,166,4050,8339,718,2209,0,15316,166,166
166,167,1929,6787,1184,227,0,10127,166,167
166,168,709,1992,225,663,0,3589,166,168
166,169,806,307,46,447,0,1606,166,169
166,170,143,0,436,153,0,732,166,170
166,171,0,0,0,258,0,258,166,171
166,173,7,0,287,0,0,294,166,173
166,175,330,0,323,0,0,653,166,175
166,177,0,0,44,0,0,44,166,177
166,180,23,0,818,0,0,841,166,180
166,183,0,0,282,0,0,282,166,183
166,184,362,0,0,0,0,362,166,184
166,185,0,0,164,0,0,164,166,185
166,187,0,0,691,0,0,691,166,187
166,189,201,0,333,0,0,534,166,189
166,190,0,0,966,0,0,966,166,190
166,194,127,0,0,0,0,127,166,194
166,195,0,0,674,0,0,674,166,195
166,196,0,0,258,0,0,258,166,196
166,197,95,0,284,0,0,379,166,197
166,198,0,0,299,0,0,299,166,198
166,199,0,0,1108,0,0,1108,166,199
166,200,0,0,222,0,0,222,166,200
166,202,0,0,2559,444,0,3003,166,202
166,203,0,0,484,0,0,484,166,203
166,204,0,0,835,0,0,835,166,204
166,208,905,3816,514,1870,0,7105,166,208
166,209,2486,0,413,2078,0,4977,166,209
166,210,1828,656,127,214,0,2825,166,210
166,211,676,0,1238,0,0,1914,166,211
166,212,0,0,53,0,0,53,166,212
166,213,485,0,910,848,0,2243,166,213
166,214,628,0,249,0,0,877,166,214
166,215,467,0,644,0,0,1111,166,215
166,216,336,0,0,0,0,336,166,216
166,217,0,0,589,0,0,589,166,217
166,218,872,0,689,0,0,1561,166,218
166,219,594,0,0,0,0,594,166,219
166,221,72,0,0,0,0,72,166,221
166,222,441,0,0,0,0,441,166,222
166,225,0,0,580,0,0,580,166,225
166,226,0,0,1173,1042,0,2215,166,226
166,227,0,0,1656,0,0,1656,166,227
166,228,0,0,560,0,0,560,166,228
166,229,0,0,1244,0,0,1244,166,229
166,230,0,0,709,0,0,709,166,230
166,232,0,0,341,0,0,341,166,232
166,233,311,0,1287,0,0,1598,166,233
166,234,0,0,1031,0,0,1031,166,234
166,235,0,0,1109,0,0,1109,166,235
166,236,205,0,0,0,0,205,166,236
166,238,102,0,0,0,0,102,166,238
166,239,0,0,218,0,0,218,166,239
166,242,0,0,250,0,0,250,166,242
166,245,0,0,127,0,0,127,166,245
166,253,0,0,26,0,0,26,166,253
166,254,521,0,0,0,0,521,166,254
166,255,0,0,113,0,0,113,166,255
166,257,0,0,486,0,0,486,166,257
166,261,166,0,0,0,0,166,166,261
166,264,0,0,287,536,0,823,166,264
166,265,934,0,212,343,0,1489,166,265
166,266,0,0,0,327,0,327,166,266
166,267,0,0,476,549,0,1025,166,267
166,275,0,0,274,0,0,274,166,275
166,278,0,0,395,0,0,395,166,278
166,300,0,0,273,0,0,273,166,300
166,318,103,0,0,0,0,103,166,318
166,329,0,0,660,0,0,660,166,329
166,336,0,0,181,0,0,181,166,336
166,339,330,0,0,0,0,330,166,339
166,340,0,0,519,0,0,519,166,340
167,1,0,0,159,0,0,159,167,1
167,2,0,0,154,0,0,154,167,2
167,3,305,0,0,0,0,305,167,3
167,5,0,0,33,154,0,187,167,5
167,14,0,0,41,0,0,41,167,14
167,15,0,0,53,0,0,53,167,15
167,16,460,0,252,0,0,712,167,16
167,17,372,0,0,0,0,372,167,17
167,18,0,0,294,0,0,294,167,18
167,20,76,0,254,0,0,330,167,20
167,23,531,0,158,0,0,689,167,23
167,25,0,0,0,349,0,349,167,25
167,27,0,0,106,0,0,106,167,27
167,28,0,0,142,0,0,142,167,28
167,30,0,0,47,0,0,47,167,30
167,31,0,0,158,0,0,158,167,31
167,33,15,0,0,0,0,15,167,33
167,34,716,0,30,0,0,746,167,34
167,36,0,0,466,0,0,466,167,36
167,40,366,28,101,33,0,528,167,40
167,41,0,0,281,52,0,333,167,41
167,42,711,0,0,0,0,711,167,42
167,43,745,45,212,284,0,1286,167,43
167,44,214,0,0,0,0,214,167,44
167,45,73,0,416,0,0,489,167,45
167,46,1047,345,230,0,0,1622,167,46
167,47,440,0,117,0,0,557,167,47
167,48,285,463,79,0,0,827,167,48
167,49,158,0,0,0,0,158,167,49
167,54,416,0,0,0,0,416,167,54
167,58,0,0,389,0,0,389,167,58
167,63,0,0,318,0,0,318,167,63
167,65,116,0,0,0,0,116,167,65
167,66,120,0,0,0,0,120,167,66
167,67,80,0,0,0,0,80,167,67
167,68,0,0,121,0,0,121,167,68
167,73,315,0,142,0,0,457,167,73
167,76,77,0,0,0,0,77,167,76
167,80,0,0,455,0,0,455,167,80
167,82,0,0,227,0,0,227,167,82
167,87,0,0,69,0,0,69,167,87
167,91,0,0,142,0,0,142,167,91
167,93,0,0,935,0,0,935,167,93
167,99,0,0,280,0,0,280,167,99
167,101,0,0,295,0,0,295,167,101
167,103,95,0,0,0,0,95,167,103
167,110,0,0,439,0,0,439,167,110
167,113,0,0,269,0,0,269,167,113
167,116,0,0,312,0,0,312,167,116
167,117,2091,0,0,0,0,2091,167,117
167,124,0,0,823,0,0,823,167,124
167,128,0,0,10,0,0,10,167,128
167,130,0,0,30,0,0,30,167,130
167,131,0,0,7,0,0,7,167,131
167,133,0,0,456,0,0,456,167,133
167,134,233,0,0,0,0,233,167,134
167,135,72,0,0,0,0,72,167,135
167,138,0,0,44,0,0,44,167,138
167,150,1224,0,0,0,0,1224,167,150
167,157,0,0,0,368,0,368,167,157
167,158,1058,0,0,0,0,1058,167,158
167,160,0,0,546,0,0,546,167,160
167,161,0,0,605,0,0,605,167,161
167,162,245,0,0,0,0,245,167,162
167,163,0,0,676,0,0,676,167,163
167,165,116,0,0,0,0,116,167,165
167,166,1678,6787,927,227,0,9619,167,166
167,167,2304,10809,155,551,0,13819,167,167
167,168,1245,3315,0,0,0,4560,167,168
167,169,757,160,442,34,0,1393,167,169
167,170,0,0,580,317,0,897,167,170
167,173,0,0,234,0,0,234,167,173
167,174,0,0,372,0,0,372,167,174
167,176,381,0,634,0,0,1015,167,176
167,177,0,0,48,30,0,78,167,177
167,180,0,0,686,0,0,686,167,180
167,181,767,0,0,0,0,767,167,181
167,182,0,0,691,0,0,691,167,182
167,184,181,0,0,0,0,181,167,184
167,185,164,0,730,0,0,894,167,185
167,186,0,0,106,0,0,106,167,186
167,187,0,0,623,0,0,623,167,187
167,190,13,0,508,0,0,521,167,190
167,191,158,0,0,0,0,158,167,191
167,192,0,0,0,637,0,637,167,192
167,195,214,0,223,0,0,437,167,195
167,197,95,0,446,0,0,541,167,197
167,198,275,0,269,0,0,544,167,198
167,200,0,0,252,0,0,252,167,200
167,202,0,0,3376,0,0,3376,167,202
167,203,0,0,614,0,0,614,167,203
167,204,0,0,678,0,0,678,167,204
167,205,0,0,1942,0,0,1942,167,205
167,206,0,0,528,0,0,528,167,206
167,207,0,0,213,0,0,213,167,207
167,208,2586,0,2197,268,660,5711,167,208
167,209,620,0,337,0,0,957,167,209
167,210,1573,234,581,0,0,2388,167,210
167,211,323,0,2287,0,0,2610,167,211
167,213,793,0,0,0,0,793,167,213
167,214,158,0,392,0,0,550,167,214
167,215,99,0,1232,0,0,1331,167,215
167,216,0,0,967,0,0,967,167,216
167,217,0,0,241,0,0,241,167,217
167,218,964,0,695,0,0,1659,167,218
167,219,0,0,1223,0,0,1223,167,219
167,220,0,0,322,0,0,322,167,220
167,221,594,0,78,0,0,672,167,221
167,222,445,0,154,0,0,599,167,222
167,225,0,0,268,0,0,268,167,225
167,226,0,0,1059,0,0,1059,167,226
167,228,0,0,161,155,0,316,167,228
167,229,0,0,1328,0,0,1328,167,229
167,230,0,0,2626,0,0,2626,167,230
167,231,0,0,320,0,0,320,167,231
167,232,780,0,390,0,0,1170,167,232
167,234,0,0,116,0,0,116,167,234
167,237,0,0,115,0,0,115,167,237
167,241,0,0,247,0,0,247,167,241
167,242,0,0,368,0,0,368,167,242
167,252,0,0,254,0,0,254,167,252
167,253,0,0,23,79,0,102,167,253
167,254,107,0,788,0,0,895,167,254
167,255,0,0,805,0,0,805,167,255
167,258,758,0,0,0,0,758,167,258
167,260,0,0,0,396,0,396,167,260
167,261,694,0,0,0,0,694,167,261
167,262,0,0,572,0,0,572,167,262
167,264,483,0,416,0,0,899,167,264
167,265,0,0,739,0,0,739,167,265
167,267,153,0,0,0,0,153,167,267
167,272,55,0,0,0,0,55,167,272
167,274,0,0,168,0,0,168,167,274
167,307,0,0,298,0,0,298,167,307
167,311,0,0,81,0,0,81,167,311
167,316,158,0,227,0,0,385,167,316
167,318,0,0,110,0,0,110,167,318
167,319,63,0,0,0,0,63,167,319
167,321,111,0,0,0,0,111,167,321
167,323,0,0,436,0,0,436,167,323
167,329,51,0,0,0,0,51,167,329
167,333,0,0,115,0,0,115,167,333
168,1,0,0,533,0,0,533,168,1
168,6,257,0,257,0,0,514,168,6
168,7,0,0,222,0,0,222,168,7
168,12,23,0,0,0,0,23,168,12
168,13,0,0,110,0,0,110,168,13
168,15,0,10,33,0,0,43,168,15
168,16,0,0,284,0,0,284,168,16
168,23,0,0,207,0,0,207,168,23
168,24,0,0,207,0,0,207,168,24
168,27,0,0,204,0,0,204,168,27
168,28,0,0,340,0,0,340,168,28
168,29,0,0,313,0,0,313,168,29
168,31,128,0,479,0,0,607,168,31
168,35,408,0,134,0,0,542,168,35
168,38,70,0,0,0,0,70,168,38
168,39,144,0,422,227,0,793,168,39
168,40,0,0,360,0,0,360,168,40
168,41,638,121,57,0,0,816,168,41
168,42,0,0,57,0,0,57,168,42
168,43,298,51,60,0,0,409,168,43
168,44,0,0,225,0,0,225,168,44
168,45,199,0,0,0,0,199,168,45
168,46,0,0,225,0,0,225,168,46
168,47,107,0,0,0,0,107,168,47
168,48,0,0,107,126,0,233,168,48
168,49,0,0,333,0,0,333,168,49
168,57,0,0,204,0,0,204,168,57
168,59,0,0,267,0,0,267,168,59
168,62,0,0,230,0,0,230,168,62
168,66,58,0,0,0,0,58,168,66
168,67,0,0,80,0,0,80,168,67
168,74,0,0,98,0,0,98,168,74
168,77,0,0,204,0,0,204,168,77
168,78,0,0,0,207,0,207,168,78
168,79,0,0,601,0,0,601,168,79
168,80,0,0,98,0,0,98,168,80
168,82,204,0,0,0,0,204,168,82
168,83,204,0,154,0,0,358,168,83
168,84,0,0,0,199,0,199,168,84
168,85,0,0,11,0,0,11,168,85
168,92,0,0,0,4,0,4,168,92
168,93,0,0,449,0,0,449,168,93
168,100,229,0,0,0,0,229,168,100
168,106,0,0,98,0,0,98,168,106
168,116,0,0,165,0,0,165,168,116
168,122,626,0,0,0,0,626,168,122
168,128,0,0,10,0,0,10,168,128
168,135,204,0,0,0,0,204,168,135
168,140,0,0,899,0,0,899,168,140
168,141,0,0,427,0,0,427,168,141
168,144,0,0,742,0,0,742,168,144
168,153,239,0,0,0,0,239,168,153
168,166,408,1992,506,663,0,3569,168,166
168,167,1579,3028,0,0,0,4607,168,167
168,168,3530,10533,217,0,0,14280,168,168
168,169,1541,1755,676,509,0,4481,168,169
168,170,455,0,819,0,0,1274,168,170
168,171,0,0,526,0,0,526,168,171
168,172,0,0,258,0,0,258,168,172
168,174,0,0,718,0,0,718,168,174
168,176,1826,0,729,0,0,2555,168,176
168,177,46,0,0,0,0,46,168,177
168,180,752,0,0,0,0,752,168,180
168,181,0,0,419,0,0,419,168,181
168,184,0,0,173,0,0,173,168,184
168,186,0,0,106,0,0,106,168,186
168,189,0,0,293,0,0,293,168,189
168,193,0,0,151,0,0,151,168,193
168,197,0,0,1090,0,0,1090,168,197
168,199,0,0,881,0,0,881,168,199
168,200,0,0,372,0,0,372,168,200
168,203,0,0,753,0,0,753,168,203
168,204,0,0,893,0,0,893,168,204
168,205,0,0,473,0,0,473,168,205
168,207,0,0,445,0,0,445,168,207
168,208,817,0,893,204,0,1914,168,208
168,211,0,0,1100,0,0,1100,168,211
168,213,986,0,0,0,0,986,168,213
168,214,0,0,204,0,0,204,168,214
168,215,204,0,0,0,0,204,168,215
168,216,0,0,219,0,0,219,168,216
168,217,0,0,361,0,0,361,168,217
168,219,0,0,189,0,0,189,168,219
168,220,0,0,184,0,0,184,168,220
168,221,373,0,0,0,0,373,168,221
168,222,610,0,328,0,0,938,168,222
168,225,0,0,268,306,0,574,168,225
168,228,0,0,301,0,0,301,168,228
168,229,101,0,0,0,0,101,168,229
168,254,109,0,0,0,0,109,168,254
168,256,817,0,0,0,0,817,168,256
168,257,204,0,0,0,0,204,168,257
168,263,121,0,634,0,0,755,168,263
168,265,238,0,373,0,0,611,168,265
168,266,0,0,196,0,0,196,168,266
168,309,0,0,153,0,0,153,168,309
168,329,0,0,51,0,0,51,168,329
168,331,0,0,206,0,0,206,168,331
168,334,101,0,0,0,0,101,168,334
168,341,0,0,204,0,0,204,168,341
168,342,98,0,0,0,0,98,168,342
169,1,0,0,251,0,0,251,169,1
169,2,0,0,90,0,0,90,169,2
169,3,0,0,202,0,0,202,169,3
169,5,0,0,360,0,0,360,169,5
169,6,245,0,0,0,0,245,169,6
169,10,0,0,11,0,0,11,169,10
169,12,0,0,83,0,0,83,169,12
169,13,202,0,0,0,0,202,169,13
169,14,0,0,541,0,0,541,169,14
169,15,202,0,58,0,0,260,169,15
169,17,67,0,0,0,0,67,169,17
169,18,124,0,0,0,0,124,169,18
169,24,657,0,0,0,0,657,169,24
169,27,447,0,0,0,0,447,169,27
169,28,0,0,35,0,0,35,169,28
169,35,153,0,0,0,0,153,169,35
169,40,0,0,157,0,0,157,169,40
169,41,11,0,0,0,0,11,169,41
169,42,0,0,86,24,0,110,169,42
169,43,77,0,0,0,0,77,169,43
169,44,565,0,378,0,0,943,169,44
169,45,756,0,388,0,0,1144,169,45
169,46,0,0,0,126,0,126,169,46
169,47,107,0,0,0,0,107,169,47
169,48,0,0,162,0,0,162,169,48
169,49,42,0,0,0,0,42,169,49
169,52,202,0,42,0,0,244,169,52
169,55,202,0,0,0,0,202,169,55
169,56,76,0,0,0,0,76,169,56
169,58,0,0,100,0,0,100,169,58
169,60,202,0,0,0,0,202,169,60
169,62,75,0,27,0,0,102,169,62
169,64,0,0,457,0,0,457,169,64
169,69,0,0,60,0,0,60,169,69
169,72,202,0,0,0,0,202,169,72
169,73,34,0,202,0,0,236,169,73
169,74,0,0,26,0,0,26,169,74
169,76,77,0,0,0,0,77,169,76
169,78,0,0,34,0,0,34,169,78
169,82,0,0,76,0,0,76,169,82
169,83,0,0,42,0,0,42,169,83
169,86,0,0,84,0,0,84,169,86
169,96,0,0,67,0,0,67,169,96
169,113,0,0,0,90,0,90,169,113
169,129,0,0,41,0,0,41,169,129
169,134,202,0,0,0,0,202,169,134
169,138,0,0,420,0,0,420,169,138
169,139,0,0,97,0,0,97,169,139
169,151,0,0,1606,0,0,1606,169,151
169,157,154,0,0,0,0,154,169,157
169,161,26,506,397,0,0,929,169,161
169,162,34,0,288,0,0,322,169,162
169,166,1164,307,46,447,0,1964,169,166
169,167,757,160,308,34,0,1259,169,167
169,168,1339,1732,465,575,0,4111,169,168
169,169,4051,8794,197,281,0,13323,169,169
169,170,462,370,202,0,653,1687,169,170
169,171,0,0,1064,0,0,1064,169,171
169,172,0,0,238,0,0,238,169,172
169,174,0,0,389,0,0,389,169,174
169,175,0,0,629,0,0,629,169,175
169,177,0,0,130,0,0,130,169,177
169,180,1077,0,2270,0,0,3347,169,180
169,182,672,0,771,141,0,1584,169,182
169,185,351,0,0,0,0,351,169,185
169,186,0,0,146,0,0,146,169,186
169,187,0,0,282,0,0,282,169,187
169,188,0,0,790,0,0,790,169,188
169,189,0,0,578,0,0,578,169,189
169,192,0,0,571,0,0,571,169,192
169,193,73,0,0,0,0,73,169,193
169,194,0,0,523,0,0,523,169,194
169,195,0,0,530,0,0,530,169,195
169,196,0,0,367,0,0,367,169,196
169,200,0,0,382,0,0,382,169,200
169,201,0,0,669,0,0,669,169,201
169,203,0,0,153,0,0,153,169,203
169,204,0,0,330,0,0,330,169,204
169,205,0,0,412,0,0,412,169,205
169,206,0,0,2605,0,0,2605,169,206
169,208,665,358,222,528,0,1773,169,208
169,210,202,0,280,0,0,482,169,210
169,213,194,0,445,0,0,639,169,213
169,214,0,0,380,0,0,380,169,214
169,216,0,0,444,0,0,444,169,216
169,217,0,0,508,0,0,508,169,217
169,218,727,0,2518,0,0,3245,169,218
169,219,0,0,1507,0,0,1507,169,219
169,222,0,0,1361,0,0,1361,169,222
169,225,0,0,363,0,0,363,169,225
169,226,0,0,1670,0,0,1670,169,226
169,229,0,0,2281,0,0,2281,169,229
169,230,0,0,1058,0,0,1058,169,230
169,231,42,0,0,0,0,42,169,231
169,232,0,0,1249,0,0,1249,169,232
169,233,0,0,671,0,0,671,169,233
169,246,202,0,0,0,0,202,169,246
169,250,404,0,0,0,0,404,169,250
169,255,196,0,885,0,0,1081,169,255
169,256,0,0,126,0,0,126,169,256
169,261,0,0,739,0,0,739,169,261
169,262,0,0,1318,0,0,1318,169,262
169,263,0,0,808,0,0,808,169,263
169,264,414,0,833,0,0,1247,169,264
169,265,0,0,743,0,0,743,169,265
169,267,0,0,299,0,0,299,169,267
169,272,0,0,136,0,0,136,169,272
169,275,0,0,334,0,0,334,169,275
169,292,0,0,509,0,0,509,169,292
169,293,0,0,869,0,0,869,169,293
169,300,0,0,34,0,0,34,169,300
169,301,0,0,202,0,0,202,169,301
169,319,14,0,0,0,0,14,169,319
169,322,0,0,121,0,0,121,169,322
169,329,0,0,0,50,0,50,169,329
169,339,0,0,194,0,0,194,169,339
170,1,0,0,305,0,0,305,170,1
170,2,46,0,0,0,0,46,170,2
170,5,0,0,295,0,0,295,170,5
170,7,0,0,106,0,0,106,170,7
170,9,0,0,0,295,0,295,170,9
170,10,0,0,295,0,0,295,170,10
170,12,0,0,395,0,0,395,170,12
170,14,731,0,499,0,0,1230,170,14
170,16,0,0,81,0,0,81,170,16
170,19,146,0,0,0,0,146,170,19
170,23,0,0,32,0,0,32,170,23
170,31,0,0,295,0,0,295,170,31
170,34,0,0,39,0,0,39,170,34
170,35,0,0,98,0,0,98,170,35
170,36,0,0,295,0,0,295,170,36
170,38,70,0,70,0,0,140,170,38
170,40,295,0,0,0,0,295,170,40
170,43,0,0,654,0,0,654,170,43
170,46,0,0,228,0,0,228,170,46
170,60,274,0,0,0,0,274,170,60
170,65,644,0,0,0,0,644,170,65
170,74,0,0,143,0,0,143,170,74
170,75,0,0,436,0,0,436,170,75
170,84,0,0,47,0,0,47,170,84
170,91,0,0,437,0,0,437,170,91
170,98,21,0,0,0,0,21,170,98
170,104,21,0,0,0,0,21,170,104
170,105,50,0,0,0,0,50,170,105
170,106,0,0,143,0,0,143,170,106
170,108,0,0,155,0,0,155,170,108
170,128,21,0,0,0,0,21,170,128
170,132,0,0,45,0,0,45,170,132
170,133,0,0,143,0,0,143,170,133
170,135,0,0,731,0,0,731,170,135
170,158,0,0,570,0,0,570,170,158
170,159,0,0,1534,0,0,1534,170,159
170,161,643,459,0,0,0,1102,170,161
170,162,0,0,499,0,0,499,170,162
170,163,298,0,0,0,0,298,170,163
170,166,696,0,218,153,0,1067,170,166
170,167,0,0,580,317,0,897,170,167
170,168,101,0,819,0,0,920,170,168
170,169,473,370,202,0,653,1698,170,169
170,170,874,19554,898,2030,0,23356,170,170
170,171,2753,2040,2766,836,0,8395,170,171
170,172,1111,0,1717,121,0,2949,170,172
170,173,7,0,353,0,0,360,170,173
170,174,0,0,1052,0,0,1052,170,174
170,175,1226,0,1831,0,0,3057,170,175
170,176,998,0,986,1241,0,3225,170,176
170,177,357,103,996,166,184,1806,170,177
170,180,0,0,1255,0,0,1255,170,180
170,181,0,0,499,1618,0,2117,170,181
170,182,403,0,1030,0,0,1433,170,182
170,183,459,0,307,0,0,766,170,183
170,185,351,0,179,0,0,530,170,185
170,186,97,0,120,0,0,217,170,186
170,187,0,0,371,0,0,371,170,187
170,188,0,0,318,0,0,318,170,188
170,189,144,0,397,0,0,541,170,189
170,190,0,0,283,282,0,565,170,190
170,191,0,0,678,0,0,678,170,191
170,192,0,0,652,0,0,652,170,192
170,194,121,0,282,0,0,403,170,194
170,195,0,0,242,0,0,242,170,195
170,198,0,0,499,0,0,499,170,198
170,199,541,0,457,0,0,998,170,199
170,201,0,0,603,0,0,603,170,201
170,202,1520,0,47,0,0,1567,170,202
170,206,0,0,428,0,0,428,170,206
170,209,0,0,965,0,0,965,170,209
170,211,0,0,812,0,0,812,170,211
170,214,740,0,519,0,0,1259,170,214
170,215,234,0,436,493,0,1163,170,215
170,216,355,0,219,0,0,574,170,216
170,217,604,0,422,0,0,1026,170,217
170,218,295,0,1334,0,0,1629,170,218
170,219,0,0,295,0,0,295,170,219
170,220,0,0,308,0,0,308,170,220
170,222,223,0,797,0,0,1020,170,222
170,225,0,0,236,0,0,236,170,225
170,230,625,0,498,0,0,1123,170,230
170,240,0,0,221,0,0,221,170,240
170,252,0,0,92,0,0,92,170,252
170,260,0,0,458,0,0,458,170,260
170,261,695,0,0,0,0,695,170,261
170,264,0,0,563,0,0,563,170,264
170,266,0,0,124,0,0,124,170,266
170,300,0,0,0,211,0,211,170,300
170,312,0,0,155,0,0,155,170,312
170,330,164,0,0,0,0,164,170,330
171,1,0,0,126,0,0,126,171,1
171,3,0,0,247,0,0,247,171,3
171,26,526,0,0,0,0,526,171,26
171,27,0,0,268,0,0,268,171,27
171,28,247,0,0,0,0,247,171,28
171,30,91,0,0,0,0,91,171,30
171,35,0,0,526,0,0,526,171,35
171,36,0,0,131,0,0,131,171,36
171,39,0,0,292,0,0,292,171,39
171,40,247,0,896,0,0,1143,171,40
171,43,228,0,0,0,0,228,171,43
171,44,621,0,0,0,0,621,171,44
171,45,1091,0,156,0,0,1247,171,45
171,56,0,0,572,0,0,572,171,56
171,64,1051,0,0,0,0,1051,171,64
171,69,0,0,526,0,0,526,171,69
171,81,526,0,939,0,0,1465,171,81
171,83,50,0,0,0,0,50,171,83
171,88,0,0,138,0,0,138,171,88
171,92,0,0,109,0,0,109,171,92
171,126,0,0,247,0,0,247,171,126
171,139,0,0,526,0,0,526,171,139
171,147,36,0,0,0,0,36,171,147
171,155,170,0,0,0,0,170,171,155
171,160,0,0,0,619,0,619,171,160
171,161,0,0,0,46,0,46,171,161
171,166,0,0,0,258,0,258,171,166
171,167,247,0,0,0,0,247,171,167
171,168,0,0,526,0,0,526,171,168
171,169,1277,0,1064,126,0,2467,171,169
171,170,2928,2806,2420,978,0,9132,171,170
171,171,2152,13373,7087,582,0,23194,171,171
171,172,2189,4503,1386,518,0,8596,171,172
171,173,0,0,1245,393,0,1638,171,173
171,174,0,0,0,315,0,315,171,174
171,175,978,0,1147,0,0,2125,171,175
171,176,1327,472,292,0,0,2091,171,176
171,177,203,0,67,91,0,361,171,177
171,180,0,0,686,0,0,686,171,180
171,181,0,0,788,247,0,1035,171,181
171,182,0,0,207,0,0,207,171,182
171,186,0,0,146,73,0,219,171,186
171,187,342,0,339,0,0,681,171,187
171,189,0,0,201,0,0,201,171,189
171,192,526,0,294,0,0,820,171,192
171,193,0,0,357,0,0,357,171,193
171,194,0,0,139,0,0,139,171,194
171,197,0,0,103,0,0,103,171,197
171,198,0,0,269,0,0,269,171,198
171,199,0,0,457,0,0,457,171,199
171,203,0,0,190,0,0,190,171,203
171,204,0,0,598,0,0,598,171,204
171,205,0,0,1630,0,0,1630,171,205
171,206,750,0,784,0,0,1534,171,206
171,210,0,0,391,0,0,391,171,210
171,213,0,0,409,0,0,409,171,213
171,215,0,1298,0,0,0,1298,171,215
171,216,301,0,269,0,0,570,171,216
171,217,989,0,0,0,0,989,171,217
171,218,942,0,0,0,0,942,171,218
171,219,0,0,975,0,0,975,171,219
171,231,236,0,0,0,0,236,171,231
171,235,247,0,0,0,0,247,171,235
171,236,0,0,526,0,0,526,171,236
171,241,0,0,247,0,0,247,171,241
171,258,0,0,674,0,0,674,171,258
171,266,158,0,0,0,0,158,171,266
171,300,395,0,0,0,0,395,171,300
171,330,0,0,704,0,0,704,171,330
172,1,0,0,121,0,0,121,172,1
172,2,516,0,0,0,0,516,172,2
172,5,0,0,475,0,0,475,172,5
172,7,0,0,700,0,0,700,172,7
172,10,0,0,88,0,0,88,172,10
172,14,0,0,88,0,0,88,172,14
172,17,0,0,259,0,0,259,172,17
172,24,0,0,214,0,0,214,172,24
172,31,282,0,0,0,0,282,172,31
172,40,0,0,121,0,0,121,172,40
172,43,0,0,476,0,0,476,172,43
172,44,0,0,0,129,0,129,172,44
172,53,238,0,0,0,0,238,172,53
172,60,258,0,0,0,0,258,172,60
172,67,0,0,258,0,0,258,172,67
172,69,0,0,258,0,0,258,172,69
172,74,0,0,258,0,0,258,172,74
172,76,34,0,0,0,0,34,172,76
172,79,0,0,533,0,0,533,172,79
172,80,0,0,496,0,0,496,172,80
172,82,258,0,258,0,0,516,172,82
172,93,0,0,200,0,0,200,172,93
172,109,0,0,258,0,0,258,172,109
172,129,35,0,0,0,0,35,172,129
172,144,701,0,0,0,0,701,172,144
172,165,0,0,0,258,0,258,172,165
172,166,7,0,0,0,0,7,172,166
172,167,0,0,678,0,0,678,172,167
172,169,0,0,238,0,0,238,172,169
172,170,1118,0,1216,121,0,2455,172,170
172,171,2189,4131,1386,518,0,8224,172,171
172,172,1532,5497,0,0,0,7029,172,172
172,173,1765,320,1041,0,902,4028,172,173
172,174,1024,0,0,0,0,1024,172,174
172,175,1875,803,242,0,0,2920,172,175
172,176,133,0,0,0,0,133,172,176
172,180,325,0,0,0,0,325,172,180
172,182,2413,1560,1721,0,0,5694,172,182
172,183,1197,0,259,623,0,2079,172,183
172,184,641,0,0,0,0,641,172,184
172,185,0,0,282,0,0,282,172,185
172,187,231,0,217,0,0,448,172,187
172,188,0,0,515,0,0,515,172,188
172,196,102,0,0,0,0,102,172,196
172,198,0,0,157,129,0,286,172,198
172,200,0,0,241,0,0,241,172,200
172,201,0,0,532,0,0,532,172,201
172,203,0,0,234,0,0,234,172,203
172,204,0,0,1081,0,0,1081,172,204
172,206,0,0,0,149,0,149,172,206
172,210,233,0,238,111,0,582,172,210
172,214,0,0,95,560,0,655,172,214
172,215,885,0,0,0,0,885,172,215
172,216,562,0,0,0,0,562,172,216
172,230,694,0,0,0,0,694,172,230
172,275,0,0,258,121,0,379,172,275
172,300,0,0,496,0,0,496,172,300
172,319,0,0,238,0,0,238,172,319
173,1,759,0,0,0,0,759,173,1
173,10,0,0,469,0,0,469,173,10
173,12,0,0,42,0,0,42,173,12
173,14,272,0,0,0,0,272,173,14
173,15,0,0,668,49,0,717,173,15
173,18,0,0,272,0,0,272,173,18
173,22,0,0,272,0,0,272,173,22
173,23,0,0,290,0,0,290,173,23
173,24,0,0,112,0,0,112,173,24
173,27,0,0,393,0,0,393,173,27
173,28,0,0,215,0,0,215,173,28
173,32,0,0,487,0,0,487,173,32
173,40,0,0,18,0,0,18,173,40
173,41,0,0,215,0,0,215,173,41
173,43,0,0,215,272,0,487,173,43
173,48,0,0,180,0,0,180,173,48
173,67,0,0,272,0,0,272,173,67
173,73,0,0,272,0,0,272,173,73
173,76,77,0,0,0,0,77,173,76
173,79,41,0,0,0,0,41,173,79
173,80,0,0,215,0,0,215,173,80
173,83,272,0,0,0,0,272,173,83
173,88,0,0,272,0,0,272,173,88
173,91,0,0,215,0,0,215,173,91
173,98,0,0,272,0,0,272,173,98
173,99,0,0,272,0,0,272,173,99
173,164,28,0,0,0,0,28,173,164
173,166,31,0,272,0,0,303,173,166
173,167,0,0,234,0,0,234,173,167
173,170,0,0,353,0,0,353,173,170
173,171,0,0,1245,393,0,1638,173,171
173,172,1798,301,196,392,902,3589,173,172
173,173,1405,13508,0,481,0,15394,173,173
173,174,0,300,0,357,0,657,173,174
173,180,272,0,0,0,0,272,173,180
173,181,0,0,373,0,0,373,173,181
173,182,530,544,196,0,0,1270,173,182
173,183,1331,0,0,288,0,1619,173,183
173,191,0,0,449,0,0,449,173,191
173,192,0,0,301,0,0,301,173,192
173,205,0,0,1028,0,0,1028,173,205
173,208,215,0,311,0,0,526,173,208
173,209,466,0,0,0,0,466,173,209
173,213,412,0,0,0,0,412,173,213
173,215,0,0,393,0,0,393,173,215
173,216,0,544,0,0,0,544,173,216
173,217,363,2251,395,0,0,3009,173,217
173,218,0,1475,671,0,0,2146,173,218
173,221,0,0,53,0,0,53,173,221
173,225,0,0,146,0,0,146,173,225
173,227,0,0,50,0,0,50,173,227
173,276,393,0,0,0,0,393,173,276
173,328,0,0,272,0,0,272,173,328
174,1,357,0,0,0,0,357,174,1
174,14,0,0,389,0,0,389,174,14
174,24,229,0,372,0,0,601,174,24
174,26,728,0,728,0,0,1456,174,26
174,35,0,0,277,0,0,277,174,35
174,36,0,0,389,0,0,389,174,36
174,41,0,0,429,0,0,429,174,41
174,42,0,0,300,0,0,300,174,42
174,45,0,0,389,0,0,389,174,45
174,56,0,0,357,0,0,357,174,56
174,63,0,0,357,0,0,357,174,63
174,68,0,0,372,0,0,372,174,68
174,72,0,0,0,315,0,315,174,72
174,73,0,0,282,0,0,282,174,73
174,76,357,0,0,0,0,357,174,76
174,79,0,0,117,0,0,117,174,79
174,82,0,0,357,0,0,357,174,82
174,92,0,0,329,0,0,329,174,92
174,93,0,0,372,0,0,372,174,93
174,99,0,0,699,0,0,699,174,99
174,136,0,0,357,0,0,357,174,136
174,151,372,0,0,0,0,372,174,151
174,152,372,0,0,0,0,372,174,152
174,156,357,0,0,0,0,357,174,156
174,161,0,0,233,357,0,590,174,161
174,162,0,0,0,276,0,276,174,162
174,165,372,0,0,0,0,372,174,165
174,167,372,0,372,0,0,744,174,167
174,168,0,0,718,0,0,718,174,168
174,169,0,0,1304,0,0,1304,174,169
174,170,0,0,663,0,0,663,174,170
174,171,0,0,0,315,0,315,174,171
174,172,325,0,0,699,0,1024,174,172
174,173,0,300,0,357,0,657,174,173
174,174,2340,25904,5613,4932,0,38789,174,174
174,175,247,1797,645,371,0,3060,174,175
174,176,635,0,0,791,0,1426,174,176
174,180,1424,6277,483,954,1014,10152,174,180
174,181,0,0,405,0,0,405,174,181
174,182,0,3818,689,0,0,4507,174,182
174,184,807,185,0,0,0,992,174,184
174,185,0,0,0,234,0,234,174,185
174,186,97,0,0,0,0,97,174,186
174,191,0,0,440,0,0,440,174,191
174,193,72,0,0,0,0,72,174,193
174,199,315,0,0,0,0,315,174,199
174,203,190,0,0,0,0,190,174,203
174,204,0,0,389,0,0,389,174,204
174,210,0,0,440,0,0,440,174,210
174,214,0,0,389,0,0,389,174,214
174,217,0,0,1460,0,0,1460,174,217
174,218,0,277,0,0,0,277,174,218
174,219,0,0,302,0,0,302,174,219
174,236,0,0,761,0,0,761,174,236
174,237,0,0,357,0,0,357,174,237
174,240,0,0,357,0,0,357,174,240
174,247,357,0,0,0,0,357,174,247
174,250,0,0,0,277,0,277,174,250
174,264,0,0,300,0,0,300,174,264
174,269,0,0,139,0,0,139,174,269
174,272,0,0,372,0,0,372,174,272
174,312,0,0,257,0,0,257,174,312
174,342,0,0,357,0,0,357,174,342
175,1,0,0,236,0,0,236,175,1
175,5,0,0,1069,0,0,1069,175,5
175,6,0,0,608,0,0,608,175,6
175,14,0,0,297,0,0,297,175,14
175,16,0,0,269,0,0,269,175,16
175,17,0,0,312,0,0,312,175,17
175,27,0,0,241,0,0,241,175,27
175,30,0,0,236,0,0,236,175,30
175,32,0,0,247,0,0,247,175,32
175,36,0,0,247,0,0,247,175,36
175,39,0,0,244,0,0,244,175,39
175,58,0,0,297,0,0,297,175,58
175,79,0,0,241,0,0,241,175,79
175,99,0,0,312,0,0,312,175,99
175,106,0,0,0,545,0,545,175,106
175,135,0,0,312,0,0,312,175,135
175,166,330,0,323,0,0,653,175,166
175,169,0,236,61,0,0,297,175,169
175,170,991,0,1280,236,0,2507,175,170
175,171,1164,0,1268,0,0,2432,175,171
175,172,1628,803,0,0,0,2431,175,172
175,174,247,1983,645,186,0,3061,175,174
175,175,6075,18901,508,2047,0,27531,175,175
175,176,483,2241,1027,1046,0,4797,175,176
175,177,0,0,162,117,0,279,175,177
175,180,495,0,1372,475,0,2342,175,180
175,181,0,0,269,0,0,269,175,181
175,182,0,908,0,652,0,1560,175,182
175,192,242,0,0,0,0,242,175,192
175,196,0,0,367,0,0,367,175,196
175,198,0,0,242,0,0,242,175,198
175,201,0,0,523,0,0,523,175,201
175,203,190,0,0,0,0,190,175,203
175,205,384,0,0,0,0,384,175,205
175,228,247,0,0,0,0,247,175,228
175,239,0,0,551,0,0,551,175,239
175,278,312,0,0,0,0,312,175,278
175,300,0,0,0,495,0,495,175,300
175,320,0,0,249,0,0,249,175,320
176,2,0,0,453,0,0,453,176,2
176,3,0,0,670,0,0,670,176,3
176,6,453,0,0,0,0,453,176,6
176,7,0,0,493,0,0,493,176,7
176,11,0,0,21,0,0,21,176,11
176,14,0,0,71,0,0,71,176,14
176,16,1123,0,0,0,0,1123,176,16
176,17,0,0,64,0,0,64,176,17
176,23,0,0,453,0,0,453,176,23
176,28,0,0,670,0,0,670,176,28
176,39,0,0,57,0,0,57,176,39
176,43,394,0,0,0,0,394,176,43
176,54,66,0,0,0,0,66,176,54
176,62,228,0,0,0,0,228,176,62
176,73,228,0,0,0,0,228,176,73
176,74,0,0,228,0,0,228,176,74
176,83,0,0,1252,0,0,1252,176,83
176,94,0,0,582,0,0,582,176,94
176,107,0,0,453,0,0,453,176,107
176,128,10,0,0,0,0,10,176,128
176,135,0,0,394,0,0,394,176,135
176,147,36,0,0,0,0,36,176,147
176,160,670,0,0,0,0,670,176,160
176,161,988,0,0,0,0,988,176,161
176,163,453,0,0,0,0,453,176,163
176,167,0,0,634,0,0,634,176,167
176,168,1826,0,729,0,0,2555,176,168
176,170,998,0,986,1241,0,3225,176,170
176,171,1656,175,292,0,0,2123,176,171
176,172,133,0,0,0,0,133,176,172
176,174,635,0,0,791,0,1426,176,174
176,175,483,2241,1350,805,0,4879,176,175
176,176,4074,16082,0,2747,0,22903,176,176
176,177,613,675,0,281,0,1569,176,177
176,180,134,0,428,0,0,562,176,180
176,181,0,0,302,0,0,302,176,181
176,182,403,0,248,0,0,651,176,182
176,184,185,0,0,0,0,185,176,184
176,186,0,0,106,0,0,106,176,186
176,187,463,0,249,0,0,712,176,187
176,191,112,0,0,0,0,112,176,191
176,202,1507,0,483,0,0,1990,176,202
176,208,228,0,292,0,0,520,176,208
176,216,0,0,216,0,0,216,176,216
176,263,0,0,0,287,0,287,176,263
176,269,0,0,139,0,0,139,176,269
176,300,0,0,582,0,0,582,176,300
176,339,0,0,582,0,0,582,176,339
177,1,0,0,133,0,0,133,177,1
177,2,46,0,97,0,0,143,177,2
177,6,0,0,46,0,0,46,177,6
177,10,0,0,50,0,0,50,177,10
177,14,0,0,95,0,0,95,177,14
177,15,0,0,62,0,0,62,177,15
177,18,0,0,50,0,0,50,177,18
177,23,0,0,152,0,0,152,177,23
177,30,0,0,91,0,0,91,177,30
177,32,0,0,136,0,0,136,177,32
177,38,0,0,50,0,0,50,177,38
177,39,284,0,0,0,0,284,177,39
177,40,0,0,103,0,0,103,177,40
177,41,44,0,0,0,0,44,177,41
177,43,0,0,0,0,66,66,177,43
177,48,0,0,103,0,0,103,177,48
177,65,46,0,0,0,0,46,177,65
177,76,56,0,0,0,0,56,177,76
177,91,0,0,91,0,0,91,177,91
177,121,189,0,0,0,0,189,177,121
177,129,0,0,62,0,0,62,177,129
177,165,0,0,80,0,0,80,177,165
177,167,0,0,48,30,0,78,177,167
177,168,91,0,0,0,0,91,177,168
177,169,0,0,130,0,0,130,177,169
177,170,433,103,996,120,184,1836,177,170
177,171,175,0,67,91,0,333,177,171
177,175,46,91,331,72,0,540,177,175
177,176,446,756,153,307,0,1662,177,176
177,177,273,4149,0,72,0,4494,177,177
177,180,0,189,0,0,0,189,177,180
177,184,193,0,0,0,0,193,177,184
177,187,0,0,242,0,0,242,177,187
177,196,95,0,0,0,0,95,177,196
177,197,0,0,48,0,0,48,177,197
177,209,0,0,50,0,0,50,177,209
177,221,0,0,48,0,0,48,177,221
177,241,0,0,103,0,0,103,177,241
177,280,0,0,46,0,0,46,177,280
177,300,0,0,50,0,0,50,177,300
177,319,0,0,29,0,0,29,177,319
177,340,0,0,95,0,0,95,177,340
178,16,0,0,129,0,0,129,178,16
178,32,0,0,21,0,0,21,178,32
178,33,15,0,0,0,0,15,178,33
178,41,0,0,30,0,0,30,178,41
178,49,0,0,100,0,0,100,178,49
178,66,308,0,0,0,0,308,178,66
178,68,102,0,0,0,0,102,178,68
178,84,0,0,141,0,0,141,178,84
178,103,0,0,45,0,0,45,178,103
178,131,8,0,0,0,0,8,178,131
178,180,0,1266,0,0,0,1266,178,180
178,206,0,0,891,0,0,891,178,206
178,302,0,0,76,0,0,76,178,302
178,319,14,0,0,0,0,14,178,319
178,320,0,0,249,0,0,249,178,320
178,339,0,0,302,0,0,302,178,339
178,340,0,0,21,0,0,21,178,340
178,341,37,0,0,0,0,37,178,341
180,2,0,0,66,0,0,66,180,2
180,7,630,0,0,630,0,1260,180,7
180,11,0,0,0,752,0,752,180,11
180,15,0,0,85,0,0,85,180,15
180,23,458,0,0,0,0,458,180,23
180,24,0,0,458,0,0,458,180,24
180,27,458,0,66,0,0,524,180,27
180,31,0,0,546,0,0,546,180,31
180,32,0,0,458,0,0,458,180,32
180,41,0,0,33,0,0,33,180,41
180,42,0,0,818,0,0,818,180,42
180,49,0,0,388,0,0,388,180,49
180,52,0,0,447,0,0,447,180,52
180,54,66,0,71,0,0,137,180,54
180,57,0,0,752,0,0,752,180,57
180,72,0,0,388,0,0,388,180,72
180,73,0,0,546,0,0,546,180,73
180,75,0,0,630,0,0,630,180,75
180,76,0,0,390,0,0,390,180,76
180,78,0,0,546,0,0,546,180,78
180,82,0,0,453,0,0,453,180,82
180,85,0,0,1107,0,0,1107,180,85
180,93,66,0,325,0,0,391,180,93
180,100,0,0,325,0,0,325,180,100
180,111,0,0,686,0,0,686,180,111
180,135,0,0,212,248,0,460,180,135
180,161,630,0,686,0,0,1316,180,161
180,162,0,0,686,0,0,686,180,162
180,164,458,0,0,0,0,458,180,164
180,166,0,0,818,0,0,818,180,166
180,167,0,0,686,0,0,686,180,167
180,168,752,0,0,0,0,752,180,168
180,169,325,0,1644,0,0,1969,180,169
180,170,0,0,1255,0,0,1255,180,170
180,171,752,0,686,0,0,1438,180,171
180,172,325,0,0,0,0,325,180,172
180,173,272,0,0,0,0,272,180,173
180,174,1424,6277,1165,954,1014,10834,180,174
180,175,495,0,1372,475,0,2342,180,175
180,176,134,0,428,0,0,562,180,176
180,177,0,189,0,0,0,189,180,177
180,178,0,1266,0,0,0,1266,180,178
180,180,5424,41494,4162,2657,0,53737,180,180
180,181,2219,4725,0,1129,0,8073,180,181
180,182,0,861,1258,0,0,2119,180,182
180,183,1681,0,0,0,0,1681,180,183
180,185,325,0,603,0,0,928,180,185
180,186,0,0,0,337,0,337,180,186
180,187,390,817,220,0,496,1923,180,187
180,188,630,0,498,0,0,1128,180,188
180,190,514,0,0,0,0,514,180,190
180,191,0,0,938,0,0,938,180,191
180,193,278,0,0,0,0,278,180,193
180,195,546,0,0,0,0,546,180,195
180,197,630,0,103,0,0,733,180,197
180,198,144,0,905,0,0,1049,180,198
180,203,440,0,0,0,0,440,180,203
180,209,0,0,954,0,0,954,180,209
180,210,0,0,228,0,0,228,180,210
180,215,234,0,498,0,0,732,180,215
180,216,1753,0,0,0,0,1753,180,216
180,254,0,0,752,0,0,752,180,254
180,313,0,0,353,0,0,353,180,313
181,2,0,0,599,0,0,599,181,2
181,6,0,0,419,0,0,419,181,6
181,7,0,0,71,0,0,71,181,7
181,14,0,0,34,0,0,34,181,14
181,15,0,0,208,0,0,208,181,15
181,17,147,0,0,0,0,147,181,17
181,27,447,0,1165,0,0,1612,181,27
181,32,105,0,0,0,0,105,181,32
181,37,0,0,447,0,0,447,181,37
181,40,0,0,114,0,0,114,181,40
181,41,447,0,0,0,0,447,181,41
181,54,0,0,14,0,0,14,181,54
181,58,0,0,1264,0,0,1264,181,58
181,74,0,0,140,0,0,140,181,74
181,79,105,0,0,0,0,105,181,79
181,81,0,0,551,0,0,551,181,81
181,82,277,0,0,0,0,277,181,82
181,93,0,0,888,0,0,888,181,93
181,136,888,0,0,0,0,888,181,136
181,165,0,0,447,0,0,447,181,165
181,166,315,0,0,0,0,315,181,166
181,167,452,0,0,0,0,452,181,167
181,168,0,0,419,0,0,419,181,168
181,170,380,0,1261,0,0,1641,181,170
181,171,0,0,788,247,0,1035,181,171
181,173,272,0,77,0,0,349,181,173
181,174,0,0,405,0,0,405,181,174
181,176,0,0,302,0,0,302,181,176
181,180,2471,4725,0,1129,0,8325,181,180
181,181,12861,16600,3008,2866,0,35335,181,181
181,182,257,403,302,0,0,962,181,182
181,183,798,638,260,0,0,1696,181,183
181,184,0,573,201,270,0,1044,181,184
181,185,0,259,435,274,0,968,181,185
181,186,261,701,115,401,0,1478,181,186
181,187,1018,2463,242,0,188,3911,181,187
181,188,976,277,260,0,0,1513,181,188
181,191,103,0,0,0,0,103,181,191
181,197,828,0,167,0,0,995,181,197
181,198,95,0,1387,0,0,1482,181,198
181,199,0,0,567,0,0,567,181,199
181,201,447,0,0,0,0,447,181,201
181,203,190,0,207,0,0,397,181,203
181,205,0,0,448,0,0,448,181,205
181,207,0,0,436,0,0,436,181,207
181,208,0,0,112,0,0,112,181,208
181,210,277,0,445,0,0,722,181,210
181,218,0,0,239,0,0,239,181,218
181,221,656,0,0,0,0,656,181,221
181,225,0,0,146,0,0,146,181,225
181,239,0,0,486,0,0,486,181,239
181,322,154,0,0,0,0,154,181,322
182,1,0,0,90,0,0,90,182,1
182,4,0,0,473,0,0,473,182,4
182,5,0,0,1877,0,0,1877,182,5
182,7,473,0,0,0,0,473,182,7
182,12,53,0,0,0,0,53,182,12
182,26,88,0,0,0,0,88,182,26
182,27,0,0,60,0,0,60,182,27
182,29,0,0,473,0,0,473,182,29
182,34,403,0,0,0,0,403,182,34
182,40,0,0,912,0,0,912,182,40
182,53,0,0,277,0,0,277,182,53
182,60,0,0,473,0,0,473,182,60
182,64,657,0,0,0,0,657,182,64
182,77,0,0,473,0,0,473,182,77
182,130,473,0,0,0,0,473,182,130
182,161,0,0,439,0,0,439,182,161
182,167,0,0,691,0,0,691,182,167
182,169,147,0,839,141,0,1127,182,169
182,170,403,0,1030,0,0,1433,182,170
182,171,526,0,207,0,0,733,182,171
182,172,2685,442,2533,0,0,5660,182,172
182,173,530,272,196,0,0,998,182,173
182,174,0,4175,689,0,0,4864,182,174
182,175,0,908,0,652,0,1560,182,175
182,176,403,0,248,0,0,651,182,176
182,180,0,861,1258,0,0,2119,182,180
182,181,434,403,181,0,0,1018,182,181
182,182,0,11770,109,2308,0,14187,182,182
182,183,1460,3418,2106,977,0,7961,182,183
182,184,185,732,384,155,0,1456,182,184
182,187,231,0,0,222,0,453,182,187
182,194,0,0,178,0,0,178,182,194
182,195,0,0,399,0,0,399,182,195
182,196,0,0,367,0,0,367,182,196
182,197,0,0,618,0,0,618,182,197
182,198,0,0,267,0,0,267,182,198
182,199,473,0,0,0,0,473,182,199
182,205,0,0,858,0,0,858,182,205
182,206,0,0,256,0,0,256,182,206
182,208,473,0,0,0,0,473,182,208
182,214,0,0,650,0,0,650,182,214
182,215,0,0,256,0,0,256,182,215
182,217,724,0,0,0,0,724,182,217
182,221,0,0,0,0,527,527,182,221
182,227,408,0,0,0,0,408,182,227
182,229,0,0,313,0,0,313,182,229
182,230,473,0,0,0,0,473,182,230
182,258,0,0,501,0,0,501,182,258
182,271,403,0,0,0,0,403,182,271
182,300,0,0,511,0,0,511,182,300
182,316,0,0,439,0,0,439,182,316
182,320,0,0,274,0,0,274,182,320
183,1,0,0,325,0,0,325,183,1
183,6,0,0,84,0,0,84,183,6
183,13,0,0,84,0,0,84,183,13
183,14,0,0,329,0,0,329,183,14
183,16,0,0,961,0,0,961,183,16
183,23,0,0,282,0,0,282,183,23
183,25,0,0,961,0,0,961,183,25
183,27,0,0,282,0,0,282,183,27
183,28,0,0,91,0,0,91,183,28
183,36,0,0,1788,0,0,1788,183,36
183,40,0,0,485,0,0,485,183,40
183,43,0,0,303,0,0,303,183,43
183,68,0,0,84,0,0,84,183,68
183,79,0,0,894,0,0,894,183,79
183,83,84,0,0,0,0,84,183,83
183,148,0,0,361,0,0,361,183,148
183,151,0,0,392,0,0,392,183,151
183,162,303,0,0,0,0,303,183,162
183,166,0,0,282,0,0,282,183,166
183,170,0,0,805,0,0,805,183,170
183,172,1479,0,259,623,0,2361,183,172
183,173,1331,0,0,288,0,1619,183,173
183,180,1237,0,483,0,0,1720,183,180
183,181,454,638,260,0,0,1352,183,181
183,182,2410,3418,2106,977,0,8911,183,182
183,183,605,6923,2020,1650,1948,13146,183,183
183,184,185,1533,201,370,0,2289,183,184
183,185,282,0,985,0,0,1267,183,185
183,187,84,0,0,0,0,84,183,187
183,188,0,614,307,0,0,921,183,188
183,189,136,0,307,0,0,443,183,189
183,191,0,0,565,0,0,565,183,191
183,193,2231,623,0,287,0,3141,183,193
183,198,0,0,87,0,0,87,183,198
183,199,0,0,403,0,0,403,183,199
183,204,0,0,971,0,0,971,183,204
183,207,1788,0,1139,0,0,2927,183,207
183,208,0,0,894,0,0,894,183,208
183,209,466,0,0,0,0,466,183,209
183,210,0,0,303,0,0,303,183,210
183,214,0,0,898,0,0,898,183,214
183,216,43,0,0,0,0,43,183,216
183,217,1484,3368,263,25,0,5140,183,217
183,220,0,0,80,0,0,80,183,220
183,227,0,0,335,0,0,335,183,227
183,243,282,0,0,674,0,956,183,243
183,336,0,0,0,184,0,184,183,336
183,338,0,0,961,0,0,961,183,338
184,1,319,0,185,0,0,504,184,1
184,3,185,0,0,0,0,185,184,3
184,14,0,0,193,0,0,193,184,14
184,24,0,0,159,0,0,159,184,24
184,26,0,0,181,0,0,181,184,26
184,33,0,0,181,0,0,181,184,33
184,40,0,0,193,0,0,193,184,40
184,43,0,0,556,0,0,556,184,43
184,45,0,0,201,0,0,201,184,45
184,59,0,0,185,0,0,185,184,59
184,64,0,0,92,0,0,92,184,64
184,77,0,0,185,0,0,185,184,77
184,79,0,0,181,0,0,181,184,79
184,81,0,0,185,0,0,185,184,81
184,94,0,0,210,0,0,210,184,94
184,140,159,0,185,0,0,344,184,140
184,147,0,0,92,0,0,92,184,147
184,165,185,0,0,0,0,185,184,165
184,166,362,0,0,0,0,362,184,166
184,167,181,0,0,0,0,181,184,167
184,168,0,0,173,0,0,173,184,168
184,172,641,0,0,0,0,641,184,172
184,174,807,185,0,0,0,992,184,174
184,176,185,0,0,0,0,185,184,176
184,177,193,0,0,0,0,193,184,177
184,181,0,670,201,270,0,1141,184,181
184,182,185,732,384,155,0,1456,184,182
184,183,370,1903,0,370,0,2643,184,183
184,184,1238,14774,0,1451,0,17463,184,184
184,185,0,2447,382,0,0,2829,184,185
184,186,160,0,0,0,0,160,184,186
184,187,222,0,0,0,0,222,184,187
184,188,395,0,0,0,0,395,184,188
184,192,0,0,201,0,0,201,184,192
184,193,0,720,205,155,133,1213,184,193
184,195,0,0,228,0,0,228,184,195
184,197,333,0,363,0,0,696,184,197
184,198,0,0,201,0,0,201,184,198
184,201,1391,0,0,0,0,1391,184,201
184,204,0,0,228,0,0,228,184,204
184,205,718,0,448,0,0,1166,184,205
184,208,370,0,0,0,0,370,184,208
184,210,159,0,0,0,0,159,184,210
184,215,0,0,185,0,0,185,184,215
184,217,399,0,0,0,0,399,184,217
184,218,319,0,0,0,0,319,184,218
184,219,159,0,0,0,0,159,184,219
184,223,548,0,0,0,0,548,184,223
184,225,0,0,146,0,0,146,184,225
184,226,0,0,286,0,0,286,184,226
184,229,159,0,0,0,0,159,184,229
184,239,0,0,228,0,0,228,184,239
184,256,0,0,600,0,0,600,184,256
184,280,0,0,185,0,0,185,184,280
185,1,0,0,687,0,0,687,185,1
185,9,234,0,0,0,0,234,185,9
185,15,0,0,171,0,0,171,185,15
185,30,234,0,0,0,0,234,185,30
185,31,0,0,351,0,0,351,185,31
185,32,0,0,335,0,0,335,185,32
185,69,0,0,335,0,0,335,185,69
185,131,0,0,179,0,0,179,185,131
185,144,0,0,230,0,0,230,185,144
185,162,0,0,351,0,0,351,185,162
185,165,0,0,0,234,0,234,185,165
185,166,0,0,164,0,0,164,185,166
185,167,164,0,730,0,0,894,185,167
185,169,351,0,0,0,0,351,185,169
185,170,0,0,179,0,0,179,185,170
185,172,0,0,282,0,0,282,185,172
185,180,325,0,603,0,0,928,185,180
185,181,0,259,435,274,0,968,185,181
185,182,351,0,399,0,0,750,185,182
185,183,282,0,985,0,0,1267,185,183
185,184,0,2447,382,0,0,2829,185,184
185,185,0,5073,0,0,0,5073,185,185
185,186,97,1128,0,1384,0,2609,185,186
185,187,351,0,0,0,0,351,185,187
185,188,0,492,365,411,0,1268,185,188
185,189,0,0,193,0,0,193,185,189
185,190,0,0,254,0,0,254,185,190
185,192,0,363,0,0,0,363,185,192
185,194,0,904,121,0,0,1025,185,194
185,195,0,703,0,0,0,703,185,195
185,196,0,319,0,0,0,319,185,196
185,198,657,0,0,0,0,657,185,198
185,199,900,0,0,0,0,900,185,199
185,201,0,0,72,0,0,72,185,201
185,218,1744,0,1084,0,0,2828,185,218
185,254,0,0,351,0,0,351,185,254
185,300,351,0,0,0,0,351,185,300
186,1,0,0,160,0,0,160,186,1
186,5,0,0,97,0,0,97,186,5
186,14,0,0,106,0,0,106,186,14
186,27,0,0,73,0,0,73,186,27
186,32,0,0,53,0,0,53,186,32
186,39,0,0,0,97,0,97,186,39
186,40,0,0,244,0,0,244,186,40
186,45,0,0,106,0,0,106,186,45
186,46,73,0,73,0,0,146,186,46
186,49,0,0,101,0,0,101,186,49
186,70,97,0,0,0,0,97,186,70
186,80,0,0,73,0,0,73,186,80
186,82,0,0,272,0,0,272,186,82
186,88,0,0,97,0,0,97,186,88
186,97,0,0,101,0,0,101,186,97
186,111,0,0,232,0,0,232,186,111
186,167,0,0,252,0,0,252,186,167
186,168,0,0,106,0,0,106,186,168
186,170,0,0,226,0,0,226,186,170
186,171,0,0,146,73,0,219,186,171
186,174,97,0,0,0,0,97,186,174
186,176,0,0,106,0,0,106,186,176
186,180,0,0,0,337,0,337,186,180
186,181,261,603,115,401,0,1380,186,181
186,182,0,0,58,0,0,58,186,182
186,184,53,97,0,0,0,150,186,184
186,185,97,1128,0,1384,0,2609,186,185
186,186,0,3029,0,0,0,3029,186,186
186,187,88,0,0,0,0,88,186,187
186,188,97,244,460,244,0,1045,186,188
186,194,0,0,0,151,0,151,186,194
186,195,0,317,0,107,0,424,186,195
186,196,0,53,0,0,0,53,186,196
186,197,0,59,0,114,0,173,186,197
186,198,0,0,483,114,0,597,186,198
186,200,0,0,118,0,0,118,186,200
186,202,118,0,0,0,0,118,186,202
186,203,255,0,0,0,0,255,186,203
186,204,0,0,971,0,0,971,186,204
186,206,88,0,0,0,0,88,186,206
186,208,0,0,80,0,0,80,186,208
186,210,195,0,0,0,0,195,186,210
186,214,0,0,106,0,0,106,186,214
186,215,0,0,146,0,0,146,186,215
186,217,151,0,106,0,0,257,186,217
186,227,135,0,344,0,0,479,186,227
186,301,146,0,0,0,0,146,186,301
186,318,0,0,73,0,0,73,186,318
187,1,0,0,464,0,0,464,187,1
187,2,222,0,0,0,0,222,187,2
187,4,0,0,342,0,0,342,187,4
187,5,442,0,249,0,0,691,187,5
187,7,0,0,273,0,0,273,187,7
187,14,351,0,372,342,0,1065,187,14
187,17,0,0,130,0,0,130,187,17
187,18,0,0,273,0,0,273,187,18
187,27,0,0,455,0,0,455,187,27
187,28,0,0,361,0,0,361,187,28
187,29,0,0,222,0,0,222,187,29
187,36,0,0,202,0,0,202,187,36
187,42,0,0,249,0,0,249,187,42
187,43,0,0,202,0,0,202,187,43
187,45,0,0,799,0,0,799,187,45
187,46,0,0,222,0,0,222,187,46
187,53,0,0,796,0,0,796,187,53
187,68,0,0,242,0,0,242,187,68
187,79,0,0,222,0,0,222,187,79
187,93,222,0,311,0,0,533,187,93
187,100,0,0,273,0,0,273,187,100
187,101,0,0,222,0,0,222,187,101
187,110,0,0,0,222,0,222,187,110
187,135,0,0,222,0,0,222,187,135
187,153,0,0,222,0,0,222,187,153
187,162,0,0,0,342,0,342,187,162
187,165,0,0,220,0,0,220,187,165
187,166,311,0,691,0,0,1002,187,166
187,167,0,0,623,0,0,623,187,167
187,169,0,0,282,0,0,282,187,169
187,170,0,0,242,0,0,242,187,170
187,171,342,0,339,0,0,681,187,171
187,172,231,0,217,0,0,448,187,172
187,176,463,0,249,0,0,712,187,176
187,177,0,0,242,0,0,242,187,177
187,180,390,817,220,0,496,1923,187,180
187,181,623,2241,701,0,188,3753,187,181
187,182,231,0,0,222,0,453,187,182
187,183,84,0,0,0,0,84,187,183
187,184,222,0,0,0,0,222,187,184
187,186,88,0,0,0,0,88,187,186
187,187,809,22373,0,2434,644,26260,187,187
187,188,638,179,462,0,0,1279,187,188
187,189,0,0,141,0,0,141,187,189
187,191,0,0,141,0,0,141,187,191
187,192,0,0,182,463,0,645,187,192
187,193,231,0,0,0,0,231,187,193
187,194,135,0,0,311,0,446,187,194
187,195,0,0,399,0,0,399,187,195
187,196,0,0,462,0,0,462,187,196
187,197,845,540,103,136,0,1624,187,197
187,198,202,0,1894,179,0,2275,187,198
187,199,0,623,589,0,0,1212,187,199
187,205,384,0,1126,0,0,1510,187,205
187,210,0,0,273,0,0,273,187,210
187,217,0,0,0,444,0,444,187,217
187,218,0,0,339,0,0,339,187,218
187,223,0,0,242,0,0,242,187,223
187,225,0,0,242,0,0,242,187,225
187,226,0,0,242,0,0,242,187,226
187,240,0,0,273,0,0,273,187,240
187,275,0,0,342,0,0,342,187,275
187,315,0,0,242,0,0,242,187,315
188,5,0,0,293,0,0,293,188,5
188,14,0,0,782,0,0,782,188,14
188,23,0,0,569,0,0,569,188,23
188,28,0,0,38,0,0,38,188,28
188,29,0,0,175,0,0,175,188,29
188,35,0,0,133,0,0,133,188,35
188,38,18,0,0,0,0,18,188,38
188,40,0,0,115,0,0,115,188,40
188,45,0,0,98,0,0,98,188,45
188,59,0,0,225,0,0,225,188,59
188,66,0,0,277,0,0,277,188,66
188,68,0,0,245,0,0,245,188,68
188,78,102,0,0,0,0,102,188,78
188,81,56,0,0,0,0,56,188,81
188,93,0,0,732,0,0,732,188,93
188,94,259,0,0,0,0,259,188,94
188,121,0,0,0,152,0,152,188,121
188,123,0,0,647,0,0,647,188,123
188,130,293,0,0,0,0,293,188,130
188,134,518,0,0,0,0,518,188,134
188,138,0,0,71,0,0,71,188,138
188,163,293,0,0,0,0,293,188,163
188,164,225,0,0,0,0,225,188,164
188,167,0,0,154,0,0,154,188,167
188,169,0,0,790,0,0,790,188,169
188,170,0,0,318,0,0,318,188,170
188,172,0,0,515,0,0,515,188,172
188,180,630,0,498,0,0,1128,188,180
188,181,244,277,1056,0,0,1577,188,181
188,183,0,614,393,0,0,1007,188,183
188,184,395,0,197,0,0,592,188,184
188,185,0,492,365,411,0,1268,188,185
188,186,97,244,460,244,0,1045,188,186
188,187,638,179,462,0,0,1279,188,187
188,188,1688,16886,0,1847,0,20421,188,188
188,191,0,0,1416,0,0,1416,188,191
188,192,276,0,320,0,0,596,188,192
188,193,468,0,108,0,0,576,188,193
188,194,293,0,1172,0,0,1465,188,194
188,195,317,1161,263,254,0,1995,188,195
188,196,0,1307,471,924,0,2702,188,196
188,197,721,1550,504,1045,0,3820,188,197
188,198,225,47,1008,0,0,1280,188,198
188,199,547,0,2442,0,0,2989,188,199
188,200,0,0,280,0,158,438,188,200
188,201,3098,0,1106,0,0,4204,188,201
188,202,0,0,1515,0,0,1515,188,202
188,203,0,0,318,0,0,318,188,203
188,204,550,0,0,0,0,550,188,204
188,205,0,0,644,0,0,644,188,205
188,206,235,0,2200,0,0,2435,188,206
188,207,0,0,252,0,0,252,188,207
188,208,0,0,951,0,0,951,188,208
188,213,0,0,160,0,0,160,188,213
188,217,170,0,0,0,0,170,188,217
188,218,175,0,0,0,0,175,188,218
188,220,839,0,0,0,0,839,188,220
188,222,938,0,0,0,0,938,188,222
188,223,244,0,0,0,0,244,188,223
188,229,0,0,330,0,0,330,188,229
188,233,0,0,338,0,0,338,188,233
188,249,608,0,0,0,0,608,188,249
188,305,0,0,202,0,0,202,188,305
188,339,0,0,172,0,0,172,188,339
189,4,0,0,1146,0,0,1146,189,4
189,5,0,0,666,0,0,666,189,5
189,6,0,0,397,0,0,397,189,6
189,12,0,0,488,0,0,488,189,12
189,14,0,0,397,0,0,397,189,14
189,16,0,0,397,0,0,397,189,16
189,17,0,0,432,0,0,432,189,17
189,18,212,0,0,0,0,212,189,18
189,26,0,0,531,0,0,531,189,26
189,41,0,0,26,0,0,26,189,41
189,43,0,0,397,0,0,397,189,43
189,44,0,0,331,0,0,331,189,44
189,45,0,0,397,0,0,397,189,45
189,47,0,0,111,0,0,111,189,47
189,49,0,0,531,0,0,531,189,49
189,62,269,0,397,0,0,666,189,62
189,63,0,0,223,0,0,223,189,63
189,65,116,0,0,0,0,116,189,65
189,68,0,0,269,0,0,269,189,68
189,87,0,0,397,0,0,397,189,87
189,94,0,0,397,0,0,397,189,94
189,136,0,0,79,0,0,79,189,136
189,156,269,0,0,0,0,269,189,156
189,166,201,0,0,0,0,201,189,166
189,167,531,0,0,0,0,531,189,167
189,169,0,0,578,0,0,578,189,169
189,170,144,0,526,0,0,670,189,170
189,171,0,0,201,0,0,201,189,171
189,174,0,0,302,0,0,302,189,174
189,183,0,0,307,0,0,307,189,183
189,185,0,0,193,0,0,193,189,185
189,188,0,0,318,0,0,318,189,188
189,189,12389,23567,1587,0,0,37543,189,189
189,190,2103,501,1640,0,0,4244,189,190
189,191,0,0,863,0,0,863,189,191
189,192,555,0,382,251,0,1188,189,192
189,194,0,446,863,0,0,1309,189,194
189,195,1255,403,432,0,0,2090,189,195
189,196,1208,422,613,0,0,2243,189,196
189,198,0,0,962,0,0,962,189,198
189,202,754,0,51,0,0,805,189,202
189,203,405,965,527,485,0,2382,189,203
189,204,47,0,0,0,0,47,189,204
189,208,0,0,268,0,0,268,189,208
189,209,397,0,0,0,0,397,189,209
189,210,0,0,102,0,0,102,189,210
189,214,0,0,228,0,0,228,189,214
189,217,696,0,0,0,0,696,189,217
189,218,0,0,1230,0,0,1230,189,218
189,219,0,0,225,0,0,225,189,219
189,220,136,0,644,0,0,780,189,220
189,222,821,0,0,0,0,821,189,222
189,223,548,397,0,266,0,1211,189,223
189,224,0,269,0,0,0,269,189,224
189,225,1051,0,0,0,0,1051,189,225
189,226,3082,4315,2504,0,0,9901,189,226
189,227,0,0,59,0,0,59,189,227
189,228,455,0,2042,0,0,2497,189,228
189,229,0,0,313,0,0,313,189,229
189,230,0,0,333,0,0,333,189,230
189,231,0,0,162,0,0,162,189,231
189,232,0,0,654,0,0,654,189,232
189,269,0,0,269,0,0,269,189,269
189,298,0,0,371,0,0,371,189,298
190,1,244,0,0,0,0,244,190,1
190,2,0,0,550,0,0,550,190,2
190,4,0,0,244,0,0,244,190,4
190,5,0,0,282,0,0,282,190,5
190,6,102,0,0,0,0,102,190,6
190,7,253,0,0,0,0,253,190,7
190,17,0,0,421,0,0,421,190,17
190,18,282,0,282,0,0,564,190,18
190,23,0,0,282,0,0,282,190,23
190,28,38,0,0,0,0,38,190,28
190,32,105,0,0,0,0,105,190,32
190,48,0,0,307,0,0,307,190,48
190,53,0,0,345,0,0,345,190,53
190,57,0,0,563,0,0,563,190,57
190,62,0,0,27,0,0,27,190,62
190,64,514,0,0,0,0,514,190,64
190,65,0,0,364,0,0,364,190,65
190,83,0,0,364,0,0,364,190,83
190,86,0,0,244,0,0,244,190,86
190,93,487,0,244,0,0,731,190,93
190,156,0,0,122,0,0,122,190,156
190,161,0,0,364,0,0,364,190,161
190,165,0,0,20,0,0,20,190,165
190,166,0,0,977,0,0,977,190,166
190,167,0,0,105,0,0,105,190,167
190,170,0,0,283,282,0,565,190,170
190,174,0,0,761,0,0,761,190,174
190,185,0,0,254,0,0,254,190,185
190,186,0,0,106,0,0,106,190,186
190,188,388,0,0,0,0,388,190,188
190,189,2103,501,1640,0,0,4244,190,189
190,190,2291,11027,683,3234,0,17235,190,190
190,191,244,352,347,0,0,943,190,191
190,192,558,218,404,324,0,1504,190,192
190,193,0,0,236,0,0,236,190,193
190,194,0,127,1171,0,0,1298,190,194
190,195,214,703,495,0,0,1412,190,195
190,196,0,0,367,0,0,367,190,196
190,198,0,0,946,0,0,946,190,198
190,199,1057,0,501,0,0,1558,190,199
190,201,603,0,424,0,0,1027,190,201
190,203,0,0,1009,0,0,1009,190,203
190,204,489,0,598,0,0,1087,190,204
190,205,0,0,644,0,0,644,190,205
190,206,0,0,111,0,0,111,190,206
190,209,0,0,198,0,0,198,190,209
190,210,0,0,458,0,0,458,190,210
190,213,487,0,0,0,0,487,190,213
190,214,0,0,267,0,0,267,190,214
190,215,421,0,0,751,0,1172,190,215
190,216,0,0,195,0,0,195,190,216
190,217,0,0,395,0,0,395,190,217
190,218,244,0,0,0,0,244,190,218
190,220,871,1650,2069,592,0,5182,190,220
190,222,2567,2881,458,304,0,6210,190,222
190,223,282,1431,693,722,0,3128,190,223
190,224,2084,0,0,0,0,2084,190,224
190,225,0,268,172,0,0,440,190,225
190,226,1296,1057,2526,1796,0,6675,190,226
190,227,0,0,1978,0,0,1978,190,227
190,228,455,0,439,0,0,894,190,228
190,229,835,0,890,0,0,1725,190,229
190,230,303,0,0,0,0,303,190,230
190,232,0,0,212,0,0,212,190,232
190,233,0,0,2626,311,0,2937,190,233
190,234,0,0,216,0,0,216,190,234
190,270,244,0,0,0,0,244,190,270
190,279,0,0,508,0,0,508,190,279
190,280,179,0,0,0,0,179,190,280
190,301,0,0,156,0,0,156,190,301
190,327,27,0,0,0,0,27,190,327
190,340,13,0,0,0,0,13,190,340
191,36,81,0,0,0,0,81,191,36
191,40,0,0,10,0,0,10,191,40
191,43,63,0,68,0,0,131,191,43
191,46,0,0,404,0,0,404,191,46
191,48,0,0,292,0,0,292,191,48
191,51,0,0,93,0,0,93,191,51
191,62,0,0,27,0,0,27,191,62
191,68,0,0,28,0,0,28,191,68
191,75,0,0,61,0,0,61,191,75
191,76,0,0,38,0,0,38,191,76
191,80,0,0,44,0,0,44,191,80
191,140,0,0,1029,0,0,1029,191,140
191,161,0,0,600,0,0,600,191,161
191,167,237,0,0,0,0,237,191,167
191,170,0,0,1036,0,0,1036,191,170
191,173,0,0,449,0,0,449,191,173
191,176,112,0,0,0,0,112,191,176
191,180,0,0,938,0,0,938,191,180
191,181,103,0,0,0,0,103,191,181
191,183,0,0,485,0,0,485,191,183
191,187,0,0,141,0,0,141,191,187
191,188,0,0,1416,0,0,1416,191,188
191,189,0,0,863,0,0,863,191,189
191,190,0,0,943,0,0,943,191,190
191,192,0,1001,246,0,0,1247,191,192
191,193,0,0,227,0,0,227,191,193
191,195,0,0,192,0,0,192,191,195
191,197,0,0,725,0,0,725,191,197
191,198,47,0,157,0,0,204,191,198
191,203,429,0,441,0,0,870,191,203
191,204,550,0,0,0,0,550,191,204
191,210,0,0,859,0,0,859,191,210
191,217,241,0,0,0,0,241,191,217
191,218,0,0,695,0,0,695,191,218
191,220,0,0,649,0,0,649,191,220
191,222,202,0,242,0,0,444,191,222
191,225,0,0,146,0,0,146,191,225
191,226,0,0,536,0,0,536,191,226
191,227,562,0,0,0,0,562,191,227
191,228,0,0,133,0,0,133,191,228
191,229,0,0,1252,0,0,1252,191,229
191,230,625,0,680,0,0,1305,191,230
191,231,0,0,165,0,0,165,191,231
191,235,0,0,445,0,0,445,191,235
191,240,206,0,0,0,0,206,191,240
191,264,518,0,0,0,0,518,191,264
192,1,0,0,546,0,0,546,192,1
192,2,0,0,294,0,0,294,192,2
192,5,0,0,276,0,0,276,192,5
192,7,0,0,362,0,0,362,192,7
192,13,0,0,270,0,0,270,192,13
192,15,0,0,98,0,0,98,192,15
192,17,0,0,258,0,0,258,192,17
192,26,0,0,276,0,0,276,192,26
192,27,0,0,226,0,0,226,192,27
192,29,0,0,315,0,0,315,192,29
192,41,0,0,816,0,0,816,192,41
192,53,0,0,315,0,0,315,192,53
192,57,0,0,383,0,0,383,192,57
192,59,0,0,294,0,0,294,192,59
192,69,0,0,0,73,0,73,192,69
192,77,276,0,0,0,0,276,192,77
192,82,0,0,258,0,0,258,192,82
192,90,994,0,0,0,0,994,192,90
192,99,0,0,633,0,0,633,192,99
192,128,0,0,276,0,0,276,192,128
192,131,0,0,242,0,0,242,192,131
192,167,0,0,0,637,0,637,192,167
192,168,0,0,294,0,0,294,192,168
192,169,0,0,276,0,0,276,192,169
192,170,0,0,652,0,0,652,192,170
192,171,526,0,294,0,0,820,192,171
192,173,0,0,301,0,0,301,192,173
192,175,242,0,0,0,0,242,192,175
192,184,0,0,201,0,0,201,192,184
192,185,0,363,0,0,0,363,192,185
192,187,0,0,182,463,0,645,192,187
192,188,276,0,0,0,0,276,192,188
192,189,555,0,382,251,0,1188,192,189
192,190,558,218,689,102,0,1567,192,190
192,191,0,1001,246,0,0,1247,192,191
192,192,276,16064,0,3145,0,19485,192,192
192,193,993,1382,0,0,0,2375,192,193
192,194,318,1496,0,164,0,1978,192,194
192,195,0,446,65,0,0,511,192,195
192,197,315,0,0,286,0,601,192,197
192,198,0,0,343,294,0,637,192,198
192,199,168,0,0,0,0,168,192,199
192,200,173,0,0,0,0,173,192,200
192,201,0,0,343,0,0,343,192,201
192,202,0,0,264,0,0,264,192,202
192,209,396,0,0,0,0,396,192,209
192,214,0,0,363,0,0,363,192,214
192,216,910,0,0,0,0,910,192,216
192,217,1057,1740,263,0,0,3060,192,217
192,218,0,0,208,0,0,208,192,218
192,223,589,0,0,0,0,589,192,223
192,225,0,0,217,0,0,217,192,225
192,226,0,0,505,0,0,505,192,226
192,227,240,0,673,0,0,913,192,227
192,234,315,0,0,0,0,315,192,234
192,262,0,0,362,0,0,362,192,262
192,274,0,0,294,0,0,294,192,274
192,300,0,0,276,0,0,276,192,300
193,2,0,0,151,0,0,151,193,2
193,5,0,0,671,0,0,671,193,5
193,12,0,0,151,0,0,151,193,12
193,14,0,0,151,0,0,151,193,14
193,18,0,0,140,0,0,140,193,18
193,19,0,0,278,0,0,278,193,19
193,31,0,0,151,0,0,151,193,31
193,33,0,0,72,0,0,72,193,33
193,38,53,0,0,0,0,53,193,38
193,40,0,0,27,0,0,27,193,40
193,43,0,0,744,0,0,744,193,43
193,45,0,0,278,0,0,278,193,45
193,48,0,0,140,0,0,140,193,48
193,50,0,0,178,0,0,178,193,50
193,63,0,0,485,0,0,485,193,63
193,69,189,0,0,0,0,189,193,69
193,81,0,0,99,0,0,99,193,81
193,84,382,0,0,0,0,382,193,84
193,108,0,0,23,0,0,23,193,108
193,137,0,0,151,0,0,151,193,137
193,138,278,0,0,0,0,278,193,138
193,162,0,0,278,0,0,278,193,162
193,163,151,0,0,0,0,151,193,163
193,168,0,0,151,0,0,151,193,168
193,169,73,0,0,0,0,73,193,169
193,171,0,0,357,0,0,357,193,171
193,174,72,0,57,0,0,129,193,174
193,180,278,0,0,0,0,278,193,180
193,183,1719,623,0,287,0,2629,193,183
193,184,0,720,205,155,133,1213,193,184
193,187,231,0,0,0,0,231,193,187
193,188,468,0,108,0,0,576,193,188
193,190,0,0,236,0,0,236,193,190
193,191,151,0,227,0,0,378,193,191
193,192,993,1382,0,0,0,2375,193,192
193,193,281,6692,887,0,0,7860,193,193
193,194,0,1780,164,1963,0,3907,193,194
193,195,0,433,0,0,0,433,193,195
193,198,394,0,317,0,0,711,193,198
193,201,189,0,858,0,0,1047,193,201
193,203,0,0,164,0,0,164,193,203
193,204,0,0,825,0,0,825,193,204
193,205,0,0,644,0,557,1201,193,205
193,207,1202,0,0,0,0,1202,193,207
193,208,278,0,0,0,0,278,193,208
193,211,0,0,302,0,0,302,193,211
193,217,0,3092,194,0,0,3286,193,217
193,218,0,0,164,0,0,164,193,218
193,220,0,0,259,0,0,259,193,220
193,221,363,0,0,0,0,363,193,221
193,223,0,0,0,109,0,109,193,223
193,227,0,0,226,0,0,226,193,227
193,262,0,0,344,0,0,344,193,262
193,339,0,0,207,0,0,207,193,339
194,1,255,0,127,0,0,382,194,1
194,5,0,0,522,0,0,522,194,5
194,7,0,0,127,0,0,127,194,7
194,14,121,0,0,0,0,121,194,14
194,15,0,0,402,0,0,402,194,15
194,16,0,0,127,0,0,127,194,16
194,32,121,0,394,0,0,515,194,32
194,41,127,0,298,0,0,425,194,41
194,43,0,0,540,0,0,540,194,43
194,44,0,0,255,0,0,255,194,44
194,61,0,0,196,0,0,196,194,61
194,64,0,0,127,0,0,127,194,64
194,76,0,0,127,0,0,127,194,76
194,88,0,0,101,0,0,101,194,88
194,100,0,0,121,0,0,121,194,100
194,154,0,0,121,0,0,121,194,154
194,161,0,0,274,0,0,274,194,161
194,165,0,0,139,0,0,139,194,165
194,166,127,0,0,0,0,127,194,166
194,169,0,0,523,0,0,523,194,169
194,170,121,0,282,0,0,403,194,170
194,171,0,0,139,0,0,139,194,171
194,182,0,0,178,0,0,178,194,182
194,185,0,904,131,0,0,1035,194,185
194,186,0,0,0,151,0,151,194,186
194,187,135,0,0,311,0,446,194,187
194,188,293,0,1172,0,0,1465,194,188
194,189,0,446,863,0,0,1309,194,189
194,190,0,127,575,0,0,702,194,190
194,191,0,0,547,0,0,547,194,191
194,192,318,1496,0,164,0,1978,194,192
194,193,763,1780,164,1200,0,3907,194,193
194,194,0,10241,262,0,0,10503,194,194
194,195,0,1259,263,528,0,2050,194,195
194,198,0,0,384,353,0,737,194,198
194,203,0,0,207,0,0,207,194,203
194,204,0,0,131,0,0,131,194,204
194,207,0,0,298,0,0,298,194,207
194,219,0,0,298,0,0,298,194,219
194,222,0,0,298,0,0,298,194,222
194,229,173,0,0,0,0,173,194,229
194,254,0,0,139,0,0,139,194,254
194,258,0,0,139,0,0,139,194,258
194,266,0,0,0,274,0,274,194,266
194,270,0,0,127,0,0,127,194,270
194,303,0,0,282,0,0,282,194,303
195,1,0,0,214,0,0,214,195,1
195,2,0,0,238,0,0,238,195,2
195,5,0,0,317,0,0,317,195,5
195,7,0,0,214,0,0,214,195,7
195,12,0,0,399,0,0,399,195,12
195,22,0,0,130,0,0,130,195,22
195,23,0,0,317,0,0,317,195,23
195,27,0,0,399,0,0,399,195,27
195,29,0,0,214,60,0,274,195,29
195,34,0,0,317,0,0,317,195,34
195,36,0,0,451,0,0,451,195,36
195,40,0,0,263,0,0,263,195,40
195,41,461,0,0,0,0,461,195,41
195,49,0,0,74,0,0,74,195,49
195,82,0,0,317,0,0,317,195,82
195,92,0,0,317,0,0,317,195,92
195,102,0,0,317,0,0,317,195,102
195,128,0,0,317,0,0,317,195,128
195,131,0,0,367,0,0,367,195,131
195,138,0,0,451,0,0,451,195,138
195,166,0,0,674,0,0,674,195,166
195,167,377,0,60,0,0,437,195,167
195,169,0,0,367,0,0,367,195,169
195,170,0,0,242,0,0,242,195,170
195,180,546,0,0,0,0,546,195,180
195,184,0,0,228,0,0,228,195,184
195,185,0,703,399,0,0,1102,195,185
195,186,0,317,0,107,0,424,195,186
195,187,0,0,399,0,0,399,195,187
195,188,0,1161,263,254,0,1678,195,188
195,189,482,134,432,0,0,1048,195,189
195,190,214,703,495,0,0,1412,195,190
195,191,0,0,192,0,0,192,195,191
195,192,0,446,65,0,0,511,195,192
195,193,0,433,0,0,0,433,195,193
195,194,0,1259,263,528,0,2050,195,194
195,195,0,12974,0,1645,0,14619,195,195
195,196,488,1125,162,319,0,2094,195,196
195,197,1197,293,0,407,0,1897,195,197
195,198,1019,0,0,275,0,1294,195,198
195,201,489,0,769,0,0,1258,195,201
195,202,317,0,250,0,0,567,195,202
195,204,0,0,399,0,0,399,195,204
195,208,0,0,247,0,0,247,195,208
195,214,0,0,345,0,0,345,195,214
195,216,0,0,345,0,0,345,195,216
195,218,0,0,608,0,0,608,195,218
195,222,367,0,0,0,0,367,195,222
195,223,818,0,0,0,0,818,195,223
195,225,0,0,1240,0,0,1240,195,225
195,226,361,0,0,0,0,361,195,226
195,227,0,0,284,0,0,284,195,227
195,229,0,0,345,0,0,345,195,229
195,230,0,0,680,0,0,680,195,230
195,231,0,0,0,264,0,264,195,231
195,254,0,0,317,0,0,317,195,254
195,266,75,0,0,0,0,75,195,266
195,271,0,0,0,317,0,317,195,271
195,274,0,0,214,0,0,214,195,274
195,332,0,0,116,0,0,116,195,332
196,6,0,0,393,0,0,393,196,6
196,13,0,0,676,0,0,676,196,13
196,14,0,0,416,0,0,416,196,14
196,16,0,0,758,0,0,758,196,16
196,17,0,0,338,0,0,338,196,17
196,36,0,0,102,0,0,102,196,36
196,40,0,0,111,0,0,111,196,40
196,45,0,0,90,0,0,90,196,45
196,47,0,0,705,0,0,705,196,47
196,52,0,0,676,0,0,676,196,52
196,53,0,0,108,0,0,108,196,53
196,54,0,0,239,0,0,239,196,54
196,55,168,0,0,0,0,168,196,55
196,57,0,0,113,0,0,113,196,57
196,68,338,0,0,0,0,338,196,68
196,70,338,0,0,0,0,338,196,70
196,78,0,0,113,0,0,113,196,78
196,79,0,0,319,0,0,319,196,79
196,93,0,0,108,0,0,108,196,93
196,168,0,0,281,0,0,281,196,168
196,169,0,0,367,0,0,367,196,169
196,172,0,0,111,0,0,111,196,172
196,175,0,0,367,0,0,367,196,175
196,177,95,0,0,0,0,95,196,177
196,182,0,0,735,0,0,735,196,182
196,185,0,319,0,0,0,319,196,185
196,186,0,53,0,0,0,53,196,186
196,187,0,0,462,0,0,462,196,187
196,188,0,1307,347,586,0,2240,196,188
196,189,577,691,613,0,0,1881,196,189
196,190,0,0,367,0,0,367,196,190
196,195,488,855,162,319,0,1824,196,195
196,196,102,14873,0,1954,0,16929,196,196
196,197,726,0,281,0,0,1007,196,197
196,198,2583,214,2245,0,0,5042,196,198
196,199,0,0,485,0,0,485,196,199
196,201,0,0,424,0,0,424,196,201
196,202,120,0,0,668,490,1278,196,202
196,203,0,1315,85,215,0,1615,196,203
196,204,0,0,1193,0,0,1193,196,204
196,206,631,0,0,0,0,631,196,206
196,208,120,0,0,0,0,120,196,208
196,210,0,0,133,0,0,133,196,210
196,213,0,0,90,0,0,90,196,213
196,214,0,0,118,0,0,118,196,214
196,215,0,0,0,338,0,338,196,215
196,216,338,0,0,0,0,338,196,216
196,217,0,0,118,0,0,118,196,217
196,221,0,0,0,215,0,215,196,221
196,222,244,0,367,0,0,611,196,222
196,223,0,0,392,0,0,392,196,223
196,229,0,0,492,0,0,492,196,229
196,231,0,0,165,0,0,165,196,231
196,276,0,0,338,0,0,338,196,276
196,282,338,0,0,0,0,338,196,282
196,340,0,0,338,0,0,338,196,340
197,1,95,0,0,0,0,95,197,1
197,2,0,0,513,0,0,513,197,2
197,5,0,0,189,0,0,189,197,5
197,6,0,0,333,0,0,333,197,6
197,16,0,0,180,0,0,180,197,16
197,24,0,0,154,0,0,154,197,24
197,29,0,0,146,0,0,146,197,29
197,36,0,0,333,0,0,333,197,36
197,43,108,0,146,333,0,587,197,43
197,49,0,0,74,0,0,74,197,49
197,52,0,0,61,0,0,61,197,52
197,57,0,0,174,0,0,174,197,57
197,61,0,0,95,0,0,95,197,61
197,68,333,0,0,0,0,333,197,68
197,71,0,0,0,95,0,95,197,71
197,74,0,0,615,0,0,615,197,74
197,77,101,0,0,0,0,101,197,77
197,78,95,0,0,0,0,95,197,78
197,79,0,0,95,0,0,95,197,79
197,94,0,0,95,0,0,95,197,94
197,153,0,0,333,0,0,333,197,153
197,160,502,0,0,0,0,502,197,160
197,166,95,0,211,0,0,306,197,166
197,167,95,0,460,0,0,555,197,167
197,168,0,0,757,0,0,757,197,168
197,171,0,0,103,0,0,103,197,171
197,177,0,0,48,0,0,48,197,177
197,180,630,0,103,0,0,733,197,180
197,181,1076,0,0,0,0,1076,197,181
197,182,0,0,618,0,0,618,197,182
197,184,333,0,363,0,0,696,197,184
197,186,0,59,0,114,0,173,197,186
197,187,845,540,103,136,0,1624,197,187
197,188,875,1820,504,1045,0,4244,197,188
197,191,0,0,725,0,0,725,197,191
197,192,0,0,0,286,0,286,197,192
197,195,297,293,0,407,0,997,197,195
197,196,726,0,281,0,0,1007,197,196
197,197,3253,8578,0,291,0,12122,197,197
197,198,554,4549,103,541,137,5884,197,198
197,199,900,900,2322,0,0,4122,197,199
197,200,0,0,103,130,0,233,197,200
197,201,0,0,767,0,0,767,197,201
197,202,324,0,0,145,0,469,197,202
197,205,0,0,418,0,0,418,197,205
197,207,0,0,103,0,0,103,197,207
197,208,0,0,180,0,0,180,197,208
197,213,793,0,0,0,0,793,197,213
197,216,0,0,146,0,0,146,197,216
197,223,179,0,425,0,0,604,197,223
197,226,0,0,536,0,0,536,197,226
197,232,0,0,654,0,0,654,197,232
197,233,0,0,773,0,0,773,197,233
197,234,0,0,190,0,0,190,197,234
197,253,0,0,180,0,0,180,197,253
197,261,0,0,0,333,0,333,197,261
197,268,35,0,0,0,0,35,197,268
198,1,0,0,269,0,0,269,198,1
198,5,0,0,436,0,0,436,198,5
198,8,0,0,157,0,0,157,198,8
198,14,0,0,0,246,0,246,198,14
198,16,0,0,198,0,0,198,198,16
198,29,0,0,492,0,0,492,198,29
198,31,0,0,246,0,0,246,198,31
198,32,0,0,144,0,0,144,198,32
198,35,0,0,144,0,0,144,198,35
198,36,0,0,246,0,0,246,198,36
198,42,0,0,246,0,0,246,198,42
198,43,144,0,0,0,0,144,198,43
198,49,144,0,0,0,0,144,198,49
198,62,0,0,232,0,0,232,198,62
198,73,0,0,161,0,0,161,198,73
198,74,0,0,246,0,0,246,198,74
198,79,41,0,125,0,0,166,198,79
198,81,0,0,335,0,0,335,198,81
198,82,0,0,246,0,0,246,198,82
198,93,0,0,246,246,0,492,198,93
198,113,275,0,0,0,0,275,198,113
198,130,0,0,75,0,0,75,198,130
198,133,0,0,275,0,0,275,198,133
198,135,0,0,136,0,0,136,198,135
198,145,0,0,31,0,0,31,198,145
198,162,0,0,335,0,0,335,198,162
198,163,0,0,298,0,0,298,198,163
198,166,0,0,473,0,0,473,198,166
198,167,275,0,275,0,0,550,198,167
198,168,0,0,380,0,0,380,198,168
198,170,0,0,499,0,0,499,198,170
198,171,0,0,269,0,0,269,198,171
198,172,0,0,157,129,0,286,198,172
198,175,384,0,242,0,0,626,198,175
198,180,144,0,905,0,0,1049,198,180
198,181,0,0,1499,0,0,1499,198,181
198,182,0,0,267,0,0,267,198,182
198,184,0,0,201,0,0,201,198,184
198,185,657,0,0,0,0,657,198,185
198,186,88,0,483,114,0,685,198,186
198,187,0,0,2114,179,0,2293,198,187
198,188,510,47,466,0,0,1023,198,188
198,189,773,0,962,0,0,1735,198,189
198,190,0,0,946,0,0,946,198,190
198,191,47,0,157,0,0,204,198,191
198,192,315,0,343,294,0,952,198,192
198,193,0,0,317,0,0,317,198,193
198,194,0,0,384,353,0,737,198,194
198,195,246,0,0,275,0,521,198,195
198,196,2325,258,2477,0,0,5060,198,196
198,197,335,4066,103,879,137,5520,198,197
198,198,7585,16437,593,0,0,24615,198,198
198,199,4899,1265,2357,265,0,8786,198,199
198,200,330,0,1705,0,0,2035,198,200
198,201,492,3980,656,337,0,5465,198,201
198,202,1210,451,3375,1657,0,6693,198,202
198,203,0,0,859,0,0,859,198,203
198,204,0,0,2317,0,0,2317,198,204
198,205,0,0,1062,0,0,1062,198,205
198,206,42,0,1170,0,0,1212,198,206
198,207,0,0,3584,0,0,3584,198,207
198,213,396,0,175,0,0,571,198,213
198,217,524,0,0,0,0,524,198,217
198,219,0,0,646,0,0,646,198,219
198,221,161,0,0,0,0,161,198,221
198,223,0,0,298,0,0,298,198,223
198,225,0,0,299,0,0,299,198,225
198,226,47,0,0,0,0,47,198,226
198,228,0,0,192,0,0,192,198,228
198,229,394,0,0,0,0,394,198,229
198,230,0,0,267,0,0,267,198,230
198,239,0,0,299,0,0,299,198,239
198,253,0,0,23,0,0,23,198,253
198,304,0,0,246,0,0,246,198,304
198,321,0,0,0,111,0,111,198,321
199,1,0,0,541,0,0,541,199,1
199,2,0,0,541,0,0,541,199,2
199,5,0,0,1696,0,0,1696,199,5
199,7,0,0,541,0,0,541,199,7
199,12,0,0,1108,0,0,1108,199,12
199,13,0,0,567,0,0,567,199,13
199,19,0,0,541,0,0,541,199,19
199,27,0,0,900,0,0,900,199,27
199,65,0,0,900,0,0,900,199,65
199,156,0,0,324,0,0,324,199,156
199,163,0,0,621,0,0,621,199,163
199,166,0,0,1108,0,0,1108,199,166
199,168,0,0,881,0,0,881,199,168
199,170,541,0,457,0,0,998,199,170
199,171,0,0,457,0,0,457,199,171
199,174,315,0,0,0,0,315,199,174
199,181,0,0,567,0,0,567,199,181
199,182,473,0,0,0,0,473,199,182
199,184,0,0,403,0,0,403,199,184
199,185,0,0,979,0,0,979,199,185
199,187,0,623,589,0,0,1212,199,187
199,188,547,0,2442,0,0,2989,199,188
199,190,1057,0,501,0,0,1558,199,190
199,192,168,0,0,0,0,168,199,192
199,196,0,0,485,0,0,485,199,196
199,197,0,0,3301,0,0,3301,199,197
199,198,4754,1265,2514,265,0,8798,199,198
199,199,16453,78883,2103,6076,4509,108024,199,199
199,200,439,264,499,144,0,1346,199,200
199,201,2525,975,0,0,3008,6508,199,201
199,204,0,0,979,0,0,979,199,204
199,211,0,0,501,0,0,501,199,211
199,214,0,0,299,0,0,299,199,214
199,219,0,0,447,0,0,447,199,219
199,230,900,0,0,0,0,900,199,230
199,240,0,0,461,0,0,461,199,240
199,267,0,0,501,0,0,501,199,267
199,280,900,0,0,0,0,900,199,280
199,292,0,0,0,269,0,269,199,292
199,325,0,0,309,0,0,309,199,325
199,339,0,0,1057,0,0,1057,199,339
200,1,0,0,222,0,0,222,200,1
200,5,0,0,149,0,0,149,200,5
200,13,0,0,590,0,0,590,200,13
200,15,0,0,506,0,0,506,200,15
200,16,0,0,134,0,0,134,200,16
200,29,0,0,149,0,0,149,200,29
200,31,0,0,218,0,0,218,200,31
200,32,0,0,109,0,0,109,200,32
200,34,0,0,218,0,0,218,200,34
200,41,0,0,26,0,0,26,200,41
200,47,0,0,109,0,0,109,200,47
200,66,0,0,109,0,0,109,200,66
200,68,0,0,222,0,0,222,200,68
200,78,0,0,149,0,0,149,200,78
200,79,0,0,330,0,0,330,200,79
200,80,0,0,149,0,0,149,200,80
200,85,0,0,109,0,0,109,200,85
200,93,0,0,222,0,0,222,200,93
200,97,0,0,0,109,0,109,200,97
200,129,0,0,109,0,0,109,200,129
200,133,0,0,149,0,0,149,200,133
200,166,0,0,222,0,0,222,200,166
200,167,0,0,465,0,0,465,200,167
200,168,0,0,372,0,0,372,200,168
200,169,0,0,391,0,0,391,200,169
200,172,0,0,241,149,0,390,200,172
200,178,0,0,329,0,0,329,200,178
200,186,0,0,118,0,0,118,200,186
200,188,0,0,280,0,158,438,200,188
200,192,282,0,0,0,0,282,200,192
200,197,0,0,103,130,0,233,200,197
200,198,1148,0,1386,0,0,2534,200,198
200,199,439,264,499,144,0,1346,200,199
200,200,2602,21190,560,406,383,25141,200,200
200,201,324,288,999,0,0,1611,200,201
200,206,2433,2846,484,144,479,6386,200,206
200,207,239,2086,241,0,0,2566,200,207
200,208,222,0,162,0,93,477,200,208
200,213,0,0,162,0,0,162,200,213
200,215,0,0,109,0,0,109,200,215
200,226,109,0,0,0,0,109,200,226
200,227,0,0,118,0,0,118,200,227
200,240,0,0,134,0,0,134,200,240
200,255,0,0,132,0,0,132,200,255
200,256,0,0,149,0,0,149,200,256
200,274,0,0,109,0,0,109,200,274
200,300,0,0,0,109,0,109,200,300
200,301,0,0,149,0,0,149,200,301
200,317,0,0,109,0,0,109,200,317
200,321,0,0,132,0,0,132,200,321
201,1,0,0,146,0,0,146,201,1
201,5,0,0,530,0,0,530,201,5
201,6,0,0,480,0,0,480,201,6
201,8,0,0,742,0,0,742,201,8
201,9,0,0,779,0,0,779,201,9
201,14,0,0,1265,0,0,1265,201,14
201,19,1206,0,0,0,0,1206,201,19
201,22,0,0,107,0,0,107,201,22
201,29,0,0,372,0,0,372,201,29
201,30,0,0,489,0,0,489,201,30
201,31,0,0,404,0,0,404,201,31
201,32,0,0,191,0,0,191,201,32
201,41,513,0,0,0,0,513,201,41
201,43,0,0,0,633,0,633,201,43
201,44,0,0,742,0,0,742,201,44
201,58,0,0,372,0,0,372,201,58
201,59,489,0,0,0,0,489,201,59
201,64,0,0,390,0,0,390,201,64
201,70,78,0,0,0,0,78,201,70
201,73,0,0,885,0,0,885,201,73
201,75,56,0,0,0,0,56,201,75
201,93,0,0,742,0,0,742,201,93
201,162,237,0,0,0,0,237,201,162
201,169,0,0,669,0,0,669,201,169
201,170,0,0,1126,0,0,1126,201,170
201,172,0,0,532,0,0,532,201,172
201,181,447,0,0,0,0,447,201,181
201,184,1391,0,0,0,0,1391,201,184
201,188,2585,0,1106,0,0,3691,201,188
201,190,603,0,424,0,0,1027,201,190
201,192,0,0,343,0,0,343,201,192
201,193,189,0,0,0,0,189,201,193
201,195,489,0,345,0,0,834,201,195
201,196,0,0,424,0,0,424,201,196
201,197,0,0,767,0,0,767,201,197
201,198,492,3980,656,337,0,5465,201,198
201,199,2860,372,0,0,1533,4765,201,199
201,200,324,288,999,0,0,1611,201,200
201,201,9249,53921,4326,871,0,68367,201,201
201,202,1451,6035,2335,1201,0,11022,201,202
201,203,0,0,148,0,0,148,201,203
201,204,0,0,656,0,0,656,201,204
201,205,0,0,858,0,0,858,201,205
201,206,3247,1952,2252,1998,0,9449,201,206
201,207,0,0,252,0,0,252,201,207
201,208,0,0,1558,0,0,1558,201,208
201,215,0,0,404,0,0,404,201,215
201,221,0,0,1106,0,0,1106,201,221
201,222,1319,0,0,0,0,1319,201,222
201,227,0,0,762,0,0,762,201,227
201,229,0,0,0,603,0,603,201,229
201,230,0,0,0,306,0,306,201,230
201,233,311,0,0,0,0,311,201,233
201,235,0,0,696,0,0,696,201,235
201,239,603,0,0,0,0,603,201,239
201,243,0,0,603,0,0,603,201,243
201,321,0,0,95,0,0,95,201,321
202,1,0,0,833,0,0,833,202,1
202,2,0,0,1667,0,0,1667,202,2
202,7,0,0,594,0,0,594,202,7
202,14,0,0,546,0,0,546,202,14
202,15,0,0,1047,0,0,1047,202,15
202,16,0,0,470,0,0,470,202,16
202,18,0,0,754,0,0,754,202,18
202,37,0,0,0,451,0,451,202,37
202,40,0,0,754,0,0,754,202,40
202,44,0,0,1856,0,0,1856,202,44
202,47,0,0,444,0,0,444,202,47
202,58,0,0,754,0,0,754,202,58
202,77,0,0,444,0,0,444,202,77
202,79,0,0,801,0,0,801,202,79
202,90,239,0,546,0,0,785,202,90
202,92,0,0,766,0,0,766,202,92
202,93,0,0,766,0,0,766,202,93
202,106,0,0,766,0,0,766,202,106
202,108,0,0,928,0,0,928,202,108
202,131,0,0,482,0,0,482,202,131
202,162,0,0,483,0,0,483,202,162
202,166,0,0,1726,444,0,2170,202,166
202,167,0,0,3376,0,0,3376,202,167
202,170,754,0,813,0,0,1567,202,170
202,176,1507,0,483,0,0,1990,202,176
202,186,118,0,0,0,0,118,202,186
202,188,0,0,1515,0,0,1515,202,188
202,189,848,0,0,0,0,848,202,189
202,191,0,0,444,0,0,444,202,191
202,192,0,0,264,0,0,264,202,192
202,195,317,0,250,0,0,567,202,195
202,196,120,0,0,668,490,1278,202,196
202,197,95,0,0,328,0,423,202,197
202,198,1210,451,2017,1657,0,5335,202,198
202,201,2054,5432,2335,1201,0,11022,202,201
202,202,5516,16895,0,8257,0,30668,202,202
202,203,816,190,673,1591,0,3270,202,203
202,204,0,758,2460,597,0,3815,202,204
202,205,451,0,0,0,0,451,202,205
202,206,498,1331,0,0,0,1829,202,206
202,207,0,0,1038,0,0,1038,202,207
202,209,0,0,0,444,0,444,202,209
202,222,48,0,51,0,0,99,202,222
202,223,0,0,491,0,0,491,202,223
202,224,754,0,0,0,0,754,202,224
202,227,0,0,524,0,0,524,202,227
202,255,444,0,0,0,0,444,202,255
202,300,0,0,444,0,0,444,202,300
202,342,0,0,546,0,0,546,202,342
203,1,0,0,153,0,0,153,203,1
203,4,0,0,190,0,0,190,203,4
203,5,0,0,753,0,0,753,203,5
203,12,0,0,307,0,0,307,203,12
203,21,0,0,110,0,0,110,203,21
203,23,0,0,249,0,0,249,203,23
203,28,0,0,429,0,0,429,203,28
203,31,0,0,249,0,0,249,203,31
203,32,0,0,307,0,0,307,203,32
203,40,0,0,1033,0,0,1033,203,40
203,41,0,0,440,0,0,440,203,41
203,42,0,0,234,0,0,234,203,42
203,43,0,0,380,0,0,380,203,43
203,46,0,0,234,0,0,234,203,46
203,54,0,0,429,0,0,429,203,54
203,64,0,0,858,0,0,858,203,64
203,65,0,0,249,0,0,249,203,65
203,70,0,0,249,0,0,249,203,70
203,74,0,0,190,0,0,190,203,74
203,76,0,0,190,0,0,190,203,76
203,78,0,0,440,0,0,440,203,78
203,81,0,0,190,0,0,190,203,81
203,84,0,0,234,0,0,234,203,84
203,91,0,0,957,0,0,957,203,91
203,93,190,0,0,0,0,190,203,93
203,94,0,0,190,0,0,190,203,94
203,109,0,0,0,429,0,429,203,109
203,133,0,0,343,0,0,343,203,133
203,162,0,0,289,0,0,289,203,162
203,166,0,0,484,0,0,484,203,166
203,167,190,0,614,0,0,804,203,167
203,168,0,0,753,0,0,753,203,168
203,169,0,0,153,0,0,153,203,169
203,171,0,0,190,0,0,190,203,171
203,172,0,0,234,0,0,234,203,172
203,174,190,0,0,0,0,190,203,174
203,175,190,0,0,0,0,190,203,175
203,180,440,0,0,0,0,440,203,180
203,181,190,0,0,0,0,190,203,181
203,186,255,0,0,0,0,255,203,186
203,188,0,0,318,0,0,318,203,188
203,189,405,965,527,485,0,2382,203,189
203,190,0,0,1009,0,0,1009,203,190
203,191,991,0,441,0,0,1432,203,191
203,193,0,0,164,0,0,164,203,193
203,194,0,0,207,0,0,207,203,194
203,196,0,1315,85,215,0,1615,203,196
203,198,0,0,859,0,0,859,203,198
203,201,0,0,148,0,0,148,203,201
203,202,1298,190,148,1591,0,3227,203,202
203,203,1480,20832,1266,0,0,23578,203,203
203,204,0,5745,945,597,0,7287,203,204
203,211,190,0,0,0,0,190,203,211
203,218,0,0,375,0,0,375,203,218
203,221,0,0,207,0,0,207,203,221
203,222,429,0,207,485,0,1121,203,222
203,223,0,0,1633,0,0,1633,203,223
203,224,0,0,466,0,0,466,203,224
203,225,405,0,207,0,0,612,203,225
203,226,190,2214,415,249,0,3068,203,226
203,227,380,190,466,0,0,1036,203,227
203,229,190,0,1154,0,0,1344,203,229
203,231,0,0,165,0,0,165,203,231
203,251,0,0,190,0,0,190,203,251
203,254,0,0,565,0,0,565,203,254
203,255,380,0,0,0,0,380,203,255
203,272,0,0,190,0,0,190,203,272
203,273,0,0,190,0,0,190,203,273
203,328,0,0,562,0,0,562,203,328
204,1,0,0,2067,0,0,2067,204,1
204,2,0,0,1308,0,0,1308,204,2
204,5,0,0,550,0,0,550,204,5
204,6,0,0,678,0,0,678,204,6
204,9,0,0,324,0,0,324,204,9
204,10,0,0,550,0,0,550,204,10
204,15,0,0,825,0,0,825,204,15
204,18,0,0,1612,0,0,1612,204,18
204,23,0,0,210,0,0,210,204,23
204,25,0,0,0,678,0,678,204,25
204,31,0,0,758,0,0,758,204,31
204,43,0,0,677,0,0,677,204,43
204,45,0,0,758,0,0,758,204,45
204,47,0,0,0,758,0,758,204,47
204,53,0,0,678,0,0,678,204,53
204,55,47,0,0,0,0,47,204,55
204,73,550,0,0,0,0,550,204,73
204,79,0,0,550,0,0,550,204,79
204,82,0,0,758,0,0,758,204,82
204,92,1,0,0,0,0,1,204,92
204,99,0,0,835,0,0,835,204,99
204,103,0,0,835,0,0,835,204,103
204,123,0,0,647,0,0,647,204,123
204,154,0,0,1308,0,0,1308,204,154
204,159,924,0,677,0,0,1601,204,159
204,166,0,0,835,0,0,835,204,166
204,167,0,0,1151,0,0,1151,204,167
204,168,0,0,971,0,0,971,204,168
204,171,0,0,942,0,0,942,204,171
204,172,0,0,1475,0,0,1475,204,172
204,174,0,0,389,0,0,389,204,174
204,183,0,0,971,0,0,971,204,183
204,186,0,0,971,0,0,971,204,186
204,188,550,0,0,0,0,550,204,188
204,190,0,0,598,0,0,598,204,190
204,193,0,0,825,0,0,825,204,193
204,194,0,0,131,0,0,131,204,194
204,195,0,0,399,0,0,399,204,195
204,196,0,0,1193,0,0,1193,204,196
204,198,0,0,1529,0,0,1529,204,198
204,199,0,0,979,0,0,979,204,199
204,200,0,0,241,0,0,241,204,200
204,201,0,0,656,0,0,656,204,201
204,202,0,0,2460,597,0,3057,204,202
204,203,0,5745,945,597,0,7287,204,203
204,204,10664,69421,2393,5770,3562,91810,204,204
204,205,0,1756,0,0,0,1756,204,205
204,206,550,0,0,0,0,550,204,206
204,208,255,0,0,0,0,255,204,208
204,209,0,0,598,0,0,598,204,209
204,215,0,0,825,0,0,825,204,215
204,217,435,0,825,0,0,1260,204,217
204,218,0,0,695,0,0,695,204,218
204,225,0,0,217,0,0,217,204,225
204,226,0,0,825,0,0,825,204,226
204,227,240,1651,598,1188,0,3677,204,227
204,228,3418,0,0,0,0,3418,204,228
204,229,0,0,727,0,0,727,204,229
204,230,0,0,333,0,0,333,204,230
204,253,0,0,15,0,0,15,204,253
204,263,0,0,634,0,0,634,204,263
204,266,0,0,0,678,0,678,204,266
204,319,0,0,0,758,0,758,204,319
205,2,0,0,1297,0,0,1297,205,2
205,4,0,0,1153,0,0,1153,205,4
205,5,0,0,412,0,0,412,205,5
205,9,384,0,0,0,0,384,205,9
205,10,0,0,592,0,0,592,205,10
205,12,0,0,473,0,0,473,205,12
205,13,0,0,507,0,0,507,205,13
205,14,0,0,1177,0,0,1177,205,14
205,16,0,0,592,0,0,592,205,16
205,23,788,0,0,0,0,788,205,23
205,25,0,0,384,0,0,384,205,25
205,27,0,0,384,0,0,384,205,27
205,28,3851,0,0,0,0,3851,205,28
205,29,384,0,0,0,0,384,205,29
205,38,0,0,845,0,0,845,205,38
205,41,0,0,592,0,0,592,205,41
205,42,1577,0,0,0,0,1577,205,42
205,53,0,0,788,0,0,788,205,53
205,57,0,0,788,0,0,788,205,57
205,60,0,0,384,0,0,384,205,60
205,68,0,0,384,0,0,384,205,68
205,81,0,0,592,0,0,592,205,81
205,93,0,0,796,0,0,796,205,93
205,95,0,0,592,0,0,592,205,95
205,97,0,0,382,0,0,382,205,97
205,99,0,0,384,0,0,384,205,99
205,106,0,0,2185,0,0,2185,205,106
205,167,0,0,1942,0,0,1942,205,167
205,168,0,0,473,0,0,473,205,168
205,169,0,0,412,0,0,412,205,169
205,170,384,0,0,0,0,384,205,170
205,171,0,0,1630,0,0,1630,205,171
205,173,0,0,1028,0,0,1028,205,173
205,177,46,0,0,0,0,46,205,177
205,181,0,0,448,0,0,448,205,181
205,182,0,0,858,0,0,858,205,182
205,184,1130,0,0,0,0,1130,205,184
205,187,384,0,1126,0,0,1510,205,187
205,188,0,0,644,0,0,644,205,188
205,190,0,0,644,0,0,644,205,190
205,193,0,0,1501,0,557,2058,205,193
205,195,0,0,680,0,0,680,205,195
205,197,0,0,418,0,0,418,205,197
205,198,0,0,1850,0,0,1850,205,198
205,202,451,0,0,0,0,451,205,202
205,204,0,1032,0,0,0,1032,205,204
205,205,1621,56059,1287,0,0,58967,205,205
205,206,3612,5328,1694,2809,0,13443,205,206
205,207,5546,4353,1892,1108,0,12899,205,207
205,208,0,0,728,0,0,728,205,208
205,209,384,0,0,0,0,384,205,209
205,210,0,0,384,0,0,384,205,210
205,216,0,0,418,0,0,418,205,216
205,221,0,0,384,0,0,384,205,221
205,222,592,0,0,0,0,592,205,222
205,226,0,0,418,0,0,418,205,226
205,231,0,0,644,0,0,644,205,231
205,239,0,0,384,0,0,384,205,239
205,247,0,0,384,0,0,384,205,247
205,250,0,0,384,0,0,384,205,250
205,260,0,0,858,0,0,858,205,260
205,267,592,0,0,0,0,592,205,267
205,300,0,0,384,0,0,384,205,300
205,303,55,0,0,0,0,55,205,303
205,319,0,0,0,384,0,384,205,319
205,341,0,0,140,0,0,140,205,341
206,1,0,0,1701,0,0,1701,206,1
206,2,0,0,974,0,0,974,206,2
206,14,0,0,598,0,0,598,206,14
206,18,0,0,598,0,0,598,206,18
206,24,0,0,235,0,0,235,206,24
206,44,486,0,0,0,0,486,206,44
206,75,56,0,0,0,0,56,206,75
206,79,0,0,819,0,0,819,206,79
206,95,102,0,0,0,0,102,206,95
206,99,0,0,489,0,0,489,206,99
206,107,486,0,0,0,0,486,206,107
206,156,486,0,0,0,0,486,206,156
206,161,0,0,528,0,0,528,206,161
206,167,0,0,528,0,0,528,206,167
206,169,0,0,2605,0,0,2605,206,169
206,170,0,0,428,0,0,428,206,170
206,171,750,0,528,0,0,1278,206,171
206,175,247,0,0,0,0,247,206,175
206,178,0,0,891,0,0,891,206,178
206,182,0,0,512,0,0,512,206,182
206,185,0,0,72,0,0,72,206,185
206,188,235,0,2200,0,0,2435,206,188
206,189,631,0,0,0,0,631,206,189
206,190,0,0,111,0,0,111,206,190
206,197,47,0,0,0,0,47,206,197
206,198,88,0,1226,0,0,1314,206,198
206,200,2858,2051,606,293,321,6129,206,200
206,201,1946,2438,1724,3298,0,9406,206,201
206,202,451,1331,0,0,0,1782,206,202
206,204,550,0,0,0,0,550,206,204
206,205,4536,4944,2552,3193,0,15225,206,205
206,206,5347,16320,2296,4609,0,28572,206,206
206,207,2060,1649,2677,2480,158,9024,206,207
206,210,0,0,489,0,0,489,206,210
206,213,0,0,256,0,0,256,206,213
206,226,486,0,0,0,0,486,206,226
206,227,235,0,0,0,0,235,206,227
206,241,0,0,0,235,0,235,206,241
206,247,0,0,0,582,0,582,206,247
206,275,0,0,159,0,0,159,206,275
206,300,95,0,0,0,0,95,206,300
207,2,0,0,594,0,0,594,207,2
207,6,0,0,1138,0,0,1138,207,6
207,7,0,0,1138,0,0,1138,207,7
207,13,0,0,1272,0,0,1272,207,13
207,16,0,0,202,0,0,202,207,16
207,18,722,0,0,0,0,722,207,18
207,25,0,0,924,0,0,924,207,25
207,28,0,0,1005,0,0,1005,207,28
207,36,0,0,361,0,0,361,207,36
207,43,63,0,0,0,0,63,207,43
207,54,0,0,878,0,0,878,207,54
207,59,0,0,361,0,0,361,207,59
207,61,0,0,516,0,0,516,207,61
207,64,120,0,0,516,0,636,207,64
207,74,0,0,361,0,0,361,207,74
207,79,971,0,0,0,0,971,207,79
207,82,164,0,0,0,0,164,207,82
207,94,0,0,593,0,0,593,207,94
207,140,0,0,373,0,0,373,207,140
207,161,0,0,445,0,0,445,207,161
207,168,0,0,445,0,0,445,207,168
207,181,0,0,436,0,0,436,207,181
207,183,2511,0,746,0,0,3257,207,183
207,186,0,0,0,97,0,97,207,186
207,188,0,0,252,0,0,252,207,188
207,193,1202,0,0,0,0,1202,207,193
207,194,0,0,298,0,0,298,207,194
207,197,0,0,103,0,0,103,207,197
207,198,0,0,3584,0,0,3584,207,198
207,200,497,2258,241,0,158,3154,207,200
207,201,0,0,252,0,0,252,207,201
207,202,0,0,1038,0,0,1038,207,202
207,205,4622,4353,1035,1108,0,11118,207,205
207,206,4403,1649,3534,804,0,10390,207,206
207,207,1508,58743,3207,2629,0,66087,207,207
207,221,0,0,0,328,0,328,207,221
207,227,674,0,0,0,0,674,207,227
207,233,616,0,0,220,0,836,207,233
207,252,0,0,105,0,0,105,207,252
207,255,0,0,1138,0,0,1138,207,255
207,266,0,0,48,0,0,48,207,266
207,282,1321,0,0,0,0,1321,207,282
207,342,0,0,373,0,0,373,207,342
208,3,268,0,0,0,0,268,208,3
208,4,0,0,826,0,0,826,208,4
208,11,23,0,0,0,0,23,208,11
208,17,537,0,21,0,0,558,208,17
208,18,0,0,447,0,0,447,208,18
208,19,0,0,495,0,0,495,208,19
208,21,0,0,349,0,0,349,208,21
208,24,142,0,455,0,0,597,208,24
208,27,268,0,0,0,0,268,208,27
208,29,268,0,0,0,0,268,208,29
208,31,0,0,348,0,0,348,208,31
208,38,0,0,19,0,0,19,208,38
208,39,247,0,0,0,0,247,208,39
208,40,537,0,455,0,0,992,208,40
208,41,0,0,0,204,0,204,208,41
208,42,112,0,81,0,0,193,208,42
208,43,0,0,990,0,0,990,208,43
208,44,268,0,0,0,0,268,208,44
208,45,0,0,1321,0,0,1321,208,45
208,48,310,0,318,0,0,628,208,48
208,57,210,0,0,0,0,210,208,57
208,72,0,0,268,0,0,268,208,72
208,73,268,0,0,268,0,536,208,73
208,94,0,0,402,0,0,402,208,94
208,97,0,0,35,0,0,35,208,97
208,107,0,0,142,0,0,142,208,107
208,110,267,0,0,0,0,267,208,110
208,128,0,0,255,0,0,255,208,128
208,139,122,0,0,0,0,122,208,139
208,161,0,0,0,307,0,307,208,161
208,165,0,0,826,45,0,871,208,165
208,166,789,3816,514,1870,0,6989,208,166
208,167,1558,0,2197,268,660,4683,208,167
208,168,1021,0,438,204,0,1663,208,168
208,169,665,232,359,528,0,1784,208,169
208,173,215,0,311,0,0,526,208,173
208,176,228,0,292,0,0,520,208,176
208,182,473,0,0,0,0,473,208,182
208,183,0,0,894,0,0,894,208,183
208,184,370,0,0,0,0,370,208,184
208,186,0,0,80,0,0,80,208,186
208,188,0,0,951,0,0,951,208,188
208,189,0,0,665,0,0,665,208,189
208,193,278,0,0,0,0,278,208,193
208,195,0,0,247,0,0,247,208,195
208,196,120,0,0,0,0,120,208,196
208,197,0,0,180,0,0,180,208,197
208,198,0,0,387,0,0,387,208,198
208,200,222,0,296,0,93,611,208,200
208,201,0,0,1558,0,0,1558,208,201
208,204,255,0,0,0,0,255,208,204
208,205,0,0,728,0,0,728,208,205
208,208,5488,16206,1460,816,0,23970,208,208
208,209,1051,3399,1060,371,0,5881,208,209
208,210,1945,75,200,0,0,2220,208,210
208,211,0,0,1040,0,0,1040,208,211
208,212,70,0,1078,0,0,1148,208,212
208,213,3205,0,546,0,0,3751,208,213
208,214,1593,1648,352,204,0,3797,208,214
208,215,2067,0,168,0,0,2235,208,215
208,218,482,0,1359,0,0,1841,208,218
208,220,239,0,322,0,0,561,208,220
208,221,537,0,0,425,0,962,208,221
208,222,223,0,0,0,0,223,208,222
208,223,210,0,0,0,0,210,208,223
208,225,0,0,399,0,0,399,208,225
208,226,0,0,567,0,0,567,208,226
208,227,240,0,0,0,0,240,208,227
208,230,0,0,333,0,0,333,208,230
208,231,0,0,165,0,0,165,208,231
208,232,40,0,341,0,0,381,208,232
208,234,465,0,287,0,0,752,208,234
208,254,2207,0,0,0,0,2207,208,254
208,255,0,0,0,688,0,688,208,255
208,258,809,0,0,0,0,809,208,258
208,261,0,0,292,0,0,292,208,261
208,262,370,0,1361,0,0,1731,208,262
208,265,0,0,507,0,0,507,208,265
208,274,0,0,344,0,0,344,208,274
208,284,0,0,325,0,0,325,208,284
208,318,0,0,268,0,0,268,208,318
209,1,0,0,206,0,0,206,209,1
209,3,0,0,620,0,0,620,209,3
209,5,0,0,870,0,0,870,209,5
209,6,0,0,507,0,0,507,209,6
209,8,0,0,466,0,0,466,209,8
209,13,0,0,18,0,0,18,209,13
209,16,0,0,373,0,0,373,209,16
209,18,0,0,250,0,0,250,209,18
209,24,0,0,379,0,0,379,209,24
209,27,1398,0,0,0,0,1398,209,27
209,35,0,0,195,0,0,195,209,35
209,36,0,0,131,0,0,131,209,36
209,43,63,0,507,0,0,570,209,43
209,44,0,0,190,0,0,190,209,44
209,46,0,0,0,761,0,761,209,46
209,48,711,0,0,0,0,711,209,48
209,53,59,0,0,0,0,59,209,53
209,62,0,0,116,0,0,116,209,62
209,64,1572,0,0,0,0,1572,209,64
209,70,174,0,0,0,0,174,209,70
209,74,0,0,0,206,0,206,209,74
209,75,255,0,0,0,0,255,209,75
209,79,0,0,986,0,0,986,209,79
209,81,0,0,640,0,0,640,209,81
209,82,0,0,411,0,0,411,209,82
209,93,0,0,174,0,0,174,209,93
209,100,0,0,466,0,0,466,209,100
209,128,0,0,10,0,0,10,209,128
209,162,0,0,507,0,0,507,209,162
209,166,5346,0,0,0,0,5346,209,166
209,167,620,0,337,0,0,957,209,167
209,170,0,0,965,0,0,965,209,170
209,173,466,0,0,0,0,466,209,173
209,177,0,0,50,0,0,50,209,177
209,180,337,0,954,0,0,1291,209,180
209,183,466,0,0,0,0,466,209,183
209,189,397,0,0,0,0,397,209,189
209,190,0,0,504,0,0,504,209,190
209,202,0,0,0,444,0,444,209,202
209,205,384,0,0,0,0,384,209,205
209,208,1162,3399,1060,0,0,5621,209,208
209,209,5572,14325,0,3595,0,23492,209,209
209,210,1554,1874,745,0,0,4173,209,210
209,211,2437,0,368,0,0,2805,209,211
209,212,0,0,661,0,0,661,209,212
209,213,1652,143,1017,1394,0,4206,209,213
209,214,553,1344,0,371,0,2268,209,214
209,215,1654,285,210,0,0,2149,209,215
209,216,0,0,736,0,0,736,209,216
209,219,1395,0,224,0,0,1619,209,219
209,220,0,0,899,0,0,899,209,220
209,221,727,0,962,0,0,1689,209,221
209,222,0,0,242,0,0,242,209,222
209,225,0,0,363,0,0,363,209,225
209,253,0,0,39,0,0,39,209,253
209,256,466,0,0,0,0,466,209,256
209,257,255,0,0,0,0,255,209,257
209,258,473,0,0,0,0,473,209,258
209,264,0,0,563,0,0,563,209,264
209,265,0,0,507,0,0,507,209,265
209,267,0,0,402,0,0,402,209,267
209,274,0,0,174,0,0,174,209,274
209,313,230,0,0,0,0,230,209,313
209,335,0,0,507,0,0,507,209,335
209,339,0,0,212,0,0,212,209,339
209,341,466,0,0,0,0,466,209,341
210,1,0,0,560,0,0,560,210,1
210,3,117,0,0,0,0,117,210,3
210,4,122,0,0,117,0,239,210,4
210,5,0,0,234,0,0,234,210,5
210,6,0,0,542,0,0,542,210,6
210,10,117,0,0,0,0,117,210,10
210,13,623,0,0,0,0,623,210,13
210,21,0,0,111,0,0,111,210,21
210,29,97,0,0,0,0,97,210,29
210,31,0,0,326,0,0,326,210,31
210,32,0,0,782,0,0,782,210,32
210,36,0,0,131,0,0,131,210,36
210,39,78,0,0,0,0,78,210,39
210,40,0,0,60,0,0,60,210,40
210,41,0,0,491,371,0,862,210,41
210,43,252,98,966,0,0,1316,210,43
210,44,117,0,0,0,0,117,210,44
210,46,584,0,0,0,0,584,210,46
210,48,469,2272,131,0,0,2872,210,48
210,52,371,0,0,0,0,371,210,52
210,55,117,0,0,0,0,117,210,55
210,68,0,0,326,0,0,326,210,68
210,70,97,0,0,0,0,97,210,70
210,73,111,0,0,0,0,111,210,73
210,76,38,0,0,0,0,38,210,76
210,78,111,0,97,0,0,208,210,78
210,79,117,0,0,0,0,117,210,79
210,80,0,0,93,0,0,93,210,80
210,81,0,0,97,0,0,97,210,81
210,82,97,0,0,0,0,97,210,82
210,87,57,0,0,0,0,57,210,87
210,88,391,0,0,0,0,391,210,88
210,91,0,0,519,0,0,519,210,91
210,93,20,0,391,0,0,411,210,93
210,100,1450,0,0,0,0,1450,210,100
210,116,0,0,537,0,0,537,210,116
210,129,35,0,0,0,0,35,210,129
210,136,0,0,0,117,0,117,210,136
210,144,222,0,0,0,0,222,210,144
210,145,0,0,48,0,0,48,210,145
210,155,0,0,170,0,0,170,210,155
210,161,97,0,0,0,0,97,210,161
210,166,1944,656,127,214,0,2941,210,166
210,167,1339,467,647,0,0,2453,210,167
210,169,202,0,280,0,0,482,210,169
210,171,0,0,391,0,0,391,210,171
210,172,233,0,238,111,0,582,210,172
210,174,0,0,357,0,0,357,210,174
210,180,0,0,228,0,0,228,210,180
210,181,277,0,445,0,0,722,210,181
210,183,0,0,303,0,0,303,210,183
210,184,159,0,0,0,0,159,210,184
210,186,195,0,0,0,0,195,210,186
210,187,0,0,273,0,0,273,210,187
210,189,0,0,102,0,0,102,210,189
210,190,0,0,458,0,0,458,210,190
210,191,0,0,859,0,0,859,210,191
210,194,0,0,121,0,0,121,210,194
210,196,0,0,133,0,0,133,210,196
210,198,0,0,275,0,0,275,210,198
210,205,0,0,473,0,0,473,210,205
210,206,0,0,489,0,0,489,210,206
210,208,1437,75,0,0,0,1512,210,208
210,209,1668,1550,745,0,0,3963,210,209
210,210,4742,10880,127,2629,0,18378,210,210
210,211,7106,2712,3163,1153,1505,15639,210,211
210,212,98,0,742,0,0,840,210,212
210,213,793,0,315,0,0,1108,210,213
210,214,247,323,0,0,0,570,210,214
210,215,391,0,0,0,0,391,210,215
210,218,117,0,0,0,0,117,210,218
210,219,0,0,189,0,0,189,210,219
210,221,0,0,207,0,0,207,210,221
210,222,223,0,697,0,0,920,210,222
210,223,0,0,637,0,0,637,210,223
210,226,493,0,0,0,0,493,210,226
210,228,0,0,687,0,0,687,210,228
210,229,0,0,935,0,0,935,210,229
210,230,0,0,333,0,0,333,210,230
210,232,0,0,212,0,0,212,210,232
210,233,220,0,338,0,0,558,210,233
210,253,0,0,40,0,0,40,210,253
210,254,2353,0,633,0,0,2986,210,254
210,255,442,0,825,0,0,1267,210,255
210,257,0,0,598,529,0,1127,210,257
210,258,237,0,0,0,0,237,210,258
210,261,426,0,347,0,0,773,210,261
210,262,0,0,915,0,0,915,210,262
210,263,1525,0,1659,0,0,3184,210,263
210,264,1417,0,563,0,0,1980,210,264
210,265,0,0,0,591,0,591,210,265
210,266,700,0,0,0,0,700,210,266
210,267,0,0,166,0,0,166,210,267
210,273,0,0,568,0,0,568,210,273
210,318,292,0,0,0,0,292,210,318
211,1,0,0,623,0,0,623,211,1
211,7,0,0,0,1368,0,1368,211,7
211,9,0,0,812,0,0,812,211,9
211,12,519,0,0,0,0,519,211,12
211,14,0,0,812,0,0,812,211,14
211,16,129,0,0,0,0,129,211,16
211,17,0,0,677,0,0,677,211,17
211,30,623,0,0,0,0,623,211,30
211,40,0,0,40,0,0,40,211,40
211,41,623,0,0,0,0,623,211,41
211,43,0,0,677,0,0,677,211,43
211,44,0,0,677,0,0,677,211,44
211,45,0,0,812,0,0,812,211,45
211,46,2167,2886,0,1288,0,6341,211,46
211,48,0,0,1716,0,0,1716,211,48
211,53,45,0,684,0,0,729,211,53
211,61,0,0,338,0,0,338,211,61
211,66,58,0,0,0,69,127,211,66
211,68,744,0,0,0,0,744,211,68
211,74,677,0,0,0,0,677,211,74
211,80,0,0,623,0,0,623,211,80
211,82,0,0,746,0,0,746,211,82
211,95,0,0,0,398,0,398,211,95
211,161,0,0,564,0,0,564,211,161
211,165,0,0,0,0,46,46,211,165
211,166,676,0,1238,0,0,1914,211,166
211,167,0,0,2287,0,0,2287,211,167
211,168,986,0,1100,0,0,2086,211,168
211,169,0,0,963,0,0,963,211,169
211,170,0,0,812,0,0,812,211,170
211,193,0,0,302,0,0,302,211,193
211,199,0,0,501,0,0,501,211,199
211,203,190,0,0,0,0,190,211,203
211,208,0,0,1240,0,0,1240,211,208
211,209,2437,0,368,0,0,2805,211,209
211,210,7052,2712,3527,762,1505,15558,211,210
211,211,7312,12183,8481,797,0,28773,211,211
211,212,1225,964,439,135,0,2763,211,212
211,213,1936,0,1260,492,0,3688,211,213
211,214,323,0,0,0,0,323,211,214
211,215,746,0,0,0,0,746,211,215
211,221,338,0,0,119,0,457,211,221
211,223,338,0,431,0,0,769,211,223
211,225,338,0,146,0,0,484,211,225
211,233,0,0,239,0,0,239,211,233
211,244,552,0,229,0,0,781,211,244
211,253,0,0,24,0,0,24,211,253
211,254,665,0,0,0,0,665,211,254
211,256,219,0,0,0,0,219,211,256
211,257,519,962,0,0,0,1481,211,257
211,258,0,0,1187,0,0,1187,211,258
211,259,585,0,0,0,0,585,211,259
211,261,2310,2836,0,0,0,5146,211,261
211,262,0,0,2611,0,0,2611,211,262
211,263,338,0,1001,0,0,1339,211,263
211,264,0,0,877,391,0,1268,211,264
211,265,835,0,0,0,0,835,211,265
211,266,361,0,0,0,0,361,211,266
211,317,0,0,623,0,0,623,211,317
212,4,0,0,376,0,0,376,212,4
212,7,0,0,49,0,0,49,212,7
212,14,0,0,381,0,0,381,212,14
212,15,0,0,0,403,0,403,212,15
212,32,0,0,403,0,0,403,212,32
212,36,0,0,653,0,0,653,212,36
212,42,403,0,0,0,0,403,212,42
212,43,350,0,0,0,0,350,212,43
212,44,248,0,0,0,0,248,212,44
212,48,0,0,53,0,0,53,212,48
212,68,0,0,437,0,0,437,212,68
212,81,0,0,53,0,0,53,212,81
212,108,70,0,0,0,0,70,212,108
212,141,437,0,0,0,0,437,212,141
212,166,0,0,53,0,0,53,212,166
212,208,70,0,1078,0,0,1148,212,208
212,209,0,0,507,0,0,507,212,209
212,210,436,0,742,0,0,1178,212,210
212,211,1789,342,439,351,0,2921,212,211
212,212,2151,15213,0,1206,0,18570,212,212
212,213,385,2914,2331,0,0,5630,212,213
212,215,467,0,0,0,0,467,212,215
212,221,1328,0,334,0,0,1662,212,221
212,222,223,0,1036,0,0,1259,212,222
212,224,0,0,656,0,0,656,212,224
212,231,0,0,165,0,0,165,212,231
212,232,0,0,212,0,0,212,212,232
212,241,0,0,53,0,0,53,212,241
212,254,0,0,656,0,0,656,212,254
212,257,323,0,89,0,0,412,212,257
212,258,1407,0,1149,0,0,2556,212,258
212,261,1549,2545,0,0,0,4094,212,261
212,262,2108,2737,0,331,0,5176,212,262
212,265,343,0,573,0,0,916,212,265
212,274,0,0,653,0,0,653,212,274
212,294,0,0,656,0,0,656,212,294
213,5,0,0,256,0,0,256,213,5
213,13,143,0,0,0,0,143,213,13
213,15,0,0,194,0,0,194,213,15
213,23,0,0,1394,0,0,1394,213,23
213,41,143,0,431,0,0,574,213,41
213,42,0,0,412,0,0,412,213,42
213,43,0,0,165,0,0,165,213,43
213,44,512,0,0,0,0,512,213,44
213,45,256,0,431,0,0,687,213,45
213,46,404,0,431,0,0,835,213,46
213,47,184,0,0,0,0,184,213,47
213,48,0,0,211,0,0,211,213,48
213,53,143,0,0,0,0,143,213,53
213,54,0,0,396,0,0,396,213,54
213,68,0,0,143,0,0,143,213,68
213,73,792,0,0,0,0,792,213,73
213,77,0,0,143,0,0,143,213,77
213,83,0,0,49,0,0,49,213,83
213,90,0,0,396,0,0,396,213,90
213,107,0,0,396,0,0,396,213,107
213,154,0,0,601,0,0,601,213,154
213,156,0,0,292,0,0,292,213,156
213,162,236,0,0,0,0,236,213,162
213,164,0,0,431,0,0,431,213,164
213,165,0,0,0,396,0,396,213,165
213,166,88,0,479,848,0,1415,213,166
213,167,1552,0,0,396,0,1948,213,167
213,168,0,0,449,0,0,449,213,168
213,169,194,0,445,0,0,639,213,169
213,171,0,0,701,0,0,701,213,171
213,173,412,0,0,0,0,412,213,173
213,188,0,0,160,0,0,160,213,188
213,190,487,0,0,0,0,487,213,190
213,192,396,0,0,0,0,396,213,192
213,196,0,0,90,0,0,90,213,196
213,197,793,0,0,0,0,793,213,197
213,198,396,0,175,0,0,571,213,198
213,200,0,0,162,0,0,162,213,200
213,208,2446,0,546,0,0,2992,213,208
213,209,1262,143,1873,1394,0,4672,213,209
213,210,1311,0,315,0,0,1626,213,210
213,211,3418,0,449,888,0,4755,213,211
213,212,636,2914,2331,246,0,6127,213,212
213,213,1699,19065,1307,3287,0,25358,213,213
213,214,0,0,212,0,0,212,213,214
213,215,193,0,0,0,0,193,213,215
213,219,0,1415,1431,0,0,2846,213,219
213,220,0,0,206,0,0,206,213,220
213,221,821,0,245,2492,0,3558,213,221
213,222,719,0,418,0,0,1137,213,222
213,223,0,0,298,120,0,418,213,223
213,225,0,0,172,0,0,172,213,225
213,229,0,0,1248,0,0,1248,213,229
213,231,0,0,338,0,0,338,213,231
213,233,396,0,0,0,0,396,213,233
213,234,0,0,287,0,0,287,213,234
213,235,0,0,1308,0,0,1308,213,235
213,239,0,0,449,0,0,449,213,239
213,254,109,0,0,0,0,109,213,254
213,255,0,0,449,0,0,449,213,255
213,257,572,0,0,0,0,572,213,257
213,261,166,407,739,0,0,1312,213,261
213,262,317,0,0,0,0,317,213,262
213,264,335,0,365,0,0,700,213,264
213,265,486,0,373,0,0,859,213,265
213,266,0,327,356,0,0,683,213,266
213,267,318,0,0,0,0,318,213,267
213,286,0,0,710,0,0,710,213,286
213,339,0,0,143,0,0,143,213,339
214,1,0,0,87,0,0,87,214,1
214,2,0,0,350,0,0,350,214,2
214,4,0,0,438,0,0,438,214,4
214,5,0,0,115,0,0,115,214,5
214,6,0,0,124,0,0,124,214,6
214,12,0,0,299,0,0,299,214,12
214,15,0,0,53,0,0,53,214,15
214,39,0,0,47,0,0,47,214,39
214,43,0,0,975,0,0,975,214,43
214,44,124,0,0,0,0,124,214,44
214,46,0,0,0,0,434,434,214,46
214,47,0,0,40,0,0,40,214,47
214,53,0,0,323,0,0,323,214,53
214,57,0,0,115,0,0,115,214,57
214,59,0,0,506,0,0,506,214,59
214,74,0,0,228,0,0,228,214,74
214,76,0,0,124,0,0,124,214,76
214,82,0,0,124,0,0,124,214,82
214,84,51,0,0,0,0,51,214,84
214,89,0,0,423,0,0,423,214,89
214,96,0,0,124,0,0,124,214,96
214,108,391,0,0,0,0,391,214,108
214,128,10,0,0,0,0,10,214,128
214,131,0,0,423,0,0,423,214,131
214,134,299,0,0,0,0,299,214,134
214,161,268,0,197,0,0,465,214,161
214,162,846,0,0,0,0,846,214,162
214,166,628,0,249,0,0,877,214,166
214,167,874,0,278,0,0,1152,214,167
214,168,0,0,204,0,0,204,214,168
214,169,124,0,380,0,0,504,214,169
214,170,360,0,1554,0,0,1914,214,170
214,171,247,0,0,0,0,247,214,171
214,172,0,0,95,560,0,655,214,172
214,174,0,0,389,0,0,389,214,174
214,177,0,0,50,0,0,50,214,177
214,181,380,0,0,0,0,380,214,181
214,182,0,0,650,0,0,650,214,182
214,183,0,0,898,0,0,898,214,183
214,186,0,0,106,0,0,106,214,186
214,189,0,0,228,0,0,228,214,189
214,191,0,0,267,0,0,267,214,191
214,192,0,0,363,0,0,363,214,192
214,195,0,0,345,0,0,345,214,195
214,196,0,0,118,0,0,118,214,196
214,208,686,1790,352,575,0,3403,214,208
214,209,628,1667,0,0,0,2295,214,209
214,213,0,0,212,0,0,212,214,213
214,214,518,9748,1089,436,0,11791,214,214
214,215,585,3256,612,1843,0,6296,214,215
214,216,0,0,451,0,0,451,214,216
214,217,170,0,177,0,0,347,214,217
214,218,0,0,135,0,0,135,214,218
214,220,0,0,148,0,0,148,214,220
214,221,612,0,0,115,0,727,214,221
214,222,0,0,141,0,0,141,214,222
214,226,521,0,847,0,0,1368,214,226
214,229,0,0,1334,1064,0,2398,214,229
214,230,0,0,752,0,0,752,214,230
214,231,0,0,0,442,0,442,214,231
214,234,684,0,0,0,0,684,214,234
214,254,0,0,638,0,0,638,214,254
214,261,0,0,40,0,0,40,214,261
214,262,0,0,344,0,0,344,214,262
214,265,124,0,0,0,0,124,214,265
214,266,0,0,135,0,0,135,214,266
214,267,153,0,0,0,0,153,214,267
215,1,0,0,310,0,0,310,215,1
215,4,0,0,938,0,0,938,215,4
215,10,498,0,0,0,0,498,215,10
215,28,0,0,22,0,0,22,215,28
215,40,0,0,120,0,0,120,215,40
215,43,0,0,310,0,0,310,215,43
215,45,0,0,496,0,0,496,215,45
215,47,193,0,0,0,0,193,215,47
215,48,0,0,162,0,0,162,215,48
215,49,74,0,0,0,0,74,215,49
215,55,0,0,285,0,0,285,215,55
215,63,0,0,234,6,0,240,215,63
215,68,49,0,456,0,0,505,215,68
215,73,0,0,0,456,0,456,215,73
215,74,0,0,0,193,0,193,215,74
215,91,0,0,285,0,0,285,215,91
215,92,0,0,4,0,0,4,215,92
215,93,0,0,285,0,0,285,215,93
215,133,0,0,0,285,0,285,215,133
215,154,601,0,0,0,0,601,215,154
215,159,0,0,234,0,0,234,215,159
215,166,467,0,359,0,0,826,215,166
215,167,99,0,1232,0,0,1331,215,167
215,168,204,0,0,0,0,204,215,168
215,169,0,0,693,0,0,693,215,169
215,170,234,0,436,493,0,1163,215,170
215,171,0,1298,0,0,0,1298,215,171
215,172,121,0,0,0,0,121,215,172
215,173,0,0,393,0,0,393,215,173
215,180,234,0,498,0,0,732,215,180
215,184,0,0,185,0,0,185,215,184
215,186,0,0,146,0,0,146,215,186
215,188,293,0,0,0,0,293,215,188
215,190,421,0,0,751,0,1172,215,190
215,192,0,0,242,0,0,242,215,192
215,193,0,0,485,0,0,485,215,193
215,200,0,0,109,0,0,109,215,200
215,201,0,0,0,372,0,372,215,201
215,204,0,0,825,0,0,825,215,204
215,206,0,0,256,0,0,256,215,206
215,208,2458,0,0,0,0,2458,215,208
215,209,1654,285,210,0,0,2149,215,209
215,211,746,0,0,0,0,746,215,211
215,212,467,0,0,0,0,467,215,212
215,213,193,0,0,0,0,193,215,213
215,214,812,3029,612,1843,0,6296,215,214
215,215,6679,13399,182,800,0,21060,215,215
215,216,2246,1338,727,422,0,4733,215,216
215,217,0,0,170,0,0,170,215,217
215,218,2068,714,496,0,0,3278,215,218
215,219,4356,0,374,521,0,5251,215,219
215,220,375,0,398,0,0,773,215,220
215,221,2216,228,358,0,0,2802,215,221
215,222,0,0,242,0,0,242,215,222
215,226,0,0,429,0,0,429,215,226
215,231,152,0,0,0,0,152,215,231
215,245,0,0,127,0,0,127,215,245
215,255,0,0,0,41,0,41,215,255
215,258,237,0,0,0,0,237,215,258
215,261,0,0,292,0,0,292,215,261
215,263,0,0,312,0,0,312,215,263
215,266,114,0,0,0,0,114,215,266
215,267,423,0,0,0,0,423,215,267
215,274,0,0,882,0,0,882,215,274
215,326,193,0,0,0,0,193,215,326
215,339,0,0,121,0,0,121,215,339
216,7,0,0,883,0,0,883,216,7
216,15,0,0,439,0,0,439,216,15
216,17,0,0,477,0,0,477,216,17
216,21,0,0,439,0,0,439,216,21
216,24,0,0,439,0,0,439,216,24
216,29,0,0,336,0,0,336,216,29
216,31,0,0,439,0,0,439,216,31
216,40,0,0,60,0,0,60,216,40
216,43,45,0,1079,0,0,1124,216,43
216,44,739,0,0,0,0,739,216,44
216,48,0,0,439,0,0,439,216,48
216,54,0,0,168,0,0,168,216,54
216,60,263,0,0,0,0,263,216,60
216,68,0,0,439,0,0,439,216,68
216,82,0,0,444,0,0,444,216,82
216,92,0,0,444,0,0,444,216,92
216,93,0,0,336,0,0,336,216,93
216,109,336,0,0,0,0,336,216,109
216,135,503,0,0,0,0,503,216,135
216,166,336,0,0,0,0,336,216,166
216,167,0,0,745,0,0,745,216,167
216,168,0,0,219,0,0,219,216,168
216,169,0,0,444,0,0,444,216,169
216,170,0,0,219,0,0,219,216,170
216,171,301,0,269,0,0,570,216,171
216,172,1326,0,0,0,0,1326,216,172
216,173,0,544,0,0,0,544,216,173
216,176,0,0,216,0,0,216,216,176
216,180,1753,0,0,0,0,1753,216,180
216,183,43,0,0,0,0,43,216,183
216,192,315,0,0,318,0,633,216,192
216,195,0,0,345,0,0,345,216,195
216,196,338,0,0,0,0,338,216,196
216,197,0,0,146,0,0,146,216,197
216,205,0,0,384,0,0,384,216,205
216,209,0,0,736,0,0,736,216,209
216,214,0,0,451,0,0,451,216,214
216,215,1483,1338,700,642,0,4163,216,215
216,216,6968,19883,654,1860,0,29365,216,216
216,217,525,0,366,0,0,891,216,217
216,218,3892,168,1402,1723,0,7185,216,218
216,219,1800,0,450,707,0,2957,216,219
216,221,0,0,706,0,0,706,216,221
216,223,0,0,195,0,0,195,216,223
216,229,439,0,0,0,0,439,216,229
216,230,0,0,1302,0,0,1302,216,230
216,232,0,0,796,0,0,796,216,232
216,302,301,0,0,0,0,301,216,302
216,331,0,0,473,0,0,473,216,331
217,1,0,0,637,0,0,637,217,1
217,2,0,0,467,0,0,467,217,2
217,3,170,0,0,0,0,170,217,3
217,7,0,0,447,0,0,447,217,7
217,11,0,0,0,310,0,310,217,11
217,12,363,0,0,0,0,363,217,12
217,16,363,0,639,0,0,1002,217,16
217,18,170,0,0,0,0,170,217,18
217,29,0,0,467,0,0,467,217,29
217,39,0,0,241,0,0,241,217,39
217,40,0,0,363,0,0,363,217,40
217,41,0,0,600,0,0,600,217,41
217,43,0,0,467,0,0,467,217,43
217,46,0,0,363,0,0,363,217,46
217,54,0,0,341,0,0,341,217,54
217,58,0,0,241,0,0,241,217,58
217,72,0,0,266,0,0,266,217,72
217,74,0,0,25,0,0,25,217,74
217,79,0,0,241,0,0,241,217,79
217,81,0,0,363,0,0,363,217,81
217,94,0,0,467,0,0,467,217,94
217,116,0,0,0,308,0,308,217,116
217,166,0,0,589,0,0,589,217,166
217,167,0,0,241,0,0,241,217,167
217,168,596,0,98,0,0,694,217,168
217,169,0,0,508,0,0,508,217,169
217,170,604,0,422,0,0,1026,217,170
217,171,989,0,0,0,0,989,217,171
217,173,726,2251,0,0,0,2977,217,173
217,174,0,0,1460,0,0,1460,217,174
217,182,724,0,0,0,0,724,217,182
217,183,1484,3033,0,25,0,4542,217,183
217,184,452,0,0,0,0,452,217,184
217,186,244,0,0,97,0,341,217,186
217,187,0,0,0,444,0,444,217,187
217,188,170,0,0,0,0,170,217,188
217,189,696,0,0,0,0,696,217,189
217,190,0,0,761,0,0,761,217,190
217,191,241,0,0,0,0,241,217,191
217,192,1057,1785,263,318,0,3423,217,192
217,193,794,2661,194,0,0,3649,217,193
217,196,108,0,0,0,0,108,217,196
217,200,0,0,241,0,0,241,217,200
217,204,1193,0,0,0,0,1193,217,204
217,214,170,0,177,0,0,347,217,214
217,215,0,0,185,0,0,185,217,215
217,216,170,0,890,0,0,1060,217,216
217,217,3761,14729,0,3138,0,21628,217,217
217,218,569,1235,263,517,0,2584,217,218
217,220,457,0,0,0,0,457,217,220
217,223,391,0,0,0,0,391,217,223
217,258,0,0,0,291,0,291,217,258
217,273,0,0,310,0,0,310,217,273
217,282,0,0,284,0,0,284,217,282
218,1,0,0,1993,0,0,1993,218,1
218,3,0,0,482,0,0,482,218,3
218,5,0,0,482,0,0,482,218,5
218,6,0,0,1377,0,0,1377,218,6
218,7,0,0,738,0,0,738,218,7
218,24,0,0,45,0,0,45,218,24
218,27,0,0,1177,0,0,1177,218,27
218,29,0,0,390,0,0,390,218,29
218,31,0,0,747,0,0,747,218,31
218,39,0,0,639,0,0,639,218,39
218,41,0,0,695,0,0,695,218,41
218,44,482,0,0,0,0,482,218,44
218,47,107,0,0,0,0,107,218,47
218,48,247,0,424,0,0,671,218,48
218,51,559,0,0,0,0,559,218,51
218,62,75,0,639,0,0,714,218,62
218,66,0,0,525,0,0,525,218,66
218,73,0,0,639,0,0,639,218,73
218,74,55,0,390,0,0,445,218,74
218,77,0,0,639,0,0,639,218,77
218,79,0,0,482,0,0,482,218,79
218,86,58,0,0,0,0,58,218,86
218,87,0,0,24,0,0,24,218,87
218,91,0,0,639,0,0,639,218,91
218,93,0,0,2250,0,0,2250,218,93
218,100,0,0,639,0,0,639,218,100
218,102,105,0,0,0,0,105,218,102
218,128,0,0,460,0,0,460,218,128
218,129,0,0,639,0,0,639,218,129
218,130,0,0,460,0,0,460,218,130
218,134,0,0,482,0,0,482,218,134
218,161,159,0,738,0,0,897,218,161
218,162,0,0,424,0,0,424,218,162
218,166,872,0,482,0,0,1354,218,166
218,167,482,0,695,0,0,1177,218,167
218,169,727,0,1859,0,0,2586,218,169
218,170,295,0,1390,0,0,1685,218,170
218,171,942,0,0,0,0,942,218,171
218,173,0,738,671,0,0,1409,218,173
218,174,0,277,0,0,0,277,218,174
218,181,0,0,239,0,0,239,218,181
218,183,0,0,263,0,0,263,218,183
218,184,0,0,173,0,0,173,218,184
218,185,1744,0,1084,0,0,2828,218,185
218,187,0,0,339,0,0,339,218,187
218,188,175,0,0,0,0,175,218,188
218,189,0,0,664,0,0,664,218,189
218,190,525,738,0,0,0,1263,218,190
218,191,0,0,695,0,0,695,218,191
218,192,0,0,208,0,0,208,218,192
218,193,0,0,164,0,0,164,218,193
218,195,0,0,608,0,0,608,218,195
218,203,0,0,375,0,0,375,218,203
218,204,0,0,695,0,0,695,218,204
218,206,0,0,0,235,0,235,218,206
218,208,482,0,1359,0,0,1841,218,208
218,209,0,0,0,164,0,164,218,209
218,210,117,0,0,0,0,117,218,210
218,214,0,0,135,0,0,135,218,214
218,215,2671,714,496,0,0,3881,218,215
218,216,1822,168,878,1723,0,4591,218,216
218,217,569,1717,695,517,0,3498,218,217
218,218,10610,46756,3051,3266,0,63683,218,218
218,219,2093,0,773,803,0,3669,218,219
218,220,558,873,915,0,0,2346,218,220
218,221,821,0,810,0,0,1631,218,221
218,222,123,0,0,0,0,123,218,222
218,223,0,0,567,0,0,567,218,223
218,226,381,0,521,532,0,1434,218,226
218,227,384,0,0,0,0,384,218,227
218,232,0,0,995,0,0,995,218,232
218,239,104,0,0,0,0,104,218,239
218,263,482,0,0,0,0,482,218,263
218,267,318,0,803,0,0,1121,218,267
218,289,0,0,0,639,0,639,218,289
218,306,0,0,610,0,0,610,218,306
218,338,0,0,639,0,0,639,218,338
219,2,60,0,343,0,0,403,219,2
219,5,0,0,924,0,0,924,219,5
219,6,343,0,0,0,0,343,219,6
219,7,0,0,447,0,0,447,219,7
219,41,0,0,362,0,0,362,219,41
219,43,0,0,508,0,0,508,219,43
219,45,0,0,227,0,0,227,219,45
219,49,0,0,894,0,0,894,219,49
219,75,56,0,0,0,0,56,219,75
219,77,0,0,0,343,0,343,219,77
219,82,0,0,0,343,0,343,219,82
219,88,0,0,343,0,0,343,219,88
219,91,343,0,1365,0,0,1708,219,91
219,99,0,0,343,0,0,343,219,99
219,129,591,0,594,0,0,1185,219,129
219,136,0,0,343,0,0,343,219,136
219,166,594,0,0,0,0,594,219,166
219,167,1787,0,998,0,0,2785,219,167
219,169,0,0,1915,0,0,1915,219,169
219,170,0,0,295,0,0,295,219,170
219,171,0,0,975,0,0,975,219,171
219,184,159,0,0,0,0,159,219,184
219,189,0,0,527,0,0,527,219,189
219,194,0,0,298,0,0,298,219,194
219,198,0,0,646,0,0,646,219,198
219,199,0,0,447,0,0,447,219,199
219,209,1395,0,224,0,0,1619,219,209
219,210,0,0,189,0,0,189,219,210
219,213,0,1415,1431,0,0,2846,219,213
219,215,5346,0,374,0,0,5720,219,215
219,216,1800,0,632,707,0,3139,219,216
219,218,1493,0,773,803,0,3069,219,218
219,219,11537,22793,447,3231,3448,41456,219,219
219,220,1202,0,200,288,0,1690,219,220
219,221,1192,3808,401,1415,0,6816,219,221
219,222,600,0,0,0,0,600,219,222
219,229,0,0,935,0,0,935,219,229
219,232,0,0,212,0,0,212,219,232
219,233,0,0,338,0,0,338,219,233
219,235,0,0,601,0,0,601,219,235
219,239,0,0,646,0,0,646,219,239
219,256,343,0,0,0,0,343,219,256
219,263,0,0,312,0,0,312,219,263
219,265,0,0,374,0,0,374,219,265
219,266,217,0,0,0,0,217,219,266
219,271,0,0,773,0,0,773,219,271
219,304,125,0,0,0,0,125,219,304
219,320,0,0,249,0,0,249,219,320
220,1,0,0,184,0,0,184,220,1
220,5,296,0,766,0,0,1062,220,5
220,12,0,0,239,0,0,239,220,12
220,15,239,0,0,0,0,239,220,15
220,16,0,0,412,0,267,679,220,16
220,30,0,0,245,0,0,245,220,30
220,39,136,0,0,0,0,136,220,39
220,40,0,0,331,0,0,331,220,40
220,42,0,0,296,0,0,296,220,42
220,44,239,0,239,0,0,478,220,44
220,45,0,0,466,0,0,466,220,45
220,60,0,0,200,0,0,200,220,60
220,74,0,0,141,0,0,141,220,74
220,79,0,0,567,0,0,567,220,79
220,81,0,0,184,0,0,184,220,81
220,83,62,0,0,0,0,62,220,83
220,158,0,0,296,0,0,296,220,158
220,162,239,0,0,0,0,239,220,162
220,165,0,0,184,0,0,184,220,165
220,166,0,0,296,0,0,296,220,166
220,167,0,0,322,0,0,322,220,167
220,170,0,0,308,0,0,308,220,170
220,183,136,0,0,0,0,136,220,183
220,188,0,0,595,0,0,595,220,188
220,189,0,0,644,0,0,644,220,189
220,190,871,2002,2335,0,0,5208,220,190
220,193,0,0,259,0,0,259,220,193
220,202,239,0,0,0,0,239,220,202
220,208,239,0,322,0,0,561,220,208
220,209,0,0,591,0,0,591,220,209
220,211,0,0,322,0,0,322,220,211
220,212,0,0,334,0,0,334,220,212
220,213,0,0,206,0,0,206,220,213
220,214,0,0,148,0,0,148,220,214
220,215,375,0,398,0,0,773,220,215
220,217,457,0,0,0,0,457,220,217
220,218,459,873,849,0,0,2181,220,218
220,219,1494,0,0,288,0,1782,220,219
220,220,2182,17715,1785,565,0,22247,220,220
220,221,1316,1657,1869,62,0,4904,220,221
220,222,2579,1756,1064,1401,0,6800,220,222
220,223,1053,0,0,0,0,1053,220,223
220,224,62,239,0,0,0,301,220,224
220,225,0,0,322,0,0,322,220,225
220,229,0,0,1391,0,0,1391,220,229
220,233,0,0,322,0,0,322,220,233
220,235,0,0,322,0,0,322,220,235
220,257,189,0,0,0,0,189,220,257
220,261,296,0,0,0,0,296,220,261
220,272,0,0,296,0,0,296,220,272
221,1,0,0,263,0,0,263,221,1
221,5,0,0,727,0,0,727,221,5
221,10,0,0,53,0,0,53,221,10
221,14,0,0,425,0,0,425,221,14
221,15,0,0,462,0,0,462,221,15
221,23,0,0,425,0,0,425,221,23
221,32,0,0,263,0,0,263,221,32
221,41,655,0,364,0,0,1019,221,41
221,43,0,0,402,0,0,402,221,43
221,45,0,0,0,299,0,299,221,45
221,48,0,0,858,0,0,858,221,48
221,55,0,0,671,0,0,671,221,55
221,59,0,0,425,0,0,425,221,59
221,66,0,0,281,0,0,281,221,66
221,67,0,0,727,0,0,727,221,67
221,93,0,0,281,0,0,281,221,93
221,94,0,0,364,0,0,364,221,94
221,132,0,0,225,0,0,225,221,132
221,135,364,0,0,0,0,364,221,135
221,161,0,0,0,297,0,297,221,161
221,165,0,0,35,0,0,35,221,165
221,166,72,0,48,0,0,120,221,166
221,167,0,0,78,0,0,78,221,167
221,169,0,0,84,0,0,84,221,169
221,173,0,0,53,0,0,53,221,173
221,181,656,0,0,0,0,656,221,181
221,182,0,0,0,0,527,527,221,182
221,190,244,0,0,0,0,244,221,190
221,196,0,0,0,215,0,215,221,196
221,198,161,0,0,0,0,161,221,198
221,201,0,0,1106,0,0,1106,221,201
221,203,0,0,207,0,0,207,221,203
221,205,46,0,384,0,0,430,221,205
221,207,0,0,0,328,0,328,221,207
221,208,537,0,0,425,0,962,221,208
221,209,727,0,962,0,0,1689,221,209
221,210,338,0,207,0,0,545,221,210
221,211,0,0,0,119,0,119,221,211
221,212,1328,0,0,0,0,1328,221,212
221,213,1333,0,245,2492,0,4070,221,213
221,214,612,0,0,115,0,727,221,214
221,215,1613,0,605,0,0,2218,221,215
221,216,0,0,483,0,0,483,221,216
221,217,363,0,0,0,0,363,221,217
221,218,1424,0,810,0,0,2234,221,218
221,219,1993,3785,401,1415,0,7594,221,219
221,220,1260,1986,1707,62,0,5015,221,220
221,221,14300,14658,1978,2135,0,33071,221,221
221,222,307,1164,396,610,0,2477,221,222
221,223,225,0,0,0,0,225,221,223
221,230,0,0,1386,0,0,1386,221,230
221,231,709,0,433,0,0,1142,221,231
221,232,0,0,740,0,0,740,221,232
221,233,436,0,577,0,0,1013,221,233
221,234,465,0,0,0,0,465,221,234
221,235,347,0,1308,0,0,1655,221,235
221,243,0,0,434,0,0,434,221,243
221,254,0,0,358,0,0,358,221,254
221,261,251,0,0,0,0,251,221,261
221,263,0,0,634,0,0,634,221,263
221,264,0,0,744,0,0,744,221,264
221,265,46,0,0,0,0,46,221,265
221,266,0,0,356,0,0,356,221,266
221,267,1294,0,203,0,0,1497,221,267
221,280,263,0,0,0,0,263,221,280
221,304,0,0,225,0,0,225,221,304
222,2,1489,0,0,0,0,1489,222,2
222,5,0,0,812,0,0,812,222,5
222,6,0,0,0,223,0,223,222,6
222,17,0,0,223,0,0,223,222,17
222,23,0,0,315,0,0,315,222,23
222,24,0,0,352,0,0,352,222,24
222,26,0,0,145,0,0,145,222,26
222,27,60,0,0,0,0,60,222,27
222,28,0,0,223,0,0,223,222,28
222,29,0,0,223,0,0,223,222,29
222,32,223,0,202,0,0,425,222,32
222,39,0,0,95,0,0,95,222,39
222,40,202,0,560,0,0,762,222,40
222,41,0,0,220,0,0,220,222,41
222,43,775,0,681,0,0,1456,222,43
222,46,0,0,623,0,0,623,222,46
222,52,0,0,315,0,0,315,222,52
222,54,0,0,223,0,0,223,222,54
222,68,0,0,128,0,0,128,222,68
222,74,0,0,202,0,0,202,222,74
222,88,0,0,496,0,0,496,222,88
222,100,0,0,223,0,0,223,222,100
222,166,202,0,0,0,0,202,222,166
222,167,445,0,364,0,0,809,222,167
222,168,849,0,199,0,0,1048,222,168
222,169,0,0,1361,0,0,1361,222,169
222,170,223,0,797,0,0,1020,222,170
222,183,0,0,80,0,0,80,222,183
222,188,550,0,0,0,0,550,222,188
222,189,821,0,0,0,0,821,222,189
222,190,3258,2881,0,0,0,6139,222,190
222,191,202,223,0,0,0,425,222,191
222,194,0,0,298,0,0,298,222,194
222,195,367,0,0,0,0,367,222,195
222,196,244,0,367,0,0,611,222,196
222,201,1319,0,0,0,0,1319,222,201
222,202,48,0,51,0,0,99,222,202
222,203,190,0,466,0,0,656,222,203
222,205,592,0,0,0,0,592,222,205
222,208,223,0,0,0,0,223,222,208
222,209,141,0,242,0,0,383,222,209
222,210,223,0,697,0,0,920,222,210
222,212,0,0,883,0,0,883,222,212
222,213,0,0,660,0,0,660,222,213
222,214,0,0,469,0,0,469,222,214
222,215,0,0,242,0,0,242,222,215
222,218,600,0,0,0,0,600,222,218
222,220,3322,1632,756,1035,0,6745,222,220
222,221,0,1164,730,388,0,2282,222,221
222,222,9633,12934,1080,1144,0,24791,222,222
222,223,1206,1418,761,935,0,4320,222,223
222,224,223,0,569,0,0,792,222,224
222,225,257,0,0,0,0,257,222,225
222,230,0,0,680,0,0,680,222,230
222,231,0,0,398,0,0,398,222,231
222,234,0,0,238,0,0,238,222,234
222,254,0,0,540,0,0,540,222,254
222,261,0,0,464,0,0,464,222,261
222,265,496,0,1019,0,0,1515,222,265
222,266,294,0,154,198,0,646,222,266
222,275,0,0,252,0,0,252,222,275
222,297,25,0,0,0,0,25,222,297
222,300,0,0,128,0,0,128,222,300
222,302,0,0,223,0,0,223,222,302
223,2,0,0,1139,0,0,1139,223,2
223,3,0,0,274,0,0,274,223,3
223,7,0,0,210,0,0,210,223,7
223,20,0,0,55,0,0,55,223,20
223,29,0,0,391,0,0,391,223,29
223,32,396,0,0,0,0,396,223,32
223,36,0,0,120,0,0,120,223,36
223,39,0,0,120,0,0,120,223,39
223,44,0,0,168,0,0,168,223,44
223,55,0,0,130,0,0,130,223,55
223,56,0,0,274,0,0,274,223,56
223,82,0,0,171,0,0,171,223,82
223,91,0,0,171,0,0,171,223,91
223,93,0,0,391,0,0,391,223,93
223,131,0,0,391,0,0,391,223,131
223,137,0,0,168,0,0,168,223,137
223,154,0,0,120,0,0,120,223,154
223,184,548,0,0,0,0,548,223,184
223,187,0,0,242,0,0,242,223,187
223,188,244,0,0,0,0,244,223,188
223,189,548,397,0,266,0,1211,223,189
223,190,640,1431,563,722,0,3356,223,190
223,192,589,0,0,0,0,589,223,192
223,193,0,0,0,109,0,109,223,193
223,195,818,0,0,0,0,818,223,195
223,196,0,0,392,0,0,392,223,196
223,197,179,0,425,0,0,604,223,197
223,198,0,0,298,0,0,298,223,198
223,202,0,0,491,0,0,491,223,202
223,203,0,0,1633,0,0,1633,223,203
223,208,210,0,0,0,0,210,223,208
223,211,338,0,0,0,0,338,223,211
223,213,0,0,493,120,0,613,223,213
223,217,391,0,0,0,0,391,223,217
223,220,1053,0,0,0,0,1053,223,220
223,221,225,0,0,0,0,225,223,221
223,222,1751,1302,761,935,0,4749,223,222
223,223,2871,5851,0,2002,0,10724,223,223
223,225,633,0,146,0,0,779,223,225
223,226,788,0,0,531,0,1319,223,226
223,227,0,0,0,20,0,20,223,227
223,230,0,0,693,0,0,693,223,230
223,231,0,0,217,0,0,217,223,231
223,232,494,0,0,266,0,760,223,232
223,233,0,0,126,0,0,126,223,233
223,254,0,0,274,0,0,274,223,254
223,261,391,0,130,0,0,521,223,261
223,264,0,0,0,536,0,536,223,264
223,265,0,0,298,0,0,298,223,265
223,266,75,0,0,0,0,75,223,266
223,267,540,0,0,0,0,540,223,267
223,271,0,0,274,0,0,274,223,271
223,274,0,0,312,0,0,312,223,274
224,62,0,0,27,0,0,27,224,62
224,123,0,0,0,1535,0,1535,224,123
224,168,0,0,128,0,0,128,224,168
224,189,0,269,0,0,0,269,224,189
224,190,1802,0,0,0,0,1802,224,190
224,202,754,0,0,0,0,754,224,202
224,203,0,0,466,0,0,466,224,203
224,212,0,0,656,0,0,656,224,212
224,218,282,0,0,0,0,282,224,218
224,220,62,239,0,0,0,301,224,220
224,222,223,0,430,0,0,653,224,222
224,225,0,0,146,0,0,146,224,225
224,228,0,0,192,0,0,192,224,228
224,233,0,2896,0,0,0,2896,224,233
224,261,0,0,1644,0,0,1644,224,261
224,266,327,0,0,0,0,327,224,266
224,306,0,0,421,0,0,421,224,306
225,1,0,0,268,0,0,268,225,1
225,2,0,0,134,0,0,134,225,2
225,5,0,0,134,0,0,134,225,5
225,7,0,0,134,0,0,134,225,7
225,13,0,0,317,0,0,317,225,13
225,15,0,0,165,0,0,165,225,15
225,16,0,0,194,0,0,194,225,16
225,18,134,0,0,0,0,134,225,18
225,28,0,0,134,0,0,134,225,28
225,34,0,0,268,0,0,268,225,34
225,35,0,0,268,0,0,268,225,35
225,41,0,0,165,0,0,165,225,41
225,43,0,0,391,0,0,391,225,43
225,44,0,0,146,0,0,146,225,44
225,45,0,0,292,0,0,292,225,45
225,46,199,0,0,0,0,199,225,46
225,48,0,0,172,0,0,172,225,48
225,61,537,0,0,0,0,537,225,61
225,63,0,0,134,0,0,134,225,63
225,68,0,0,268,0,0,268,225,68
225,76,0,0,146,0,0,146,225,76
225,79,0,0,199,0,0,199,225,79
225,91,0,0,316,0,0,316,225,91
225,92,0,0,4,0,0,4,225,92
225,98,4,0,0,0,0,4,225,98
225,109,0,0,165,0,0,165,225,109
225,110,0,0,245,0,0,245,225,110
225,128,0,0,134,0,0,134,225,128
225,132,0,0,134,0,0,134,225,132
225,137,0,0,0,134,0,134,225,137
225,166,0,0,562,0,0,562,225,166
225,167,0,0,560,0,0,560,225,167
225,168,0,0,268,306,0,574,225,168
225,169,0,0,363,0,0,363,225,169
225,170,0,0,236,0,0,236,225,170
225,173,0,0,146,0,0,146,225,173
225,181,0,0,146,0,0,146,225,181
225,184,0,0,146,0,0,146,225,184
225,187,0,0,242,0,0,242,225,187
225,189,1051,0,0,0,0,1051,225,189
225,190,0,268,172,0,0,440,225,190
225,191,0,0,146,0,0,146,225,191
225,192,0,0,217,0,0,217,225,192
225,195,0,0,1240,0,0,1240,225,195
225,203,190,0,207,215,0,612,225,203
225,204,0,0,217,0,0,217,225,204
225,208,0,0,399,0,0,399,225,208
225,209,0,0,363,0,0,363,225,209
225,211,338,0,146,0,0,484,225,211
225,213,0,0,172,0,0,172,225,213
225,220,0,0,322,0,0,322,225,220
225,222,257,0,0,0,0,257,225,222
225,223,453,0,341,0,0,794,225,223
225,224,0,0,146,0,0,146,225,224
225,225,199,15749,948,201,0,17097,225,225
225,226,268,258,146,0,0,672,225,226
225,227,1505,1003,284,587,0,3379,225,227
225,229,467,1799,835,100,0,3201,225,229
225,230,2873,0,992,0,0,3865,225,230
225,231,152,134,257,0,0,543,225,231
225,232,399,1028,0,301,0,1728,225,232
225,233,0,0,292,201,0,493,225,233
225,234,0,0,574,0,0,574,225,234
225,235,0,0,445,1368,0,1813,225,235
225,237,0,0,41,0,0,41,225,237
225,245,127,0,0,0,0,127,225,245
225,250,0,0,146,0,0,146,225,250
225,254,0,0,172,0,0,172,225,254
225,258,0,0,0,134,0,134,225,258
225,259,0,0,146,0,0,146,225,259
225,261,0,0,146,0,0,146,225,261
225,262,0,0,292,0,0,292,225,262
225,264,0,0,146,0,0,146,225,264
225,267,0,0,41,0,0,41,225,267
225,291,399,0,0,0,0,399,225,291
226,2,0,0,1683,0,0,1683,226,2
226,3,0,0,536,0,0,536,226,3
226,5,0,0,1818,0,0,1818,226,5
226,6,0,0,521,0,0,521,226,6
226,7,0,0,607,0,0,607,226,7
226,10,0,0,521,0,0,521,226,10
226,12,0,0,607,0,0,607,226,12
226,14,0,0,641,0,0,641,226,14
226,15,0,0,493,0,0,493,226,15
226,22,0,0,163,0,0,163,226,22
226,23,0,0,1551,0,0,1551,226,23
226,26,521,0,521,0,0,1042,226,26
226,29,0,0,641,0,0,641,226,29
226,32,0,0,521,0,0,521,226,32
226,35,0,0,521,0,0,521,226,35
226,41,0,0,521,0,0,521,226,41
226,43,0,0,536,0,0,536,226,43
226,45,1042,0,0,0,0,1042,226,45
226,47,0,0,493,0,0,493,226,47
226,54,0,0,349,0,0,349,226,54
226,59,0,0,361,0,0,361,226,59
226,62,0,0,394,0,0,394,226,62
226,68,0,0,1535,0,0,1535,226,68
226,72,0,0,732,0,0,732,226,72
226,73,76,0,0,0,0,76,226,73
226,75,0,0,521,0,0,521,226,75
226,77,0,0,1172,0,0,1172,226,77
226,79,0,0,902,0,0,902,226,79
226,82,0,0,381,0,0,381,226,82
226,92,0,0,493,0,0,493,226,92
226,93,0,0,213,0,0,213,226,93
226,94,0,0,213,0,0,213,226,94
226,107,0,0,641,0,0,641,226,107
226,128,0,0,521,0,0,521,226,128
226,131,0,0,607,0,0,607,226,131
226,132,0,0,641,0,0,641,226,132
226,135,0,0,170,0,0,170,226,135
226,162,0,0,607,0,0,607,226,162
226,163,618,0,0,0,0,618,226,163
226,166,0,0,1173,1042,0,2215,226,166
226,167,0,0,1103,0,0,1103,226,167
226,169,0,0,1134,0,0,1134,226,169
226,170,521,0,0,0,0,521,226,170
226,184,0,0,286,0,0,286,226,184
226,187,0,0,242,0,0,242,226,187
226,189,3479,4542,2393,0,0,10414,226,189
226,190,1887,1057,995,2079,0,6018,226,190
226,191,280,0,0,0,0,280,226,191
226,193,394,0,0,0,0,394,226,193
226,195,361,0,0,0,0,361,226,195
226,197,0,0,536,0,0,536,226,197
226,198,47,0,0,0,0,47,226,198
226,200,109,0,0,0,0,109,226,200
226,203,190,2214,415,249,0,3068,226,203
226,204,0,0,825,0,0,825,226,204
226,205,0,0,418,0,0,418,226,205
226,206,486,0,0,0,0,486,226,206
226,208,0,0,567,0,0,567,226,208
226,210,493,0,0,0,0,493,226,210
226,211,0,0,797,0,0,797,226,211
226,214,521,0,532,0,0,1053,226,214
226,215,0,0,429,0,0,429,226,215
226,218,381,0,521,532,0,1434,226,218
226,222,0,0,343,0,0,343,226,222
226,223,788,0,0,531,0,1319,226,223
226,225,268,258,146,0,0,672,226,225
226,226,25520,60100,4121,4376,0,94117,226,226
226,227,1632,3320,2433,843,0,8228,226,227
226,228,176,0,578,0,0,754,226,228
226,229,0,0,1591,1011,0,2602,226,229
226,230,1250,0,0,0,0,1250,226,230
226,231,0,0,208,0,0,208,226,231
226,232,0,0,104,0,0,104,226,232
226,234,0,0,0,199,0,199,226,234
226,262,1397,0,0,0,0,1397,226,262
226,271,0,0,521,0,0,521,226,271
226,339,0,0,521,0,0,521,226,339
227,3,0,0,674,0,0,674,227,3
227,5,0,0,674,0,0,674,227,5
227,6,0,0,56,0,0,56,227,6
227,7,0,0,295,0,0,295,227,7
227,8,0,0,321,0,0,321,227,8
227,14,0,0,762,0,0,762,227,14
227,29,618,0,557,0,0,1175,227,29
227,35,0,0,618,0,0,618,227,35
227,40,0,0,674,0,0,674,227,40
227,42,240,0,0,0,0,240,227,42
227,44,0,0,830,0,0,830,227,44
227,53,0,0,261,0,0,261,227,53
227,57,0,0,155,0,0,155,227,57
227,67,0,0,83,0,0,83,227,67
227,68,0,0,501,0,0,501,227,68
227,73,0,0,674,674,0,1348,227,73
227,75,0,0,295,0,0,295,227,75
227,82,0,0,858,0,0,858,227,82
227,91,0,0,261,0,0,261,227,91
227,93,240,0,441,0,0,681,227,93
227,100,0,0,1057,0,0,1057,227,100
227,109,0,0,674,0,0,674,227,109
227,131,0,0,674,0,0,674,227,131
227,144,21,0,0,0,0,21,227,144
227,153,0,0,618,0,0,618,227,153
227,161,0,0,673,0,0,673,227,161
227,162,618,0,0,0,0,618,227,162
227,166,0,0,673,0,0,673,227,166
227,173,0,0,50,0,0,50,227,173
227,182,408,0,0,0,0,408,227,182
227,183,0,0,335,0,0,335,227,183
227,186,135,0,344,0,0,479,227,186
227,189,0,0,59,0,0,59,227,189
227,190,0,0,1978,0,0,1978,227,190
227,192,0,0,1439,0,0,1439,227,192
227,193,0,0,226,0,0,226,227,193
227,195,0,0,284,0,0,284,227,195
227,200,0,0,118,0,0,118,227,200
227,201,0,0,762,0,0,762,227,201
227,202,0,0,524,0,0,524,227,202
227,203,1505,190,466,0,0,2161,227,203
227,204,240,1651,598,1188,0,3677,227,204
227,206,235,0,0,0,0,235,227,206
227,208,240,0,0,0,0,240,227,208
227,223,0,0,0,20,0,20,227,223
227,225,1505,1003,284,587,0,3379,227,225
227,226,4500,2181,1453,843,0,8977,227,226
227,227,8661,10312,1043,5718,0,25734,227,227
227,228,1155,1878,2807,587,0,6427,227,228
227,229,4969,228,4287,1175,0,10659,227,229
227,231,0,0,0,290,0,290,227,231
227,262,0,0,1069,0,0,1069,227,262
227,264,0,0,673,0,0,673,227,264
227,265,0,0,673,0,0,673,227,265
227,300,0,0,240,0,0,240,227,300
227,311,740,0,0,0,0,740,227,311
228,1,0,0,206,0,0,206,228,1
228,2,0,0,687,0,0,687,228,2
228,5,0,0,279,0,0,279,228,5
228,9,0,0,176,0,0,176,228,9
228,14,0,0,301,0,0,301,228,14
228,17,0,0,217,0,0,217,228,17
228,18,0,0,455,0,0,455,228,18
228,32,21,0,631,0,0,652,228,32
228,40,0,0,531,0,0,531,228,40
228,41,0,0,455,0,0,455,228,41
228,42,0,0,560,0,0,560,228,42
228,44,0,0,560,0,0,560,228,44
228,53,0,0,631,0,0,631,228,53
228,63,0,0,1080,0,0,1080,228,63
228,68,0,0,176,0,0,176,228,68
228,73,0,0,245,0,0,245,228,73
228,79,0,0,176,0,0,176,228,79
228,82,0,0,631,0,0,631,228,82
228,91,0,0,0,455,0,455,228,91
228,93,0,0,560,0,0,560,228,93
228,160,455,0,0,0,0,455,228,160
228,166,0,0,455,0,0,455,228,166
228,167,0,0,658,155,0,813,228,167
228,168,0,0,301,0,0,301,228,168
228,189,455,0,1265,0,0,1720,228,189
228,191,0,0,133,0,0,133,228,191
228,198,0,0,192,0,0,192,228,198
228,204,2930,0,0,0,0,2930,228,204
228,206,247,0,0,0,0,247,228,206
228,210,0,0,687,0,0,687,228,210
228,224,0,0,192,0,0,192,228,224
228,226,176,0,578,0,0,754,228,226
228,227,1155,1878,2807,587,0,6427,228,227
228,228,3738,17545,775,1251,0,23309,228,228
228,229,2966,1875,1073,312,660,6886,228,229
228,248,0,0,245,0,0,245,228,248
228,264,0,0,495,0,0,495,228,264
228,317,455,0,0,0,0,455,228,317
229,1,0,0,1147,0,0,1147,229,1
229,2,0,0,3924,46,0,3970,229,2
229,3,0,0,365,0,0,365,229,3
229,4,0,0,398,0,0,398,229,4
229,5,0,0,1288,731,0,2019,229,5
229,7,0,0,1228,0,0,1228,229,7
229,9,0,0,398,0,0,398,229,9
229,14,0,0,935,0,0,935,229,14
229,15,0,0,847,0,0,847,229,15
229,18,0,0,398,0,0,398,229,18
229,22,0,0,464,0,0,464,229,22
229,23,0,0,452,0,0,452,229,23
229,28,0,0,694,0,0,694,229,28
229,31,0,0,365,0,0,365,229,31
229,32,0,0,1388,0,0,1388,229,32
229,37,0,0,398,0,0,398,229,37
229,39,0,0,398,0,0,398,229,39
229,43,0,0,2640,0,0,2640,229,43
229,45,0,0,1092,0,0,1092,229,45
229,49,0,0,1200,0,0,1200,229,49
229,50,0,0,398,0,0,398,229,50
229,57,365,0,0,0,0,365,229,57
229,59,0,0,365,0,0,365,229,59
229,63,0,0,365,0,0,365,229,63
229,66,0,0,1223,0,0,1223,229,66
229,68,0,0,365,0,0,365,229,68
229,69,0,0,365,0,0,365,229,69
229,77,0,0,365,0,0,365,229,77
229,78,0,0,365,0,0,365,229,78
229,92,0,0,450,0,0,450,229,92
229,98,0,0,450,0,0,450,229,98
229,109,0,0,1347,0,0,1347,229,109
229,131,0,0,365,0,0,365,229,131
229,139,0,0,365,0,0,365,229,139
229,151,0,0,452,0,0,452,229,151
229,159,0,0,398,0,0,398,229,159
229,161,0,0,450,0,0,450,229,161
229,164,1060,0,557,0,0,1617,229,164
229,166,0,0,1314,0,0,1314,229,166
229,167,0,0,771,0,0,771,229,167
229,168,101,0,0,0,0,101,229,168
229,169,0,0,1303,0,0,1303,229,169
229,172,694,0,0,0,0,694,229,172
229,188,0,0,330,0,0,330,229,188
229,189,0,0,313,0,0,313,229,189
229,190,2021,0,890,0,0,2911,229,190
229,191,0,0,398,0,0,398,229,191
229,194,173,0,0,0,0,173,229,194
229,195,0,0,345,0,0,345,229,195
229,196,0,0,492,0,0,492,229,196
229,201,0,0,0,603,0,603,229,201
229,203,190,0,1154,0,0,1344,229,203
229,204,0,0,398,0,0,398,229,204
229,210,0,0,1492,0,0,1492,229,210
229,213,0,0,1248,0,0,1248,229,213
229,214,0,0,1334,1064,0,2398,229,214
229,215,452,0,0,0,0,452,229,215
229,219,0,0,935,0,0,935,229,219
229,222,0,0,398,0,0,398,229,222
229,225,1042,1930,835,100,0,3907,229,225
229,226,0,0,1193,1011,0,2204,229,226
229,227,5197,0,3782,1175,0,10154,229,227
229,228,2235,1689,1073,312,660,5969,229,228
229,229,15347,79209,17909,6463,0,118928,229,229
229,230,4544,12611,7335,5726,0,30216,229,230
229,231,517,0,3110,152,0,3779,229,231
229,232,0,0,0,1011,0,1011,229,232
229,233,694,0,1068,0,0,1762,229,233
229,234,918,0,0,0,0,918,229,234
229,240,0,0,1060,0,0,1060,229,240
229,258,0,0,1248,0,0,1248,229,258
229,260,0,0,499,0,0,499,229,260
229,263,0,0,709,0,0,709,229,263
229,264,365,0,2044,0,0,2409,229,264
229,265,0,0,373,0,0,373,229,265
229,266,0,0,82,0,0,82,229,266
229,267,0,0,1540,0,0,1540,229,267
229,285,0,0,365,0,0,365,229,285
229,286,0,0,860,0,0,860,229,286
229,305,0,0,202,0,0,202,229,305
229,317,0,0,365,0,0,365,229,317
229,323,0,0,365,0,0,365,229,323
229,329,0,0,365,0,0,365,229,329
229,337,0,0,694,0,0,694,229,337
229,340,0,0,365,0,0,365,229,340
230,2,0,0,1326,0,0,1326,230,2
230,4,0,0,306,0,0,306,230,4
230,5,0,0,625,0,0,625,230,5
230,6,0,0,857,0,0,857,230,6
230,7,0,0,770,0,0,770,230,7
230,14,0,0,770,0,0,770,230,14
230,24,0,0,419,0,0,419,230,24
230,27,0,0,1056,0,0,1056,230,27
230,30,0,0,377,0,0,377,230,30
230,40,0,0,1651,0,0,1651,230,40
230,42,0,0,333,0,0,333,230,42
230,43,0,0,1289,0,0,1289,230,43
230,49,0,0,625,0,0,625,230,49
230,53,0,0,625,0,0,625,230,53
230,63,12,0,0,0,0,12,230,63
230,72,0,0,306,0,0,306,230,72
230,77,0,0,0,306,0,306,230,77
230,84,0,0,306,0,0,306,230,84
230,93,0,0,1302,0,0,1302,230,93
230,110,0,0,377,0,0,377,230,110
230,140,625,0,0,0,0,625,230,140
230,164,0,0,377,0,0,377,230,164
230,166,0,0,1042,0,0,1042,230,166
230,167,0,0,1841,0,0,1841,230,167
230,169,0,0,1058,0,0,1058,230,169
230,170,625,0,498,0,0,1123,230,170
230,182,473,0,0,0,0,473,230,182
230,191,625,0,680,0,0,1305,230,191
230,195,900,0,0,0,0,900,230,195
230,198,0,0,566,0,0,566,230,198
230,201,0,0,0,306,0,306,230,201
230,204,0,0,333,0,0,333,230,204
230,205,0,0,680,0,0,680,230,205
230,208,0,0,333,0,0,333,230,208
230,210,0,0,2386,0,0,2386,230,210
230,214,0,0,752,0,0,752,230,214
230,216,0,0,1302,0,0,1302,230,216
230,221,0,0,1386,0,0,1386,230,221
230,222,0,0,680,0,0,680,230,222
230,225,2168,0,0,0,0,2168,230,225
230,226,625,0,0,0,0,625,230,226
230,229,6413,11776,5446,7463,0,31098,230,229
230,230,3475,34861,933,6633,0,45902,230,230
230,231,0,0,0,186,0,186,230,231
230,232,0,0,1099,0,0,1099,230,232
230,233,0,0,456,0,0,456,230,233
230,235,1020,0,0,0,0,1020,230,235
230,239,0,0,1076,0,0,1076,230,239
230,240,0,0,333,0,0,333,230,240
230,245,0,0,333,0,0,333,230,245
230,250,0,0,306,0,0,306,230,250
230,253,0,0,770,0,0,770,230,253
230,258,0,0,333,0,0,333,230,258
230,265,0,0,680,0,0,680,230,265
230,267,306,0,755,0,0,1061,230,267
230,289,0,0,1302,0,0,1302,230,289
230,307,0,0,327,0,0,327,230,307
230,319,17,0,0,0,0,17,230,319
230,322,0,0,682,0,0,682,230,322
230,338,207,0,0,0,0,207,230,338
231,1,0,0,152,0,0,152,231,1
231,2,0,0,563,0,0,563,231,2
231,5,0,0,152,0,0,152,231,5
231,6,236,0,0,0,0,236,231,6
231,9,0,0,152,0,0,152,231,9
231,12,0,0,165,0,0,165,231,12
231,14,0,0,199,0,0,199,231,14
231,16,0,0,152,0,0,152,231,16
231,17,0,0,118,0,0,118,231,17
231,19,0,0,257,0,0,257,231,19
231,23,0,0,152,0,0,152,231,23
231,24,0,0,149,0,0,149,231,24
231,31,0,0,614,0,0,614,231,31
231,32,93,0,199,0,0,292,231,32
231,41,0,0,152,0,0,152,231,41
231,42,0,0,382,0,0,382,231,42
231,43,0,0,165,0,0,165,231,43
231,45,0,0,236,0,0,236,231,45
231,53,0,0,152,0,0,152,231,53
231,66,0,0,152,0,0,152,231,66
231,74,0,0,310,0,0,310,231,74
231,88,152,0,0,0,0,152,231,88
231,93,0,0,95,0,0,95,231,93
231,133,0,0,149,0,0,149,231,133
231,162,0,0,165,0,0,165,231,162
231,166,0,0,257,0,0,257,231,166
231,167,0,0,320,0,0,320,231,167
231,169,42,0,0,0,0,42,231,169
231,171,236,0,0,0,0,236,231,171
231,189,0,0,162,0,0,162,231,189
231,191,0,0,165,0,0,165,231,191
231,195,0,0,0,264,0,264,231,195
231,196,0,0,165,0,0,165,231,196
231,203,0,0,165,0,0,165,231,203
231,205,0,0,644,0,0,644,231,205
231,208,0,0,165,0,0,165,231,208
231,212,0,0,165,0,0,165,231,212
231,213,0,0,338,0,0,338,231,213
231,214,0,0,0,442,0,442,231,214
231,215,152,0,0,0,0,152,231,215
231,221,0,0,433,0,0,433,231,221
231,223,0,0,217,0,0,217,231,223
231,225,152,134,257,0,0,543,231,225
231,226,0,0,312,0,0,312,231,226
231,227,0,0,0,290,0,290,231,227
231,229,882,0,3110,0,0,3992,231,229
231,230,0,0,0,186,0,186,231,230
231,231,1911,14955,1550,2823,0,21239,231,231
231,232,0,1130,2570,680,0,4380,231,232
231,233,0,0,899,425,0,1324,231,233
231,240,0,0,165,0,0,165,231,240
231,254,0,0,382,0,0,382,231,254
231,256,0,0,165,0,0,165,231,256
231,258,237,0,0,0,0,237,231,258
231,259,0,0,509,0,0,509,231,259
231,260,0,0,165,0,0,165,231,260
231,261,0,0,338,0,0,338,231,261
231,263,0,186,165,641,0,992,231,263
231,264,709,0,815,152,0,1676,231,264
231,267,0,0,257,0,0,257,231,267
231,287,0,0,245,0,0,245,231,287
231,294,0,0,165,0,0,165,231,294
231,315,0,0,200,0,0,200,231,315
232,1,0,0,195,0,0,195,232,1
232,6,0,0,49,0,0,49,232,6
232,23,0,0,373,0,0,373,232,23
232,36,0,0,314,0,0,314,232,36
232,39,0,0,499,0,0,499,232,39
232,41,0,0,796,0,0,796,232,41
232,45,0,0,601,0,0,601,232,45
232,46,0,0,212,0,0,212,232,46
232,48,0,0,866,0,0,866,232,48
232,59,0,0,314,0,0,314,232,59
232,68,0,0,314,0,0,314,232,68
232,81,0,0,195,0,0,195,232,81
232,119,417,0,0,0,0,417,232,119
232,132,0,0,195,0,0,195,232,132
232,144,601,0,0,0,0,601,232,144
232,162,0,0,332,0,0,332,232,162
232,167,780,0,536,0,0,1316,232,167
232,169,0,0,629,0,0,629,232,169
232,189,0,0,654,0,0,654,232,189
232,190,0,0,212,0,0,212,232,190
232,197,0,0,654,0,0,654,232,197
232,208,40,0,341,0,0,381,232,208
232,212,0,0,212,0,0,212,232,212
232,215,0,0,418,0,0,418,232,215
232,216,0,0,796,0,0,796,232,216
232,218,0,0,341,0,0,341,232,218
232,221,0,0,740,0,0,740,232,221
232,223,494,0,0,266,0,760,232,223
232,225,399,1028,0,301,0,1728,232,225
232,229,0,0,0,1162,0,1162,232,229
232,230,0,0,1435,0,0,1435,232,230
232,231,0,1226,2787,528,0,4541,232,231
232,232,4265,25689,3659,2623,0,36236,232,232
232,233,2572,860,658,0,0,4090,232,233
232,234,0,264,0,260,0,524,232,234
232,239,0,0,0,373,0,373,232,239
232,253,0,0,0,314,0,314,232,253
232,254,0,0,1308,0,0,1308,232,254
232,257,0,0,341,0,0,341,232,257
232,258,314,0,0,0,0,314,232,258
232,260,915,0,282,0,0,1197,232,260
232,261,0,0,682,0,0,682,232,261
232,262,0,0,212,195,282,689,232,262
232,263,0,0,618,466,0,1084,232,263
232,264,0,0,1091,731,0,1822,232,264
232,265,0,0,724,0,0,724,232,265
232,266,0,195,0,0,0,195,232,266
232,267,0,0,406,0,0,406,232,267
233,1,0,0,550,0,0,550,233,1
233,3,0,0,220,0,0,220,233,3
233,5,0,0,311,0,0,311,233,5
233,6,0,0,338,0,0,338,233,6
233,15,0,0,338,0,0,338,233,15
233,18,0,0,338,0,0,338,233,18
233,20,0,0,671,0,0,671,233,20
233,23,0,0,436,0,0,436,233,23
233,27,0,0,436,0,0,436,233,27
233,40,0,0,598,0,0,598,233,40
233,41,0,0,475,0,0,475,233,41
233,42,0,0,338,0,0,338,233,42
233,43,0,0,436,0,0,436,233,43
233,46,616,0,689,0,0,1305,233,46
233,57,0,0,311,0,0,311,233,57
233,62,27,0,0,0,0,27,233,62
233,67,0,0,747,0,0,747,233,67
233,93,0,0,436,0,0,436,233,93
233,106,220,0,0,0,0,220,233,106
233,158,0,0,338,0,0,338,233,158
233,159,634,0,0,0,0,634,233,159
233,162,311,0,0,0,0,311,233,162
233,166,311,0,949,0,0,1260,233,166
233,169,0,0,671,0,0,671,233,169
233,188,0,0,338,0,0,338,233,188
233,190,0,0,2626,311,0,2937,233,190
233,194,311,0,0,0,0,311,233,194
233,197,0,0,773,0,0,773,233,197
233,201,311,0,0,0,0,311,233,201
233,207,616,0,0,220,0,836,233,207
233,210,0,0,338,0,0,338,233,210
233,211,0,0,239,0,0,239,233,211
233,213,396,0,0,0,0,396,233,213
233,219,0,0,338,0,0,338,233,219
233,220,0,0,322,0,0,322,233,220
233,221,436,0,577,0,0,1013,233,221
233,223,0,0,126,0,0,126,233,223
233,224,0,2896,0,0,0,2896,233,224
233,225,0,0,292,201,0,493,233,225
233,229,694,0,1406,0,0,2100,233,229
233,230,0,0,456,0,0,456,233,230
233,231,0,0,899,425,0,1324,233,231
233,232,2572,860,1042,0,0,4474,233,232
233,233,1773,28199,0,1524,5390,36886,233,233
233,234,0,0,287,0,0,287,233,234
233,235,0,4822,935,1196,0,6953,233,235
233,241,0,0,239,0,0,239,233,241
233,251,0,0,640,0,0,640,233,251
233,254,220,0,1794,0,0,2014,233,254
233,258,0,0,239,0,0,239,233,258
233,260,458,0,499,0,0,957,233,260
233,261,0,0,338,0,0,338,233,261
233,264,518,0,2185,0,894,3597,233,264
233,265,0,0,0,578,0,578,233,265
233,266,0,0,697,0,0,697,233,266
233,267,1452,1641,489,1206,0,4788,233,267
233,282,616,0,475,0,0,1091,233,282
234,1,0,0,684,0,0,684,234,1
234,2,0,0,287,0,0,287,234,2
234,3,0,0,684,0,0,684,234,3
234,7,684,0,0,0,0,684,234,7
234,14,0,0,287,0,0,287,234,14
234,15,0,0,287,0,0,287,234,15
234,27,31,0,0,0,0,31,234,27
234,29,0,0,264,0,0,264,234,29
234,34,0,0,264,0,0,264,234,34
234,43,0,0,684,0,0,684,234,43
234,56,1199,0,0,0,0,1199,234,56
234,63,726,0,0,0,0,726,234,63
234,73,0,0,465,0,0,465,234,73
234,81,0,0,264,0,0,264,234,81
234,93,0,0,684,0,0,684,234,93
234,166,0,0,1317,0,0,1317,234,166
234,167,483,0,116,0,0,599,234,167
234,190,0,0,216,0,0,216,234,190
234,192,315,0,0,0,0,315,234,192
234,197,0,0,190,0,0,190,234,197
234,208,465,0,287,0,0,752,234,208
234,210,0,0,506,0,0,506,234,210
234,211,0,0,744,0,0,744,234,211
234,213,0,0,287,0,0,287,234,213
234,214,684,0,0,0,0,684,234,214
234,221,465,0,744,0,0,1209,234,221
234,222,0,0,238,0,0,238,234,222
234,225,0,0,574,0,0,574,234,225
234,226,0,0,0,199,0,199,234,226
234,229,918,0,0,0,0,918,234,229
234,232,0,264,0,260,0,524,234,232
234,233,0,0,287,0,0,287,234,233
234,234,7858,47564,4710,1563,0,61695,234,234
234,235,0,3993,2189,0,0,6182,234,235
234,241,0,0,287,0,0,287,234,241
234,255,0,0,506,0,0,506,234,255
234,263,970,0,433,261,0,1664,234,263
234,264,0,0,2830,0,382,3212,234,264
234,265,0,0,1270,0,0,1270,234,265
234,266,0,0,287,0,0,287,234,266
234,267,947,1595,166,0,0,2708,234,267
234,273,0,0,264,0,0,264,234,273
234,274,0,0,264,0,0,264,234,274
234,289,0,0,0,261,0,261,234,289
234,301,52,0,0,0,0,52,234,301
234,342,0,0,264,0,0,264,234,342
235,1,0,0,525,0,0,525,235,1
235,2,0,0,890,409,0,1299,235,2
235,9,0,0,1202,0,0,1202,235,9
235,17,0,0,696,0,0,696,235,17
235,23,0,0,0,1202,0,1202,235,23
235,43,0,0,482,0,0,482,235,43
235,45,484,0,696,0,0,1180,235,45
235,68,0,0,1020,0,0,1020,235,68
235,74,0,0,553,0,0,553,235,74
235,128,0,0,484,0,0,484,235,128
235,166,0,0,1109,0,0,1109,235,166
235,171,247,0,0,0,0,247,235,171
235,201,0,0,696,0,0,696,235,201
235,213,0,0,1308,0,0,1308,235,213
235,219,0,0,601,0,0,601,235,219
235,220,0,0,322,0,0,322,235,220
235,221,347,0,1308,0,0,1655,235,221
235,225,0,0,445,1368,0,1813,235,225
235,230,1020,0,0,0,0,1020,235,230
235,233,0,4822,935,1196,0,6953,235,233
235,234,483,3993,2189,0,0,6665,235,234
235,235,7361,24627,2219,7179,1405,42791,235,235
235,253,0,0,43,0,0,43,235,253
235,254,0,0,696,0,0,696,235,254
235,259,0,0,1109,0,0,1109,235,259
235,260,0,0,515,0,0,515,235,260
235,261,0,0,527,0,0,527,235,261
235,263,0,484,0,0,0,484,235,263
235,264,1020,1572,2415,0,0,5007,235,264
235,265,969,0,890,0,0,1859,235,265
235,267,896,2173,445,0,0,3514,235,267
235,300,1202,0,0,0,0,1202,235,300
236,1,33,0,448,0,59,540,236,1
236,5,0,0,51,0,0,51,236,5
236,15,0,0,263,0,0,263,236,15
236,18,0,0,246,96,0,342,236,18
236,21,178,0,0,0,0,178,236,21
236,23,0,0,122,0,0,122,236,23
236,24,0,0,311,0,0,311,236,24
236,27,41,0,0,0,0,41,236,27
236,28,82,0,0,0,0,82,236,28
236,29,0,0,633,0,0,633,236,29
236,31,41,0,0,0,0,41,236,31
236,32,129,0,207,0,0,336,236,32
236,36,0,0,51,0,0,51,236,36
236,39,359,0,0,0,0,359,236,39
236,40,123,0,0,0,0,123,236,40
236,43,0,0,58,0,0,58,236,43
236,44,567,0,0,0,0,567,236,44
236,45,0,0,50,0,0,50,236,45
236,49,47,0,0,0,0,47,236,49
236,50,41,0,80,94,0,215,236,50
236,51,180,0,0,0,0,180,236,51
236,54,225,0,0,0,0,225,236,54
236,57,0,0,155,0,0,155,236,57
236,60,205,0,0,0,0,205,236,60
236,62,41,0,0,112,0,153,236,62
236,66,41,0,0,58,0,99,236,66
236,67,0,0,122,0,0,122,236,67
236,70,84,0,0,0,0,84,236,70
236,71,0,0,143,0,0,143,236,71
236,74,0,0,109,47,0,156,236,74
236,75,0,0,36,0,0,36,236,75
236,79,41,0,0,0,0,41,236,79
236,94,0,0,122,0,0,122,236,94
236,96,25,0,0,0,0,25,236,96
236,100,0,0,224,0,0,224,236,100
236,128,0,0,45,0,0,45,236,128
236,159,0,0,0,41,0,41,236,159
236,171,0,0,526,0,0,526,236,171
236,174,0,0,761,0,0,761,236,174
236,236,1059,6380,0,599,0,8038,236,236
236,237,344,3760,0,91,0,4195,236,237
236,238,557,482,147,0,0,1186,236,238
236,239,1240,1034,0,465,0,2739,236,239
236,240,444,1442,795,0,0,2681,236,240
236,241,144,250,109,0,0,503,236,241
236,242,178,127,758,358,0,1421,236,242
236,243,0,339,436,0,0,775,236,243
236,244,2462,0,740,0,0,3202,236,244
236,247,0,0,584,0,0,584,236,247
236,249,0,0,2292,0,0,2292,236,249
236,250,135,0,0,0,0,135,236,250
236,251,487,0,0,0,0,487,236,251
236,252,0,0,105,0,0,105,236,252
236,254,0,0,248,0,0,248,236,254
236,257,0,0,471,0,0,471,236,257
236,258,237,0,0,0,0,237,236,258
236,261,0,0,123,0,0,123,236,261
236,264,0,0,416,0,0,416,236,264
236,265,0,0,124,0,0,124,236,265
236,269,139,0,0,0,0,139,236,269
236,271,0,0,225,112,0,337,236,271
236,274,41,0,0,0,0,41,236,274
236,279,0,0,774,0,0,774,236,279
236,282,41,0,0,0,0,41,236,282
236,300,1021,0,0,0,0,1021,236,300
236,316,47,0,0,0,0,47,236,316
236,329,41,0,0,0,0,41,236,329
236,339,41,0,0,0,0,41,236,339
236,340,67,0,0,0,0,67,236,340
236,342,41,0,0,0,0,41,236,342
237,1,0,0,70,0,0,70,237,1
237,2,26,0,0,0,0,26,237,2
237,3,0,0,26,0,0,26,237,3
237,4,0,0,26,0,0,26,237,4
237,5,0,0,72,0,0,72,237,5
237,6,0,0,0,26,0,26,237,6
237,7,26,0,0,0,0,26,237,7
237,11,22,0,0,0,0,22,237,11
237,14,0,0,28,0,0,28,237,14
237,18,466,0,325,0,0,791,237,18
237,19,136,0,0,0,0,136,237,19
237,20,0,0,509,0,0,509,237,20
237,21,206,0,90,0,0,296,237,21
237,23,26,0,47,0,0,73,237,23
237,24,0,0,290,0,0,290,237,24
237,27,47,0,157,0,0,204,237,27
237,28,0,0,207,0,0,207,237,28
237,29,0,0,72,0,0,72,237,29
237,32,47,0,62,0,0,109,237,32
237,44,26,0,35,47,0,108,237,44
237,45,194,0,0,0,0,194,237,45
237,49,0,0,171,0,0,171,237,49
237,52,0,0,26,0,0,26,237,52
237,53,201,0,128,58,0,387,237,53
237,54,51,0,53,0,0,104,237,54
237,55,0,0,217,0,0,217,237,55
237,56,111,0,0,0,0,111,237,56
237,57,0,0,51,0,0,51,237,57
237,59,0,0,26,0,0,26,237,59
237,61,490,0,51,51,0,592,237,61
237,63,51,0,0,0,0,51,237,63
237,66,51,0,26,0,0,77,237,66
237,67,33,0,0,0,0,33,237,67
237,68,0,0,0,26,0,26,237,68
237,69,26,0,0,0,0,26,237,69
237,70,65,0,111,0,0,176,237,70
237,72,26,0,0,0,0,26,237,72
237,73,26,0,102,0,0,128,237,73
237,74,0,0,111,0,0,111,237,74
237,77,0,0,72,0,0,72,237,77
237,79,0,0,26,0,0,26,237,79
237,82,111,0,31,0,0,142,237,82
237,83,0,0,51,0,0,51,237,83
237,84,0,0,0,47,0,47,237,84
237,88,150,0,0,0,0,150,237,88
237,92,0,0,111,0,0,111,237,92
237,95,0,0,72,0,0,72,237,95
237,100,0,0,16,0,0,16,237,100
237,106,0,0,72,0,0,72,237,106
237,128,0,0,26,0,0,26,237,128
237,131,0,0,26,11,0,37,237,131
237,156,0,0,0,145,0,145,237,156
237,163,0,0,176,0,0,176,237,163
237,174,0,0,357,0,0,357,237,174
237,225,0,0,41,0,0,41,237,225
237,236,344,3175,0,91,0,3610,237,236
237,237,1105,2028,16,97,0,3246,237,237
237,238,842,2095,336,0,0,3273,237,238
237,239,185,428,152,61,0,826,237,239
237,240,300,47,153,15,0,515,237,240
237,241,195,232,145,46,77,695,237,241
237,242,1328,887,120,292,0,2627,237,242
237,243,1479,0,133,0,0,1612,237,243
237,244,1660,953,3279,0,0,5892,237,244
237,245,511,0,385,0,0,896,237,245
237,246,0,0,0,166,0,166,237,246
237,247,953,0,1963,0,0,2916,237,247
237,250,58,0,0,0,0,58,237,250
237,252,15,0,657,0,0,672,237,252
237,253,0,0,61,0,0,61,237,253
237,254,0,0,311,107,0,418,237,254
237,259,0,0,213,0,0,213,237,259
237,261,0,0,426,0,0,426,237,261
237,267,306,0,0,0,0,306,237,267
237,270,0,0,28,0,0,28,237,270
237,272,111,0,0,0,0,111,237,272
237,273,0,0,766,0,0,766,237,273
237,274,0,0,115,0,0,115,237,274
237,275,0,0,1353,0,0,1353,237,275
237,277,26,0,0,0,0,26,237,277
237,282,0,0,0,26,0,26,237,282
237,300,26,0,0,202,0,228,237,300
237,302,85,0,0,0,0,85,237,302
237,306,0,0,527,0,0,527,237,306
237,321,263,0,0,0,0,263,237,321
237,338,26,0,0,0,0,26,237,338
237,339,0,0,47,0,0,47,237,339
237,342,0,0,26,0,0,26,237,342
238,1,0,0,309,0,0,309,238,1
238,2,0,0,151,0,0,151,238,2
238,4,0,0,178,0,0,178,238,4
238,5,135,0,0,0,0,135,238,5
238,6,0,0,294,0,0,294,238,6
238,15,0,0,135,0,0,135,238,15
238,19,178,0,0,0,0,178,238,19
238,21,41,0,336,151,0,528,238,21
238,22,135,0,0,0,0,135,238,22
238,25,104,0,0,0,0,104,238,25
238,26,227,0,0,0,0,227,238,26
238,27,0,0,151,0,0,151,238,27
238,28,0,0,151,0,0,151,238,28
238,29,80,0,0,0,0,80,238,29
238,31,78,0,293,0,0,371,238,31
238,32,0,0,251,0,0,251,238,32
238,38,112,0,0,0,0,112,238,38
238,49,0,0,74,74,72,220,238,49
238,51,135,0,26,0,0,161,238,51
238,53,0,0,85,0,0,85,238,53
238,54,172,0,0,0,0,172,238,54
238,55,0,0,0,74,0,74,238,55
238,56,0,0,78,0,0,78,238,56
238,57,0,0,270,213,0,483,238,57
238,58,100,0,0,0,0,100,238,58
238,59,178,0,0,0,0,178,238,59
238,60,135,0,135,0,0,270,238,60
238,61,898,0,0,0,0,898,238,61
238,62,151,0,0,0,0,151,238,62
238,63,102,0,0,0,0,102,238,63
238,64,120,0,0,120,0,240,238,64
238,73,0,0,135,0,0,135,238,73
238,76,28,0,38,0,0,66,238,76
238,77,0,0,309,0,0,309,238,77
238,78,0,0,135,0,0,135,238,78
238,79,0,0,163,0,0,163,238,79
238,81,0,0,151,0,0,151,238,81
238,83,0,0,444,0,0,444,238,83
238,95,0,0,151,0,0,151,238,95
238,97,168,0,0,0,0,168,238,97
238,108,135,0,0,0,0,135,238,108
238,116,0,0,537,0,0,537,238,116
238,133,135,0,0,0,0,135,238,133
238,135,0,0,282,0,0,282,238,135
238,136,0,0,480,0,0,480,238,136
238,234,0,0,287,0,0,287,238,234
238,236,444,135,0,0,0,579,238,236
238,237,867,3351,336,0,0,4554,238,237
238,238,2873,2423,0,718,0,6014,238,238
238,239,1364,875,119,135,0,2493,238,239
238,240,213,0,147,693,0,1053,238,240
238,241,135,0,126,0,0,261,238,241
238,242,135,0,0,0,0,135,238,242
238,243,405,0,0,270,0,675,238,243
238,244,0,1002,0,0,0,1002,238,244
238,245,292,0,125,0,0,417,238,245
238,246,507,0,620,0,0,1127,238,246
238,247,977,0,2235,0,0,3212,238,247
238,250,412,135,0,0,0,547,238,250
238,251,829,256,0,314,0,1399,238,251
238,252,252,703,0,0,0,955,238,252
238,254,0,0,472,135,0,607,238,254
238,260,0,0,690,0,0,690,238,260
238,261,0,0,892,426,0,1318,238,261
238,265,0,0,213,0,0,213,238,265
238,274,270,0,309,0,0,579,238,274
238,275,274,0,0,427,0,701,238,275
238,277,0,0,619,0,0,619,238,277
238,298,0,0,250,0,0,250,238,298
238,300,0,0,0,151,0,151,238,300
238,303,0,0,147,0,0,147,238,303
238,309,0,0,249,0,0,249,238,309
238,339,0,0,10,0,0,10,238,339
239,1,0,0,345,0,0,345,239,1
239,2,107,0,116,0,0,223,239,2
239,3,0,0,610,0,0,610,239,3
239,18,0,0,136,125,0,261,239,18
239,19,1662,0,67,198,0,1927,239,19
239,20,254,0,0,0,0,254,239,20
239,21,493,0,466,0,0,959,239,21
239,22,838,0,0,0,0,838,239,22
239,23,0,0,219,0,0,219,239,23
239,24,0,0,359,0,0,359,239,24
239,26,0,0,206,0,0,206,239,26
239,27,60,0,0,0,0,60,239,27
239,29,0,0,301,0,0,301,239,29
239,30,47,0,0,0,0,47,239,30
239,32,0,0,374,0,0,374,239,32
239,41,242,0,0,0,0,242,239,41
239,44,0,0,67,0,0,67,239,44
239,45,240,0,0,0,0,240,239,45
239,49,0,0,314,0,0,314,239,49
239,50,55,110,132,0,0,297,239,50
239,51,1614,288,0,0,0,1902,239,51
239,53,0,39,406,0,0,445,239,53
239,54,0,0,160,0,0,160,239,54
239,55,0,0,315,0,0,315,239,55
239,56,148,0,396,0,0,544,239,56
239,57,110,0,61,0,0,171,239,57
239,58,41,0,0,0,0,41,239,58
239,59,0,0,245,0,0,245,239,59
239,60,0,0,67,0,0,67,239,60
239,61,304,0,0,0,0,304,239,61
239,62,27,0,0,0,0,27,239,62
239,63,69,0,0,0,0,69,239,63
239,64,120,0,0,0,0,120,239,64
239,65,231,0,0,0,0,231,239,65
239,66,0,0,119,0,0,119,239,66
239,69,0,0,0,35,0,35,239,69
239,70,0,0,110,0,0,110,239,70
239,73,134,0,0,0,0,134,239,73
239,74,0,0,192,110,0,302,239,74
239,76,0,0,34,0,0,34,239,76
239,77,0,0,140,0,0,140,239,77
239,79,110,0,282,0,0,392,239,79
239,80,26,0,0,0,0,26,239,80
239,83,69,0,0,0,0,69,239,83
239,93,0,0,0,301,0,301,239,93
239,97,0,0,40,0,0,40,239,97
239,102,0,0,170,0,0,170,239,102
239,106,110,0,0,0,0,110,239,106
239,109,0,0,968,0,0,968,239,109
239,135,75,0,0,0,0,75,239,135
239,144,0,0,617,0,0,617,239,144
239,152,0,0,346,0,0,346,239,152
239,153,45,0,0,0,0,45,239,153
239,166,0,0,218,0,0,218,239,166
239,170,0,0,247,0,0,247,239,170
239,174,357,0,0,0,0,357,239,174
239,175,0,0,304,0,0,304,239,175
239,181,0,0,486,0,0,486,239,181
239,184,0,0,228,0,0,228,239,184
239,201,603,0,0,0,0,603,239,201
239,205,0,0,384,0,0,384,239,205
239,208,0,0,299,0,0,299,239,208
239,210,391,0,0,0,0,391,239,210
239,213,0,0,449,0,0,449,239,213
239,218,104,0,0,0,0,104,239,218
239,219,0,0,646,0,0,646,239,219
239,230,0,0,1076,0,0,1076,239,230
239,236,1240,1002,0,465,0,2707,239,236
239,237,102,501,136,61,0,800,239,237
239,238,1213,719,288,135,0,2355,239,238
239,239,2064,9013,679,424,0,12180,239,239
239,240,326,881,423,0,855,2485,239,240
239,241,357,169,180,58,77,841,239,241
239,242,339,186,217,673,0,1415,239,242
239,243,942,270,366,61,0,1639,239,243
239,244,957,0,1973,1605,0,4535,239,244
239,245,0,0,138,207,0,345,239,245
239,246,114,0,152,0,0,266,239,246
239,247,3041,0,3124,0,0,6165,239,247
239,249,1823,0,909,0,0,2732,239,249
239,250,258,0,276,0,0,534,239,250
239,251,1393,0,67,337,0,1797,239,251
239,252,745,0,0,0,0,745,239,252
239,253,0,0,89,373,0,462,239,253
239,254,1407,0,67,0,0,1474,239,254
239,255,569,0,615,0,0,1184,239,255
239,256,450,0,321,522,0,1293,239,256
239,261,0,0,465,0,0,465,239,261
239,262,0,0,841,0,0,841,239,262
239,264,0,0,378,0,0,378,239,264
239,268,128,0,0,0,0,128,239,268
239,270,54,0,0,0,0,54,239,270
239,275,0,0,880,0,0,880,239,275
239,276,627,0,849,0,0,1476,239,276
239,278,0,0,215,395,0,610,239,278
239,279,0,0,322,0,0,322,239,279
239,284,250,0,0,0,0,250,239,284
239,286,0,0,0,61,0,61,239,286
239,293,0,0,0,869,0,869,239,293
239,300,425,0,119,0,0,544,239,300
239,321,408,0,152,0,0,560,239,321
239,327,316,0,0,0,0,316,239,327
239,329,50,0,0,0,0,50,239,329
239,339,0,0,350,0,0,350,239,339
240,1,0,0,449,206,0,655,240,1
240,3,0,0,109,0,0,109,240,3
240,5,100,0,0,512,0,612,240,5
240,6,308,0,0,0,0,308,240,6
240,10,204,0,0,0,0,204,240,10
240,14,0,0,228,0,0,228,240,14
240,17,0,0,0,24,0,24,240,17
240,18,798,0,295,0,0,1093,240,18
240,19,2878,326,506,0,0,3710,240,19
240,20,0,0,240,0,0,240,240,20
240,21,926,0,224,106,0,1256,240,21
240,23,204,0,102,0,0,306,240,23
240,24,286,0,317,0,0,603,240,24
240,26,127,0,0,0,0,127,240,26
240,27,60,0,59,102,0,221,240,27
240,28,0,0,228,0,0,228,240,28
240,29,0,0,100,0,0,100,240,29
240,30,0,0,55,0,0,55,240,30
240,31,0,0,100,0,0,100,240,31
240,32,0,93,0,0,0,93,240,32
240,35,206,0,0,0,0,206,240,35
240,36,0,0,196,0,0,196,240,36
240,43,63,0,68,0,0,131,240,43
240,45,206,0,224,0,0,430,240,45
240,46,0,0,410,0,0,410,240,46
240,47,0,0,117,0,0,117,240,47
240,49,402,0,224,0,0,626,240,49
240,50,815,53,38,0,0,906,240,50
240,51,185,0,0,0,0,185,240,51
240,52,0,206,226,0,0,432,240,52
240,53,0,0,86,0,0,86,240,53
240,54,37,0,0,0,0,37,240,54
240,55,761,0,0,0,0,761,240,55
240,57,621,0,131,0,0,752,240,57
240,58,97,0,0,0,0,97,240,58
240,59,0,0,64,0,0,64,240,59
240,60,0,0,221,0,0,221,240,60
240,61,0,0,0,0,298,298,240,61
240,63,11,0,0,0,0,11,240,63
240,64,59,0,0,0,0,59,240,64
240,73,201,0,0,0,0,201,240,73
240,74,55,0,0,0,0,55,240,74
240,75,35,0,0,0,0,35,240,75
240,80,101,0,0,0,0,101,240,80
240,81,0,0,355,0,0,355,240,81
240,82,0,0,76,0,0,76,240,82
240,83,206,0,0,0,0,206,240,83
240,89,0,0,228,0,0,228,240,89
240,90,0,0,0,0,274,274,240,90
240,95,0,0,102,0,0,102,240,95
240,107,401,0,0,0,0,401,240,107
240,108,0,0,51,0,0,51,240,108
240,109,0,0,1072,0,0,1072,240,109
240,170,0,0,221,0,0,221,240,170
240,174,0,0,357,0,0,357,240,174
240,187,0,0,273,0,0,273,240,187
240,191,206,0,0,0,0,206,240,191
240,199,0,0,461,0,0,461,240,199
240,200,0,0,134,0,0,134,240,200
240,209,59,0,0,0,0,59,240,209
240,229,0,0,1060,0,0,1060,240,229
240,230,0,0,333,0,0,333,240,230
240,231,0,0,165,0,0,165,240,231
240,236,444,1577,795,0,0,2816,240,236
240,237,300,47,153,15,0,515,240,237
240,238,348,0,0,693,0,1041,240,238
240,239,436,662,423,0,855,2376,240,239
240,240,626,8528,800,1776,596,12326,240,240
240,241,581,1743,0,111,0,2435,240,241
240,243,0,0,703,0,0,703,240,243
240,244,0,0,711,0,0,711,240,244
240,245,0,0,278,0,0,278,240,245
240,250,0,0,224,0,0,224,240,250
240,257,0,0,290,0,0,290,240,257
240,259,0,0,172,0,0,172,240,259
240,263,0,0,1267,0,0,1267,240,263
240,265,0,0,450,0,0,450,240,265
240,272,0,0,100,0,0,100,240,272
240,274,0,0,502,0,0,502,240,274
240,278,395,0,0,0,0,395,240,278
240,282,0,0,64,0,0,64,240,282
240,300,285,0,0,0,0,285,240,300
241,1,53,0,0,0,0,53,241,1
241,2,0,0,126,0,0,126,241,2
241,3,0,0,26,0,0,26,241,3
241,6,0,0,100,0,0,100,241,6
241,10,0,0,58,0,0,58,241,10
241,12,53,0,0,0,0,53,241,12
241,15,53,0,0,0,0,53,241,15
241,16,53,0,131,0,0,184,241,16
241,18,202,0,417,92,77,788,241,18
241,19,256,0,58,0,0,314,241,19
241,24,0,0,110,0,0,110,241,24
241,27,0,0,189,0,0,189,241,27
241,42,202,0,0,0,0,202,241,42
241,43,0,0,49,0,0,49,241,43
241,44,48,391,0,0,0,439,241,44
241,45,0,92,58,0,77,227,241,45
241,48,716,0,0,0,0,716,241,48
241,49,0,0,58,0,0,58,241,49
241,50,0,0,0,74,0,74,241,50
241,51,193,0,0,0,0,193,241,51
241,52,246,0,0,0,0,246,241,52
241,53,53,0,116,0,0,169,241,53
241,54,26,0,0,0,0,26,241,54
241,57,53,0,227,0,0,280,241,57
241,58,0,0,109,0,0,109,241,58
241,61,0,0,26,0,0,26,241,61
241,62,0,0,58,0,0,58,241,62
241,66,58,0,0,0,0,58,241,66
241,69,118,0,0,0,0,118,241,69
241,73,222,0,0,0,0,222,241,73
241,74,0,0,174,0,0,174,241,74
241,76,0,0,100,0,0,100,241,76
241,79,0,0,53,0,0,53,241,79
241,83,0,0,15,0,0,15,241,83
241,85,0,0,0,11,0,11,241,85
241,93,0,0,120,0,0,120,241,93
241,97,0,0,24,0,0,24,241,97
241,106,120,0,0,0,0,120,241,106
241,108,0,0,100,0,0,100,241,108
241,129,22,0,0,0,0,22,241,129
241,150,0,0,460,0,0,460,241,150
241,162,0,0,190,0,0,190,241,162
241,167,0,0,247,0,0,247,241,167
241,171,0,0,247,0,0,247,241,171
241,177,0,0,103,0,0,103,241,177
241,196,0,0,0,120,0,120,241,196
241,212,0,0,53,0,0,53,241,212
241,218,0,0,0,235,0,235,241,218
241,233,0,0,239,0,0,239,241,233
241,234,0,0,287,0,0,287,241,234
241,236,144,276,167,0,0,587,241,236
241,237,195,232,16,46,77,566,241,237
241,238,135,0,126,0,0,261,241,238
241,239,333,193,243,58,161,988,241,239
241,240,475,1705,0,270,0,2450,241,240
241,241,0,3037,0,0,0,3037,241,241
241,242,355,157,663,118,982,2275,241,242
241,243,0,0,131,0,0,131,241,243
241,244,1580,0,0,179,0,1759,241,244
241,245,0,0,227,0,0,227,241,245
241,247,0,0,1036,537,0,1573,241,247
241,252,0,0,100,0,0,100,241,252
241,253,0,141,25,23,0,189,241,253
241,254,0,116,0,0,0,116,241,254
241,255,758,0,0,0,0,758,241,255
241,256,433,0,0,0,0,433,241,256
241,258,0,0,881,0,0,881,241,258
241,266,327,0,0,0,0,327,241,266
241,268,53,0,0,0,0,53,241,268
241,274,0,0,266,0,0,266,241,274
241,291,0,0,1017,0,0,1017,241,291
241,295,0,0,555,0,0,555,241,295
241,300,0,0,58,0,0,58,241,300
241,301,0,0,58,0,0,58,241,301
241,317,14,0,0,0,0,14,241,317
241,334,0,0,0,708,0,708,241,334
241,338,53,0,0,0,0,53,241,338
242,4,0,0,339,0,0,339,242,4
242,5,0,0,1126,0,0,1126,242,5
242,7,339,0,0,0,0,339,242,7
242,17,0,0,120,0,0,120,242,17
242,18,339,0,178,0,0,517,242,18
242,19,178,0,272,0,0,450,242,19
242,20,0,0,576,0,0,576,242,20
242,24,181,0,0,0,0,181,242,24
242,27,0,0,178,0,0,178,242,27
242,29,0,0,33,0,0,33,242,29
242,36,0,0,186,0,0,186,242,36
242,43,0,0,598,0,0,598,242,43
242,44,339,0,0,0,0,339,242,44
242,45,0,0,0,339,258,597,242,45
242,50,0,0,528,0,0,528,242,50
242,53,0,0,408,0,0,408,242,53
242,55,0,0,200,0,0,200,242,55
242,56,0,0,339,0,0,339,242,56
242,61,0,0,0,339,0,339,242,61
242,73,0,0,97,0,0,97,242,73
242,77,0,0,588,0,0,588,242,77
242,79,0,0,475,0,0,475,242,79
242,84,0,0,339,0,0,339,242,84
242,92,0,0,428,0,0,428,242,92
242,100,0,0,368,0,0,368,242,100
242,115,0,0,526,0,0,526,242,115
242,116,0,0,186,0,0,186,242,116
242,129,0,0,97,0,0,97,242,129
242,138,0,0,48,0,0,48,242,138
242,139,0,0,178,0,0,178,242,139
242,144,178,0,178,0,0,356,242,144
242,147,0,0,305,0,0,305,242,147
242,160,0,0,155,0,0,155,242,160
242,166,0,0,250,0,0,250,242,166
242,167,0,0,417,0,0,417,242,167
242,236,178,127,758,358,0,1421,242,236
242,237,1328,1102,120,195,0,2745,242,237
242,239,0,186,368,410,0,964,242,239
242,241,355,157,368,297,982,2159,242,241
242,242,0,6716,0,843,1756,9315,242,242
242,243,0,973,601,0,491,2065,242,243
242,244,0,4167,1254,555,1383,7359,242,244
242,247,1163,0,0,0,0,1163,242,247
242,252,289,0,0,0,0,289,242,252
242,253,0,0,0,23,0,23,242,253
242,254,186,0,109,581,0,876,242,254
242,255,186,0,0,0,0,186,242,255
242,258,0,0,0,0,977,977,242,258
242,261,426,0,0,0,0,426,242,261
242,262,0,0,402,0,0,402,242,262
242,276,569,0,0,0,0,569,242,276
242,280,178,0,250,0,0,428,242,280
242,284,353,0,0,0,0,353,242,284
242,304,0,0,339,0,0,339,242,304
243,1,0,0,574,0,0,574,243,1
243,2,0,0,275,0,0,275,243,2
243,4,0,0,392,0,0,392,243,4
243,9,0,0,275,0,0,275,243,9
243,14,0,0,270,0,0,270,243,14
243,18,635,0,0,0,0,635,243,18
243,19,558,0,0,0,0,558,243,19
243,20,0,0,133,0,0,133,243,20
243,35,0,0,574,0,0,574,243,35
243,42,0,0,703,0,0,703,243,42
243,43,63,0,0,0,0,63,243,43
243,44,0,0,703,0,0,703,243,44
243,49,0,0,105,0,0,105,243,49
243,51,123,0,0,0,0,123,243,51
243,53,275,0,370,288,0,933,243,53
243,54,635,0,0,0,0,635,243,54
243,55,0,0,275,0,0,275,243,55
243,56,646,0,275,0,0,921,243,56
243,59,550,0,604,0,0,1154,243,59
243,75,56,0,570,0,0,626,243,75
243,93,0,0,56,0,0,56,243,93
243,112,0,0,434,0,0,434,243,112
243,134,0,0,620,0,0,620,243,134
243,155,0,0,275,0,0,275,243,155
243,159,173,0,0,0,0,173,243,159
243,183,563,0,0,674,0,1237,243,183
243,201,0,0,603,0,0,603,243,201
243,236,0,339,436,0,0,775,243,236
243,237,2071,0,133,0,0,2204,243,237
243,238,405,0,0,270,0,675,243,238
243,239,942,270,138,61,0,1411,243,239
243,240,0,0,703,0,0,703,243,240
243,241,0,0,131,0,0,131,243,241
243,242,0,973,601,0,491,2065,243,242
243,243,1290,25055,1911,2597,0,30853,243,243
243,244,552,13549,1848,2227,0,18176,243,244
243,245,1623,1641,337,497,0,4098,243,245
243,246,0,0,1022,138,0,1160,243,246
243,247,1892,0,1036,0,0,2928,243,247
243,249,570,450,0,0,0,1020,243,249
243,250,275,0,0,352,0,627,243,250
243,251,1202,0,361,0,0,1563,243,251
243,252,1126,487,0,0,0,1613,243,252
243,253,0,0,24,0,0,24,243,253
243,254,0,0,270,0,0,270,243,254
243,255,548,0,56,0,0,604,243,255
243,256,0,0,690,0,0,690,243,256
243,257,267,0,0,0,0,267,243,257
243,269,139,0,0,0,0,139,243,269
243,276,627,0,0,0,0,627,243,276
243,297,25,0,0,0,0,25,243,297
243,339,570,0,0,0,0,570,243,339
244,5,0,0,195,0,0,195,244,5
244,17,0,0,600,0,0,600,244,17
244,18,964,0,366,0,0,1330,244,18
244,20,0,0,0,803,0,803,244,20
244,24,0,0,195,0,0,195,244,24
244,34,0,0,337,0,0,337,244,34
244,37,0,0,447,0,0,447,244,37
244,43,0,0,1433,0,0,1433,244,43
244,44,0,0,600,0,0,600,244,44
244,51,0,0,532,0,0,532,244,51
244,54,0,0,0,337,0,337,244,54
244,55,0,0,789,0,0,789,244,55
244,57,0,0,337,0,0,337,244,57
244,59,0,0,2185,0,0,2185,244,59
244,61,0,0,2470,0,0,2470,244,61
244,63,6,0,532,0,0,538,244,63
244,66,0,0,212,829,0,1041,244,66
244,74,0,0,337,0,0,337,244,74
244,128,0,0,337,0,0,337,244,128
244,139,110,0,0,0,0,110,244,139
244,211,552,0,229,0,0,781,244,211
244,236,1505,0,1340,0,0,2845,244,236
244,237,697,953,2401,0,0,4051,244,237
244,238,284,1002,0,0,0,1286,244,238
244,239,1910,0,2339,1866,0,6115,244,239
244,240,0,0,711,0,0,711,244,240
244,241,1580,0,0,0,0,1580,244,241
244,242,0,4345,1254,555,1383,7537,244,242
244,243,2212,13576,1848,1863,0,19499,244,243
244,244,3164,23722,0,3181,0,30067,244,244
244,245,255,2486,856,420,0,4017,244,245
244,246,705,0,600,0,0,1305,244,246
244,247,1505,0,736,0,0,2241,244,247
244,248,957,0,0,0,0,957,244,248
244,249,0,0,0,337,0,337,244,249
244,250,337,0,675,0,0,1012,244,250
244,254,0,0,575,0,0,575,244,254
244,258,0,0,454,0,0,454,244,258
244,276,0,0,1063,0,0,1063,244,276
244,286,0,0,486,0,0,486,244,286
244,310,0,0,139,0,0,139,244,310
245,1,0,0,577,0,0,577,245,1
245,2,0,0,400,0,0,400,245,2
245,4,0,0,278,0,0,278,245,4
245,5,0,0,254,0,0,254,245,5
245,18,254,0,0,0,0,254,245,18
245,27,0,0,255,0,0,255,245,27
245,28,0,0,551,0,0,551,245,28
245,29,0,0,127,0,0,127,245,29
245,31,0,0,594,0,0,594,245,31
245,32,310,0,0,0,0,310,245,32
245,43,255,0,0,0,0,255,245,43
245,56,176,0,0,0,0,176,245,56
245,57,0,0,255,0,0,255,245,57
245,58,0,0,389,0,0,389,245,58
245,59,381,0,0,0,0,381,245,59
245,64,267,0,0,0,0,267,245,64
245,72,115,0,234,0,0,349,245,72
245,73,0,0,127,0,0,127,245,73
245,75,0,0,117,0,0,117,245,75
245,80,0,0,127,0,0,127,245,80
245,84,0,0,127,0,0,127,245,84
245,124,135,0,0,0,0,135,245,124
245,127,127,0,0,0,0,127,245,127
245,166,0,0,127,0,0,127,245,166
245,215,0,0,127,0,0,127,245,215
245,225,127,0,0,0,0,127,245,225
245,230,0,0,333,0,0,333,245,230
245,237,511,0,385,0,0,896,245,237
245,238,292,0,125,0,0,417,245,238
245,239,0,0,0,207,0,207,245,239
245,240,0,0,278,0,0,278,245,240
245,241,0,0,227,0,0,227,245,241
245,243,1333,1641,952,0,0,3926,245,243
245,244,348,2741,579,420,0,4088,245,244
245,245,0,8108,0,230,0,8338,245,245
245,246,0,0,322,0,0,322,245,246
245,247,127,0,0,0,0,127,245,247
245,249,127,0,0,0,0,127,245,249
245,252,0,0,138,0,0,138,245,252
245,254,0,0,255,0,0,255,245,254
245,286,0,0,278,0,0,278,245,286
245,301,255,0,0,0,0,255,245,301
246,1,114,0,114,0,0,228,246,1
246,4,114,0,0,0,0,114,246,4
246,15,0,0,114,0,0,114,246,15
246,16,0,0,124,0,0,124,246,16
246,23,0,0,453,0,0,453,246,23
246,24,0,0,113,0,0,113,246,24
246,25,0,0,140,0,0,140,246,25
246,26,0,0,113,0,0,113,246,26
246,29,0,0,0,113,0,113,246,29
246,32,0,0,113,0,0,113,246,32
246,42,369,0,0,0,0,369,246,42
246,45,0,0,519,0,0,519,246,45
246,49,0,0,588,0,0,588,246,49
246,54,0,0,1269,372,0,1641,246,54
246,57,114,0,113,0,0,227,246,57
246,58,100,0,0,114,0,214,246,58
246,59,372,0,641,0,0,1013,246,59
246,61,0,0,123,0,0,123,246,61
246,66,0,0,405,0,0,405,246,66
246,70,114,0,0,0,0,114,246,70
246,72,0,0,166,0,0,166,246,72
246,73,227,0,124,0,0,351,246,73
246,77,0,0,114,0,0,114,246,77
246,79,0,0,113,0,0,113,246,79
246,81,0,0,123,0,0,123,246,81
246,82,114,0,0,0,0,114,246,82
246,91,0,0,113,0,0,113,246,91
246,93,0,0,113,0,0,113,246,93
246,99,0,0,114,0,0,114,246,99
246,128,0,0,114,0,0,114,246,128
246,130,0,0,140,0,0,140,246,130
246,131,114,0,114,0,0,228,246,131
246,160,0,0,113,0,0,113,246,160
246,169,202,0,0,0,0,202,246,169
246,237,0,0,0,166,0,166,246,237
246,238,135,0,785,0,0,920,246,238
246,239,0,0,152,0,0,152,246,239
246,243,0,0,1022,138,0,1160,246,243
246,244,259,447,600,0,0,1306,246,244
246,245,0,0,322,0,0,322,246,245
246,246,455,9621,3952,860,0,14888,246,246
246,247,3561,138,4469,508,0,8676,246,247
246,248,476,0,124,0,0,600,246,248
246,249,0,0,124,0,0,124,246,249
246,250,0,0,529,0,0,529,246,250
246,275,223,0,0,0,0,223,246,275
246,278,113,0,0,0,0,113,246,278
246,306,0,0,808,0,0,808,246,306
246,324,0,0,631,0,0,631,246,324
247,1,0,0,2582,0,0,2582,247,1
247,2,1535,0,653,0,0,2188,247,2
247,18,348,0,0,93,0,441,247,18
247,19,0,0,1198,0,0,1198,247,19
247,20,254,0,653,0,0,907,247,20
247,27,0,0,725,1259,0,1984,247,27
247,29,0,0,1677,0,0,1677,247,29
247,31,0,0,725,0,0,725,247,31
247,35,0,0,788,0,0,788,247,35
247,39,0,0,310,0,0,310,247,39
247,51,0,0,90,0,0,90,247,51
247,53,0,0,973,0,0,973,247,53
247,54,563,0,0,0,0,563,247,54
247,59,725,0,3641,0,0,4366,247,59
247,61,0,0,893,0,0,893,247,61
247,62,0,0,973,0,0,973,247,62
247,64,725,0,0,0,0,725,247,64
247,65,116,0,0,0,0,116,247,65
247,68,725,0,894,0,0,1619,247,68
247,69,80,0,0,0,0,80,247,69
247,70,0,0,1125,0,0,1125,247,70
247,78,0,0,894,0,0,894,247,78
247,102,130,0,0,0,0,130,247,102
247,150,582,0,0,0,0,582,247,150
247,174,357,0,0,0,0,357,247,174
247,205,0,0,384,0,0,384,247,205
247,206,0,0,0,582,0,582,247,206
247,222,223,0,0,0,0,223,247,222
247,236,0,0,584,456,0,1040,247,236
247,237,978,0,2240,0,0,3218,247,237
247,238,977,0,2235,0,0,3212,247,238
247,239,2504,0,3124,0,0,5628,247,239
247,241,0,0,1036,537,0,1573,247,241
247,242,1163,0,0,0,0,1163,247,242
247,243,3018,0,1036,0,0,4054,247,243
247,244,1505,0,736,0,0,2241,247,244
247,245,127,0,0,0,0,127,247,245
247,246,3447,138,4469,508,0,8562,247,246
247,247,12298,72235,5008,7245,0,96786,247,247
247,249,953,3477,723,534,0,5687,247,249
247,250,0,0,2962,0,0,2962,247,250
247,251,0,0,4568,0,0,4568,247,251
247,252,185,1102,1122,0,0,2409,247,252
247,253,22,0,0,0,0,22,247,253
247,274,894,0,1100,1158,0,3152,247,274
247,275,1078,0,0,0,0,1078,247,275
247,277,894,0,0,0,0,894,247,277
247,278,395,0,0,0,0,395,247,278
247,281,838,0,1198,0,0,2036,247,281
247,285,490,0,0,0,0,490,247,285
247,286,86,0,0,0,0,86,247,286
247,287,0,0,725,0,0,725,247,287
247,300,456,0,0,0,0,456,247,300
247,303,894,0,1282,0,0,2176,247,303
247,305,0,0,131,0,0,131,247,305
247,315,185,0,0,0,0,185,247,315
247,325,0,0,724,0,0,724,247,325
247,328,0,0,973,0,0,973,247,328
248,17,0,0,26,0,0,26,248,17
248,19,0,0,145,0,0,145,248,19
248,28,38,0,0,0,0,38,248,28
248,49,0,0,73,0,0,73,248,49
248,59,173,0,0,0,251,424,248,59
248,76,38,0,0,0,0,38,248,76
248,93,0,0,245,0,0,245,248,93
248,236,957,0,0,0,0,957,248,236
248,240,50,0,0,0,0,50,248,240
248,246,476,0,124,0,0,600,248,246
248,250,0,108,0,0,0,108,248,250
248,270,54,0,0,0,0,54,248,270
248,273,0,0,0,1408,0,1408,248,273
248,294,0,0,508,0,0,508,248,294
249,2,0,0,607,0,0,607,249,2
249,5,608,0,114,0,0,722,249,5
249,7,0,0,332,0,0,332,249,7
249,10,0,0,114,0,0,114,249,10
249,27,0,0,332,0,0,332,249,27
249,31,0,0,332,0,0,332,249,31
249,37,0,0,114,0,0,114,249,37
249,53,0,157,0,0,0,157,249,53
249,58,0,0,620,0,0,620,249,58
249,59,7356,0,1676,0,880,9912,249,59
249,61,0,0,451,0,0,451,249,61
249,64,332,0,0,0,0,332,249,64
249,74,0,0,608,0,0,608,249,74
249,80,0,0,608,0,0,608,249,80
249,81,0,0,526,0,0,526,249,81
249,100,114,0,0,0,0,114,249,100
249,136,114,0,0,0,0,114,249,136
249,165,0,0,483,0,0,483,249,165
249,188,608,0,0,0,0,608,249,188
249,236,0,347,2292,0,0,2639,249,236
249,239,1823,0,909,0,0,2732,249,239
249,240,0,0,228,0,0,228,249,240
249,243,845,450,0,0,0,1295,249,243
249,244,0,0,0,337,0,337,249,244
249,245,254,0,0,0,0,254,249,245
249,246,0,0,124,0,0,124,249,246
249,247,953,3477,723,534,0,5687,249,247
249,249,7437,12751,1446,0,0,21634,249,249
249,250,483,1267,526,0,0,2276,249,250
249,251,608,608,0,0,0,1216,249,251
249,252,0,500,1468,570,0,2538,249,252
249,264,392,0,0,0,0,392,249,264
249,269,0,0,0,238,0,238,249,269
249,273,0,0,766,0,0,766,249,273
249,274,1738,0,661,0,0,2399,249,274
249,275,114,0,0,0,0,114,249,275
249,276,0,462,0,0,0,462,249,276
249,300,0,0,526,0,0,526,249,300
250,1,0,0,123,0,0,123,250,1
250,2,254,0,0,108,0,362,250,2
250,3,0,0,118,0,0,118,250,3
250,5,0,0,108,0,0,108,250,5
250,6,23,0,0,0,0,23,250,6
250,12,0,0,108,0,0,108,250,12
250,16,254,0,0,0,0,254,250,16
250,17,0,0,35,0,0,35,250,17
250,21,0,0,108,0,0,108,250,21
250,23,56,0,315,0,0,371,250,23
250,24,234,0,330,0,0,564,250,24
250,28,0,0,325,0,0,325,250,28
250,31,288,0,0,0,0,288,250,31
250,32,0,0,123,0,0,123,250,32
250,36,0,0,102,0,0,102,250,36
250,38,0,0,0,18,0,18,250,38
250,40,649,0,0,0,0,649,250,40
250,41,156,0,0,0,0,156,250,41
250,43,108,0,0,0,0,108,250,43
250,45,254,0,0,0,0,254,250,45
250,50,0,0,108,0,0,108,250,50
250,51,0,0,0,248,0,248,250,51
250,53,179,0,867,0,0,1046,250,53
250,54,87,0,0,396,0,483,250,54
250,57,0,0,359,0,0,359,250,57
250,58,658,783,0,0,145,1586,250,58
250,59,694,771,0,150,0,1615,250,59
250,61,507,0,240,0,0,747,250,61
250,63,11,0,0,0,0,11,250,63
250,66,216,0,298,0,0,514,250,66
250,79,0,0,108,0,0,108,250,79
250,82,254,0,108,0,0,362,250,82
250,115,266,0,0,0,0,266,250,115
250,144,0,0,824,0,0,824,250,144
250,169,404,0,0,0,0,404,250,169
250,174,0,0,0,277,0,277,250,174
250,205,0,0,384,0,0,384,250,205
250,225,0,0,146,0,0,146,250,225
250,230,0,0,333,0,0,333,250,230
250,236,135,0,0,0,0,135,250,236
250,237,83,0,0,0,0,83,250,237
250,238,412,135,0,0,0,547,250,238
250,239,258,0,276,0,0,534,250,239
250,240,0,0,224,0,0,224,250,240
250,243,275,0,0,352,0,627,250,243
250,244,1290,0,675,0,0,1965,250,244
250,246,0,0,529,0,0,529,250,246
250,247,1457,0,1405,0,0,2862,250,247
250,248,0,108,0,0,0,108,250,248
250,249,483,1971,526,0,0,2980,250,249
250,250,216,5228,0,0,0,5444,250,250
250,251,0,1166,0,200,0,1366,250,251
250,252,802,1786,114,789,0,3491,250,252
250,254,0,0,294,0,0,294,250,254
250,269,277,0,0,0,0,277,250,269
250,274,267,0,845,0,0,1112,250,274
250,275,1738,0,179,0,0,1917,250,275
250,276,0,0,621,0,0,621,250,276
250,277,108,0,254,0,0,362,250,277
250,278,1627,0,0,395,0,2022,250,278
250,281,108,0,0,0,0,108,250,281
250,284,602,0,0,0,0,602,250,284
250,285,0,0,725,0,0,725,250,285
250,310,255,0,0,0,0,255,250,310
250,316,108,0,0,0,0,108,250,316
250,323,0,0,586,0,0,586,250,323
251,1,0,0,200,0,0,200,251,1
251,3,0,0,645,0,0,645,251,3
251,5,0,0,200,0,0,200,251,5
251,7,200,0,0,0,0,200,251,7
251,15,281,0,0,0,0,281,251,15
251,21,151,0,217,0,0,368,251,21
251,22,0,0,279,0,0,279,251,22
251,24,0,0,0,66,0,66,251,24
251,26,113,0,0,0,0,113,251,26
251,31,200,0,0,0,0,200,251,31
251,34,39,0,39,0,0,78,251,34
251,36,466,0,0,0,0,466,251,36
251,43,74,0,0,0,0,74,251,43
251,45,0,0,0,1168,0,1168,251,45
251,48,0,0,344,0,0,344,251,48
251,50,109,0,0,0,0,109,251,50
251,53,0,200,0,359,0,559,251,53
251,54,0,0,618,0,0,618,251,54
251,56,200,0,200,0,0,400,251,56
251,57,200,0,0,0,0,200,251,57
251,59,0,0,950,291,0,1241,251,59
251,60,316,0,0,0,0,316,251,60
251,63,0,0,0,219,0,219,251,63
251,64,200,0,0,0,0,200,251,64
251,68,256,0,279,0,0,535,251,68
251,75,200,0,0,0,0,200,251,75
251,76,428,0,0,0,0,428,251,76
251,81,56,0,0,0,0,56,251,81
251,84,0,0,389,0,0,389,251,84
251,91,0,0,200,0,0,200,251,91
251,100,200,0,0,0,0,200,251,100
251,121,0,0,889,0,0,889,251,121
251,148,0,0,278,0,0,278,251,148
251,150,200,0,0,0,0,200,251,150
251,203,0,0,190,0,0,190,251,203
251,233,0,0,640,0,0,640,251,233
251,237,0,0,78,0,0,78,251,237
251,238,783,256,85,314,0,1438,251,238
251,239,1242,0,67,337,0,1646,251,239
251,243,854,0,361,0,0,1215,251,243
251,247,0,0,4568,0,0,4568,251,247
251,249,807,608,0,0,0,1415,251,249
251,250,200,1166,0,200,0,1566,251,250
251,251,1266,4461,0,513,0,6240,251,251
251,252,450,254,393,1178,0,2275,251,252
251,255,44,0,0,0,0,44,251,255
251,268,200,0,0,0,0,200,251,268
251,276,601,0,0,0,0,601,251,276
251,284,400,0,0,0,0,400,251,284
251,285,405,0,0,0,0,405,251,285
251,288,0,0,0,240,0,240,251,288
251,300,1117,0,0,0,0,1117,251,300
251,302,200,0,0,0,0,200,251,302
251,304,0,0,217,0,0,217,251,304
251,305,0,0,376,0,0,376,251,305
251,318,0,0,0,40,0,40,251,318
251,322,157,0,0,0,0,157,251,322
252,1,0,0,380,0,0,380,252,1
252,4,0,0,51,0,0,51,252,4
252,5,0,0,126,0,0,126,252,5
252,17,0,0,58,0,0,58,252,17
252,19,315,0,0,0,0,315,252,19
252,24,0,0,254,0,0,254,252,24
252,40,0,0,620,0,0,620,252,40
252,54,0,0,137,0,0,137,252,54
252,58,247,200,331,0,0,778,252,58
252,59,0,0,743,0,0,743,252,59
252,63,11,0,0,0,0,11,252,63
252,66,0,0,126,0,0,126,252,66
252,68,62,0,0,0,0,62,252,68
252,69,85,0,0,62,0,147,252,69
252,73,0,0,144,0,0,144,252,73
252,76,62,0,0,0,0,62,252,76
252,79,0,0,393,0,0,393,252,79
252,80,0,0,0,44,0,44,252,80
252,82,126,0,126,0,0,252,252,82
252,94,0,0,745,0,0,745,252,94
252,101,0,0,0,62,0,62,252,101
252,131,0,0,206,0,0,206,252,131
252,164,0,0,137,0,0,137,252,164
252,167,0,0,254,0,0,254,252,167
252,170,0,0,92,0,0,92,252,170
252,207,0,0,105,0,0,105,252,207
252,236,0,0,105,0,0,105,252,236
252,237,15,0,657,0,0,672,252,237
252,238,252,559,0,0,0,811,252,238
252,239,745,0,0,0,0,745,252,239
252,241,0,0,100,0,0,100,252,241
252,242,289,0,0,0,0,289,252,242
252,243,0,487,0,0,0,487,252,243
252,245,0,0,138,0,0,138,252,245
252,247,686,1163,1122,0,0,2971,252,247
252,249,0,500,1468,570,0,2538,252,249
252,250,1492,1786,114,789,0,4181,252,250
252,251,450,254,393,1178,0,2275,252,251
252,252,1716,12712,1620,0,0,16048,252,252
252,254,0,0,378,0,0,378,252,254
252,259,0,0,576,0,0,576,252,259
252,269,375,0,851,0,0,1226,252,269
252,274,252,0,126,0,0,378,252,274
252,277,1072,0,0,0,0,1072,252,277
252,300,745,0,254,0,0,999,252,300
252,303,0,0,29,0,0,29,252,303
252,304,0,0,204,0,0,204,252,304
253,3,0,0,23,0,0,23,253,3
253,7,0,0,24,0,0,24,253,7
253,10,0,0,5,0,0,5,253,10
253,14,0,0,24,0,0,24,253,14
253,18,0,0,0,0,34,34,253,18
253,23,39,0,23,0,0,62,253,23
253,29,0,0,488,0,0,488,253,29
253,40,0,0,15,0,0,15,253,40
253,43,0,0,58,0,0,58,253,43
253,44,0,0,14,22,0,36,253,44
253,45,261,259,77,263,34,894,253,45
253,46,0,24,0,0,0,24,253,46
253,54,0,0,43,0,0,43,253,54
253,57,0,0,24,0,0,24,253,57
253,73,0,0,22,0,0,22,253,73
253,77,0,0,36,0,0,36,253,77
253,79,0,0,8,0,0,8,253,79
253,95,0,0,24,0,0,24,253,95
253,130,0,0,45,0,0,45,253,130
253,160,22,0,0,0,0,22,253,160
253,166,0,0,26,0,0,26,253,166
253,167,0,0,23,79,0,102,253,167
253,197,0,0,180,0,0,180,253,197
253,198,0,0,23,0,0,23,253,198
253,204,0,0,15,0,0,15,253,204
253,209,0,0,39,0,0,39,253,209
253,210,0,0,40,0,0,40,253,210
253,211,0,0,24,0,0,24,253,211
253,230,0,0,770,0,0,770,253,230
253,232,0,0,0,687,0,687,253,232
253,235,0,0,43,0,0,43,253,235
253,237,0,0,61,0,0,61,253,237
253,239,0,0,65,0,0,65,253,239
253,241,0,141,25,23,0,189,253,241
253,242,0,0,0,23,0,23,253,242
253,243,0,0,24,0,0,24,253,243
253,247,22,0,0,0,0,22,253,247
253,253,24,988,47,44,0,1103,253,253
253,254,404,1089,199,62,34,1788,253,254
253,255,0,357,26,198,34,615,253,255
253,256,0,0,90,0,0,90,253,256
253,257,0,0,69,0,0,69,253,257
253,258,321,0,0,0,32,353,253,258
253,260,0,0,282,0,0,282,253,260
253,261,0,0,26,0,0,26,253,261
253,263,0,0,634,0,0,634,253,263
253,275,0,0,149,0,0,149,253,275
253,276,0,0,601,0,0,601,253,276
253,300,0,0,24,0,0,24,253,300
253,301,0,0,24,0,0,24,253,301
253,332,0,0,235,0,0,235,253,332
254,1,0,0,195,0,0,195,254,1
254,3,0,0,351,0,0,351,254,3
254,6,0,0,280,0,0,280,254,6
254,7,144,0,0,0,0,144,254,7
254,11,208,0,0,0,0,208,254,11
254,13,0,0,0,33,0,33,254,13
254,14,0,0,41,0,0,41,254,14
254,15,0,0,853,0,0,853,254,15
254,18,0,0,102,0,0,102,254,18
254,21,83,0,0,0,0,83,254,21
254,22,0,0,640,0,0,640,254,22
254,23,0,0,478,0,0,478,254,23
254,24,0,0,245,0,0,245,254,24
254,27,0,0,600,0,0,600,254,27
254,28,0,0,496,0,0,496,254,28
254,30,109,0,0,0,0,109,254,30
254,31,0,0,518,0,0,518,254,31
254,32,0,0,582,0,0,582,254,32
254,35,0,0,18,0,0,18,254,35
254,36,0,0,248,0,0,248,254,36
254,37,600,0,0,61,0,661,254,37
254,40,18,0,516,10,0,544,254,40
254,41,0,0,320,0,0,320,254,41
254,42,0,0,57,0,0,57,254,42
254,43,160,0,1403,0,0,1563,254,43
254,44,1069,0,537,0,0,1606,254,44
254,45,2100,293,519,807,0,3719,254,45
254,46,618,477,1454,0,0,2549,254,46
254,47,657,0,776,214,0,1647,254,47
254,48,562,0,324,0,0,886,254,48
254,51,0,0,448,600,0,1048,254,51
254,53,248,0,107,0,0,355,254,53
254,54,14,0,0,0,0,14,254,54
254,55,0,0,0,1312,0,1312,254,55
254,57,0,0,867,0,0,867,254,57
254,59,0,0,248,0,0,248,254,59
254,62,0,0,26,27,0,53,254,62
254,68,0,0,294,0,0,294,254,68
254,70,218,0,0,0,0,218,254,70
254,73,0,0,248,0,0,248,254,73
254,74,109,0,698,0,0,807,254,74
254,80,0,0,294,0,0,294,254,80
254,83,0,0,129,0,0,129,254,83
254,94,31,0,0,0,0,31,254,94
254,101,0,0,220,0,0,220,254,101
254,107,0,0,0,248,0,248,254,107
254,112,0,0,167,0,0,167,254,112
254,119,0,0,879,0,0,879,254,119
254,126,0,0,341,0,0,341,254,126
254,130,0,0,14,0,0,14,254,130
254,131,0,0,294,0,0,294,254,131
254,144,0,0,742,0,0,742,254,144
254,148,241,0,0,0,0,241,254,148
254,163,561,0,0,0,0,561,254,163
254,166,521,0,0,0,0,521,254,166
254,167,107,0,496,0,0,603,254,167
254,168,109,0,0,0,0,109,254,168
254,180,0,0,752,0,0,752,254,180
254,184,0,0,600,0,0,600,254,184
254,185,0,0,351,0,0,351,254,185
254,194,0,0,139,0,0,139,254,194
254,203,0,0,289,0,0,289,254,203
254,208,2207,0,0,0,0,2207,254,208
254,210,2353,0,127,0,0,2480,254,210
254,211,109,0,0,0,0,109,254,211
254,212,0,0,656,0,0,656,254,212
254,213,109,0,0,0,0,109,254,213
254,214,0,0,638,0,0,638,254,214
254,218,0,0,654,0,0,654,254,218
254,222,0,0,540,0,0,540,254,222
254,223,0,0,274,0,0,274,254,223
254,225,0,0,463,0,0,463,254,225
254,231,0,0,382,0,0,382,254,231
254,232,0,0,654,0,0,654,254,232
254,233,0,0,1794,0,0,1794,254,233
254,234,0,0,506,0,0,506,254,234
254,235,0,0,696,0,0,696,254,235
254,236,0,0,248,0,0,248,254,236
254,237,0,0,311,107,0,418,254,237
254,238,0,0,0,135,0,135,254,238
254,239,1407,0,67,0,0,1474,254,239
254,241,0,116,0,0,0,116,254,241
254,242,428,0,109,339,0,876,254,242
254,243,0,0,270,0,0,270,254,243
254,244,0,0,231,0,0,231,254,244
254,245,0,0,255,0,0,255,254,245
254,250,0,0,294,0,0,294,254,250
254,252,0,0,378,0,0,378,254,252
254,253,22,1117,183,62,34,1418,254,253
254,254,5555,12974,386,2256,0,21171,254,254
254,255,3731,1535,2048,809,0,8123,254,255
254,256,907,1353,471,208,0,2939,254,256
254,257,2179,0,486,0,0,2665,254,257
254,258,0,0,1942,670,0,2612,254,258
254,259,0,0,355,0,0,355,254,259
254,261,0,0,292,0,0,292,254,261
254,262,0,0,1413,0,0,1413,254,262
254,263,0,0,1257,0,0,1257,254,263
254,264,518,0,365,0,0,883,254,264
254,266,240,0,0,0,0,240,254,266
254,269,0,0,84,0,0,84,254,269
254,271,129,0,0,0,0,129,254,271
254,283,0,0,317,0,0,317,254,283
254,301,188,0,0,0,0,188,254,301
254,327,199,0,0,0,0,199,254,327
254,328,395,0,0,0,0,395,254,328
254,339,248,0,290,0,0,538,254,339
254,342,0,0,443,0,0,443,254,342
255,2,863,0,0,0,0,863,255,2
255,4,0,0,805,0,0,805,255,4
255,6,466,0,0,0,0,466,255,6
255,13,3695,0,0,0,0,3695,255,13
255,19,758,0,506,0,0,1264,255,19
255,20,758,0,0,0,0,758,255,20
255,23,0,0,787,0,0,787,255,23
255,27,0,0,758,0,0,758,255,27
255,29,0,0,890,0,0,890,255,29
255,30,47,0,0,0,0,47,255,30
255,35,0,0,1563,0,0,1563,255,35
255,42,885,0,825,0,0,1710,255,42
255,43,258,0,939,0,0,1197,255,43
255,44,931,0,0,0,0,931,255,44
255,45,758,0,0,0,1100,1858,255,45
255,46,809,0,0,0,0,809,255,46
255,47,220,0,0,0,0,220,255,47
255,48,758,0,0,0,0,758,255,48
255,49,404,0,0,0,0,404,255,49
255,57,1391,0,0,0,0,1391,255,57
255,63,927,0,0,0,0,927,255,63
255,100,0,0,740,0,0,740,255,100
255,101,0,0,166,0,0,166,255,101
255,107,99,0,0,0,0,99,255,107
255,135,170,0,0,0,0,170,255,135
255,165,740,0,0,0,0,740,255,165
255,166,102,0,113,0,0,215,255,166
255,167,614,0,0,0,0,614,255,167
255,169,196,0,0,0,0,196,255,169
255,200,0,0,132,0,0,132,255,200
255,202,444,0,0,0,0,444,255,202
255,203,380,0,0,0,0,380,255,203
255,207,0,0,1138,0,0,1138,255,207
255,208,0,0,0,688,0,688,255,208
255,209,466,0,0,0,0,466,255,209
255,210,117,0,825,0,0,942,255,210
255,211,0,0,963,0,0,963,255,211
255,213,0,0,449,0,0,449,255,213
255,215,0,0,0,41,0,41,255,215
255,221,236,0,0,0,0,236,255,221
255,234,0,0,506,0,0,506,255,234
255,239,569,0,0,0,0,569,255,239
255,241,758,0,0,0,0,758,255,241
255,242,186,0,0,0,0,186,255,242
255,243,548,0,56,0,0,604,255,243
255,251,44,0,0,0,0,44,255,251
255,253,0,357,532,198,34,1121,255,253
255,254,4189,1998,1416,809,0,8412,255,254
255,255,24011,32589,0,0,2047,58647,255,255
255,256,1901,977,284,323,0,3485,255,256
255,257,866,0,0,529,0,1395,255,257
255,258,2779,1770,2420,0,0,6969,255,258
255,259,0,0,213,0,0,213,255,259
255,260,449,0,0,0,326,775,255,260
255,261,0,0,464,0,0,464,255,261
255,263,0,0,838,0,0,838,255,263
255,340,0,0,464,0,0,464,255,340
256,5,0,0,88,0,0,88,256,5
256,9,0,0,404,0,0,404,256,9
256,13,0,0,74,0,0,74,256,13
256,15,261,0,0,0,0,261,256,15
256,17,0,0,472,0,0,472,256,17
256,19,0,0,74,0,0,74,256,19
256,29,0,0,261,0,0,261,256,29
256,32,0,0,295,0,0,295,256,32
256,42,0,0,0,48,0,48,256,42
256,43,0,0,707,0,0,707,256,43
256,44,0,0,284,886,0,1170,256,44
256,46,138,0,0,0,0,138,256,46
256,47,0,0,102,0,0,102,256,47
256,54,93,0,0,0,0,93,256,54
256,56,0,0,0,148,0,148,256,56
256,59,0,0,138,0,0,138,256,59
256,60,102,0,0,0,0,102,256,60
256,61,0,0,472,0,0,472,256,61
256,62,0,0,534,0,0,534,256,62
256,79,0,0,612,0,0,612,256,79
256,83,0,0,295,0,0,295,256,83
256,91,0,0,261,0,0,261,256,91
256,93,261,0,0,0,0,261,256,93
256,95,102,0,0,0,0,102,256,95
256,97,35,0,0,0,0,35,256,97
256,102,85,0,0,0,0,85,256,102
256,119,0,0,417,0,0,417,256,119
256,126,0,0,246,0,0,246,256,126
256,129,0,0,261,0,0,261,256,129
256,168,817,0,0,0,0,817,256,168
256,169,0,0,126,0,0,126,256,169
256,200,0,0,149,0,0,149,256,200
256,208,0,0,292,0,0,292,256,208
256,211,776,0,0,0,0,776,256,211
256,219,343,0,0,0,0,343,256,219
256,231,0,0,165,0,0,165,256,231
256,239,450,0,321,522,0,1293,256,239
256,241,433,0,0,0,0,433,256,241
256,243,0,0,690,0,0,690,256,243
256,253,0,0,89,0,0,89,256,253
256,254,351,1353,1124,208,0,3036,256,254
256,255,2423,977,0,323,0,3723,256,255
256,256,797,3296,0,1291,0,5384,256,256
256,257,3104,2401,943,311,0,6759,256,257
256,258,2104,417,3081,0,0,5602,256,258
256,259,0,0,1025,0,0,1025,256,259
256,263,261,0,624,0,0,885,256,263
256,271,0,0,295,0,0,295,256,271
256,300,0,0,0,261,0,261,256,300
256,339,0,0,434,0,0,434,256,339
257,3,0,0,277,0,0,277,257,3
257,16,0,0,277,0,0,277,257,16
257,18,0,0,471,0,0,471,257,18
257,24,0,0,197,0,0,197,257,24
257,27,0,0,696,0,0,696,257,27
257,28,447,0,0,0,0,447,257,28
257,29,433,0,0,0,0,433,257,29
257,34,0,0,255,0,0,255,257,34
257,41,121,0,0,0,0,121,257,41
257,43,447,0,145,0,0,592,257,43
257,45,433,0,486,0,0,919,257,45
257,46,2307,0,545,0,0,2852,257,46
257,48,1400,0,471,0,0,1871,257,48
257,55,0,0,633,0,0,633,257,55
257,65,0,0,0,263,0,263,257,65
257,70,0,0,433,0,0,433,257,70
257,72,0,0,433,0,0,433,257,72
257,73,433,0,0,0,0,433,257,73
257,74,0,0,255,0,0,255,257,74
257,79,0,0,447,0,0,447,257,79
257,82,0,0,433,0,0,433,257,82
257,93,0,0,0,56,0,56,257,93
257,94,631,0,255,0,0,886,257,94
257,98,7,0,0,0,0,7,257,98
257,115,577,0,0,0,0,577,257,115
257,136,631,0,0,0,0,631,257,136
257,167,0,0,127,0,0,127,257,167
257,168,204,0,0,0,0,204,257,168
257,209,255,0,0,0,0,255,257,209
257,210,0,0,471,529,0,1000,257,210
257,211,519,962,0,0,0,1481,257,211
257,212,323,0,89,0,0,412,257,212
257,213,572,0,0,0,0,572,257,213
257,220,189,0,0,0,0,189,257,220
257,232,0,0,341,0,0,341,257,232
257,236,0,0,471,0,0,471,257,236
257,240,0,0,290,0,0,290,257,240
257,243,267,0,0,0,0,267,257,243
257,253,0,0,69,0,0,69,257,253
257,254,2179,0,486,0,0,2665,257,254
257,255,866,0,0,529,0,1395,257,255
257,256,2837,1873,1517,311,0,6538,257,256
257,257,2048,12039,0,0,0,14087,257,257
257,258,255,799,0,0,0,1054,257,258
257,259,0,0,213,0,0,213,257,259
257,261,1120,1008,1958,0,0,4086,257,261
257,262,0,841,1043,0,0,1884,257,262
257,263,0,0,634,0,0,634,257,263
257,300,433,0,880,0,0,1313,257,300
257,338,433,0,0,0,0,433,257,338
257,339,0,0,433,0,0,433,257,339
258,1,0,0,823,0,0,823,258,1
258,2,0,0,317,0,0,317,258,2
258,6,0,0,733,0,0,733,258,6
258,15,0,0,565,0,0,565,258,15
258,18,0,0,881,0,0,881,258,18
258,24,0,0,1024,0,0,1024,258,24
258,25,0,0,454,0,0,454,258,25
258,28,0,0,0,237,0,237,258,28
258,39,0,0,454,0,0,454,258,39
258,40,18,0,0,0,0,18,258,40
258,43,63,0,749,0,0,812,258,43
258,44,0,0,2041,0,0,2041,258,44
258,45,834,0,0,0,0,834,258,45
258,46,0,0,310,0,0,310,258,46
258,59,0,0,607,0,0,607,258,59
258,60,0,0,809,0,0,809,258,60
258,73,0,0,809,0,0,809,258,73
258,77,0,0,417,0,0,417,258,77
258,82,0,0,674,0,0,674,258,82
258,96,0,0,674,0,0,674,258,96
258,137,333,0,0,0,0,333,258,137
258,157,0,0,0,154,0,154,258,157
258,171,0,0,733,0,0,733,258,171
258,182,0,0,501,0,0,501,258,182
258,194,0,0,139,0,0,139,258,194
258,208,809,0,0,0,0,809,258,208
258,209,473,0,0,0,0,473,258,209
258,210,237,0,0,0,0,237,258,210
258,211,0,0,1187,0,0,1187,258,211
258,212,0,0,1149,0,0,1149,258,212
258,215,237,0,0,0,0,237,258,215
258,217,0,0,0,291,0,291,258,217
258,225,0,0,0,134,0,134,258,225
258,226,381,0,0,0,0,381,258,226
258,229,0,0,1248,0,0,1248,258,229
258,230,0,0,333,0,0,333,258,230
258,231,237,0,0,0,0,237,258,231
258,232,314,0,0,0,0,314,258,232
258,233,0,0,239,0,0,239,258,233
258,236,237,0,0,0,0,237,258,236
258,239,0,0,615,0,0,615,258,239
258,241,0,0,881,0,0,881,258,241
258,242,0,0,0,0,977,977,258,242
258,244,0,0,454,0,0,454,258,244
258,253,321,0,0,0,32,353,258,253
258,254,0,0,1877,670,0,2547,258,254
258,255,3000,1770,1564,0,0,6334,258,255
258,256,1843,417,3365,0,0,5625,258,256
258,257,255,799,0,0,0,1054,258,257
258,258,2852,18468,3807,6169,0,31296,258,258
258,259,208,0,0,0,0,208,258,259
258,260,458,878,673,0,0,2009,258,260
258,261,3354,694,0,317,0,4365,258,261
258,262,1503,0,1648,0,0,3151,258,262
258,263,287,0,1031,0,0,1318,258,263
258,265,679,0,373,0,0,1052,258,265
258,267,153,0,0,0,0,153,258,267
258,276,0,0,654,0,0,654,258,276
259,14,0,0,208,0,0,208,259,14
259,19,0,0,213,0,0,213,259,19
259,28,0,0,204,0,0,204,259,28
259,35,0,0,417,0,0,417,259,35
259,40,0,0,626,0,0,626,259,40
259,41,0,0,182,0,0,182,259,41
259,42,0,0,417,0,0,417,259,42
259,44,0,0,227,0,0,227,259,44
259,45,576,0,0,0,0,576,259,45
259,46,0,0,504,0,0,504,259,46
259,54,0,0,463,0,0,463,259,54
259,59,0,0,0,139,0,139,259,59
259,62,0,0,236,0,0,236,259,62
259,77,0,0,213,0,0,213,259,77
259,211,585,0,0,0,0,585,259,211
259,225,0,0,146,0,0,146,259,225
259,231,0,0,509,0,0,509,259,231
259,235,0,0,1109,0,0,1109,259,235
259,237,0,0,213,0,0,213,259,237
259,240,0,0,172,0,0,172,259,240
259,252,0,0,576,0,0,576,259,252
259,254,0,0,355,0,0,355,259,254
259,255,0,0,213,0,0,213,259,255
259,256,0,0,1025,0,0,1025,259,256
259,257,0,0,213,0,0,213,259,257
259,259,650,11999,417,620,0,13686,259,259
259,260,361,3976,417,492,0,5246,259,260
259,261,0,622,840,0,0,1462,259,261
259,263,0,2023,0,2465,0,4488,259,263
259,264,621,0,172,0,0,793,259,264
259,265,0,0,354,0,0,354,259,265
259,267,0,0,299,0,0,299,259,267
260,1,0,0,312,0,0,312,260,1
260,18,0,0,282,0,0,282,260,18
260,22,0,0,787,0,0,787,260,22
260,24,0,0,857,0,0,857,260,24
260,29,0,0,683,0,0,683,260,29
260,40,0,0,856,0,0,856,260,40
260,41,0,0,431,0,0,431,260,41
260,44,0,0,856,225,0,1081,260,44
260,46,0,259,0,0,0,259,260,46
260,53,0,0,259,0,0,259,260,53
260,54,0,0,282,0,0,282,260,54
260,55,0,0,856,0,0,856,260,55
260,56,0,0,499,0,0,499,260,56
260,84,225,0,0,0,0,225,260,84
260,87,0,0,458,0,0,458,260,87
260,91,0,0,1200,0,0,1200,260,91
260,100,0,0,499,0,0,499,260,100
260,165,0,0,267,0,0,267,260,165
260,170,0,0,458,0,0,458,260,170
260,205,0,0,858,0,0,858,260,205
260,213,0,0,0,396,0,396,260,213
260,229,0,0,499,0,0,499,260,229
260,231,0,0,165,0,0,165,260,231
260,232,915,259,0,0,0,1174,260,232
260,233,458,0,499,0,0,957,260,233
260,235,0,0,515,0,0,515,260,235
260,238,0,0,690,0,0,690,260,238
260,253,0,0,282,0,0,282,260,253
260,255,449,0,856,0,326,1631,260,255
260,258,458,878,673,0,0,2009,260,258
260,259,158,4180,417,492,0,5247,260,259
260,260,1057,14701,0,947,751,17456,260,260
260,261,188,1923,292,0,0,2403,260,261
260,262,841,1642,499,0,0,2982,260,262
260,263,458,287,1575,0,0,2320,260,263
260,264,431,0,0,0,0,431,260,264
260,269,0,0,458,0,0,458,260,269
260,300,0,0,689,0,0,689,260,300
260,339,225,0,0,0,0,225,260,339
260,342,0,0,232,0,0,232,260,342
261,2,0,0,292,0,0,292,261,2
261,5,0,0,464,0,0,464,261,5
261,6,0,0,928,0,0,928,261,6
261,8,0,0,273,0,0,273,261,8
261,18,0,0,292,0,0,292,261,18
261,20,0,0,892,0,0,892,261,20
261,23,0,0,561,0,0,561,261,23
261,24,0,0,292,0,0,292,261,24
261,27,0,0,426,0,0,426,261,27
261,28,0,0,426,0,0,426,261,28
261,37,0,0,268,0,0,268,261,37
261,40,426,0,213,0,0,639,261,40
261,41,0,0,464,0,0,464,261,41
261,45,0,0,472,0,0,472,261,45
261,46,0,268,2029,0,0,2297,261,46
261,47,0,0,464,0,0,464,261,47
261,49,0,0,426,0,0,426,261,49
261,58,0,0,292,0,0,292,261,58
261,64,0,0,0,515,0,515,261,64
261,73,0,0,892,0,0,892,261,73
261,88,0,0,0,253,0,253,261,88
261,92,0,0,464,0,0,464,261,92
261,93,426,0,0,0,0,426,261,93
261,127,0,0,166,0,0,166,261,127
261,129,0,0,464,0,0,464,261,129
261,137,0,0,464,0,0,464,261,137
261,166,166,0,0,0,0,166,261,166
261,167,694,0,0,0,0,694,261,167
261,169,0,0,739,0,0,739,261,169
261,170,695,0,0,0,0,695,261,170
261,197,0,0,0,333,0,333,261,197
261,208,0,0,292,0,0,292,261,208
261,210,426,0,347,0,0,773,261,210
261,211,2310,2836,0,0,0,5146,261,211
261,212,2956,2545,0,0,0,5501,261,212
261,213,166,407,739,0,0,1312,261,213
261,214,0,0,40,0,0,40,261,214
261,215,0,0,292,0,0,292,261,215
261,220,296,0,0,0,0,296,261,220
261,221,251,0,0,0,0,251,261,221
261,222,0,0,464,0,0,464,261,222
261,223,391,0,130,0,0,521,261,223
261,224,0,0,1644,0,0,1644,261,224
261,225,0,0,146,0,0,146,261,225
261,231,0,0,338,0,0,338,261,231
261,232,0,0,341,0,0,341,261,232
261,233,0,0,679,0,0,679,261,233
261,234,0,0,570,0,0,570,261,234
261,235,0,0,527,0,0,527,261,235
261,236,0,0,123,0,0,123,261,236
261,237,0,0,426,0,0,426,261,237
261,238,0,0,892,426,0,1318,261,238
261,242,426,0,0,0,0,426,261,242
261,253,0,0,26,0,0,26,261,253
261,254,0,0,292,0,0,292,261,254
261,255,0,0,464,0,0,464,261,255
261,257,1120,1008,1958,0,0,4086,261,257
261,258,3093,694,0,0,0,3787,261,258
261,259,0,622,840,0,0,1462,261,259
261,260,188,1923,292,0,0,2403,261,260
261,261,6282,9802,1478,2794,778,21134,261,261
261,262,1741,1922,572,504,0,4739,261,262
261,263,399,0,4015,366,0,4780,261,263
261,264,0,0,292,0,0,292,261,264
261,265,104,0,0,0,0,104,261,265
261,338,0,0,0,268,0,268,261,338
262,1,0,0,1069,0,0,1069,262,1
262,6,0,0,335,0,0,335,262,6
262,14,0,0,793,0,0,793,262,14
262,16,0,0,915,0,0,915,262,16
262,18,0,0,915,0,0,915,262,18
262,24,0,0,344,0,0,344,262,24
262,31,0,0,30,0,0,30,262,31
262,32,0,0,841,0,0,841,262,32
262,38,0,0,0,317,0,317,262,38
262,40,0,0,20,0,0,20,262,40
262,46,0,0,572,0,0,572,262,46
262,47,107,0,915,0,0,1022,262,47
262,53,0,0,841,0,0,841,262,53
262,54,661,0,1824,0,0,2485,262,54
262,79,0,0,0,841,0,841,262,79
262,81,0,0,331,0,0,331,262,81
262,97,0,0,841,0,0,841,262,97
262,106,0,0,360,0,0,360,262,106
262,132,841,0,0,0,0,841,262,132
262,133,0,0,915,0,0,915,262,133
262,159,0,0,331,0,0,331,262,159
262,166,0,0,983,0,0,983,262,166
262,167,0,0,572,0,0,572,262,167
262,169,0,0,1318,0,0,1318,262,169
262,192,0,0,362,0,0,362,262,192
262,193,0,0,344,0,0,344,262,193
262,208,370,0,1361,0,0,1731,262,208
262,210,0,0,915,0,0,915,262,210
262,211,0,0,2611,0,0,2611,262,211
262,212,2108,2737,0,661,0,5506,262,212
262,213,317,0,0,0,0,317,262,213
262,214,0,0,344,0,0,344,262,214
262,225,0,0,292,0,0,292,262,225
262,226,1397,0,0,0,0,1397,262,226
262,232,0,0,212,0,282,494,262,232
262,239,0,0,841,0,0,841,262,239
262,242,0,0,402,0,0,402,262,242
262,254,0,0,344,0,0,344,262,254
262,257,0,841,1043,0,0,1884,262,257
262,258,674,0,2046,0,0,2720,262,258
262,260,1299,1642,0,0,0,2941,262,260
262,261,2175,1756,572,1065,0,5568,262,261
262,262,4848,22242,0,6114,0,33204,262,262
262,263,841,1901,634,0,0,3376,262,263
262,264,0,1370,0,0,0,1370,262,264
262,265,5582,10046,2114,0,0,17742,262,265
262,267,523,0,572,0,222,1317,262,267
262,305,0,0,621,0,0,621,262,305
263,1,0,0,851,0,0,851,263,1
263,2,0,0,0,582,0,582,263,2
263,11,0,0,513,0,0,513,263,11
263,12,0,0,109,0,0,109,263,12
263,18,0,0,634,0,0,634,263,18
263,39,0,0,634,0,0,634,263,39
263,40,0,0,419,0,0,419,263,40
263,44,582,0,0,0,0,582,263,44
263,45,0,0,1206,0,0,1206,263,45
263,47,0,0,259,0,0,259,263,47
263,48,121,0,0,0,0,121,263,48
263,60,0,0,114,0,0,114,263,60
263,68,0,0,304,0,0,304,263,68
263,74,87,0,0,0,0,87,263,74
263,94,0,0,419,0,0,419,263,94
263,115,427,0,0,0,0,427,263,115
263,162,582,0,0,0,0,582,263,162
263,164,743,0,0,0,0,743,263,164
263,168,0,0,634,0,0,634,263,168
263,169,0,0,808,0,0,808,263,169
263,176,0,0,0,287,0,287,263,176
263,204,0,0,634,0,0,634,263,204
263,210,1525,0,1871,0,0,3396,263,210
263,211,1014,0,634,0,0,1648,263,211
263,215,0,0,312,0,0,312,263,215
263,219,482,0,312,0,0,794,263,219
263,221,0,0,634,0,0,634,263,221
263,229,0,0,1107,0,0,1107,263,229
263,231,0,186,367,303,0,856,263,231
263,232,0,0,406,466,0,872,263,232
263,234,684,0,433,261,0,1378,263,234
263,235,0,484,0,0,0,484,263,235
263,240,0,0,1267,0,0,1267,263,240
263,253,0,0,634,0,0,634,263,253
263,254,0,0,1257,0,0,1257,263,254
263,255,0,0,838,0,0,838,263,255
263,256,261,0,624,0,0,885,263,256
263,257,0,0,634,0,0,634,263,257
263,258,287,0,634,0,0,921,263,258
263,259,0,2023,0,2465,0,4488,263,259
263,260,458,582,941,0,0,1981,263,260
263,261,399,0,3542,366,0,4307,263,261
263,262,841,2266,634,0,0,3741,263,262
263,263,1720,40409,2075,2603,0,46807,263,263
263,264,4499,2123,1201,347,0,8170,263,264
263,265,0,303,1458,0,0,1761,263,265
263,266,0,0,634,276,0,910,263,266
263,267,612,0,952,0,0,1564,263,267
263,269,0,0,0,152,0,152,263,269
264,1,0,0,667,0,0,667,264,1
264,5,0,0,613,0,0,613,264,5
264,6,382,0,0,0,0,382,264,6
264,15,0,0,667,0,0,667,264,15
264,18,0,0,335,0,0,335,264,18
264,20,83,0,0,0,0,83,264,20
264,23,0,0,449,0,0,449,264,23
264,31,0,0,613,0,0,613,264,31
264,41,0,0,351,0,0,351,264,41
264,42,0,0,886,0,0,886,264,42
264,46,0,0,210,0,0,210,264,46
264,47,0,0,563,0,0,563,264,47
264,54,1036,0,683,0,0,1719,264,54
264,55,0,0,518,0,0,518,264,55
264,57,0,0,613,0,0,613,264,57
264,59,518,0,0,0,0,518,264,59
264,69,613,0,0,0,0,613,264,69
264,72,0,0,613,0,0,613,264,72
264,88,0,0,518,0,0,518,264,88
264,109,518,0,0,0,0,518,264,109
264,126,261,0,0,0,0,261,264,126
264,130,0,0,613,0,0,613,264,130
264,166,0,0,0,536,0,536,264,166
264,167,0,0,416,0,0,416,264,167
264,169,414,0,667,0,0,1081,264,169
264,170,0,0,563,0,0,563,264,170
264,174,0,0,300,0,0,300,264,174
264,191,518,0,0,0,0,518,264,191
264,200,109,0,0,0,0,109,264,200
264,209,0,0,563,0,0,563,264,209
264,210,899,0,563,391,0,1853,264,210
264,211,0,0,667,0,0,667,264,211
264,213,335,0,928,0,0,1263,264,213
264,221,473,0,0,0,0,473,264,221
264,223,0,0,0,536,0,536,264,223
264,225,0,0,146,0,0,146,264,225
264,227,0,0,673,0,0,673,264,227
264,228,0,0,495,0,0,495,264,228
264,229,365,0,1813,0,0,2178,264,229
264,231,0,0,598,0,0,598,264,231
264,232,0,0,923,731,0,1654,264,232
264,233,518,0,1877,0,894,3289,264,233
264,234,0,0,3290,0,382,3672,264,234
264,235,1540,553,3524,0,0,5617,264,235
264,236,0,0,416,0,0,416,264,236
264,239,0,0,378,0,0,378,264,239
264,254,518,0,563,0,0,1081,264,254
264,255,236,0,0,0,0,236,264,255
264,259,463,0,0,0,0,463,264,259
264,260,158,0,0,0,0,158,264,260
264,261,0,0,862,0,0,862,264,261
264,262,0,1370,0,0,0,1370,264,262
264,263,4499,2507,728,347,0,8081,264,263
264,264,4486,21990,5210,1388,0,33074,264,264
264,265,2174,6462,2426,0,0,11062,264,265
264,266,114,304,0,114,0,532,264,266
264,267,1559,1091,1424,0,0,4074,264,267
264,274,392,0,0,0,0,392,264,274
264,305,0,0,621,0,0,621,264,305
265,1,0,0,1082,343,0,1425,265,1
265,2,0,0,373,0,0,373,265,2
265,4,0,0,679,0,0,679,265,4
265,9,0,0,679,0,0,679,265,9
265,11,343,0,0,0,0,343,265,11
265,24,0,0,226,0,0,226,265,24
265,27,0,0,343,0,0,343,265,27
265,31,0,0,828,0,0,828,265,31
265,38,0,0,373,0,0,373,265,38
265,43,0,0,1219,0,0,1219,265,43
265,44,43,0,373,0,0,416,265,44
265,48,0,0,739,0,0,739,265,48
265,51,208,0,0,0,0,208,265,51
265,55,114,0,343,0,0,457,265,55
265,62,0,0,144,0,0,144,265,62
265,64,114,0,450,0,0,564,265,64
265,68,0,0,61,679,0,740,265,68
265,72,0,0,0,92,0,92,265,72
265,82,0,0,828,0,0,828,265,82
265,91,0,0,679,0,0,679,265,91
265,99,0,0,0,233,0,233,265,99
265,131,0,0,343,0,0,343,265,131
265,162,0,0,9,0,0,9,265,162
265,166,934,0,212,343,0,1489,265,166
265,168,238,0,373,0,0,611,265,168
265,169,0,0,743,0,0,743,265,169
265,191,0,0,445,0,0,445,265,191
265,208,0,0,507,0,0,507,265,208
265,209,0,0,507,0,0,507,265,209
265,210,0,0,0,591,0,591,265,210
265,211,589,0,0,0,0,589,265,211
265,212,343,0,573,0,0,916,265,212
265,213,1228,0,373,0,0,1601,265,213
265,214,124,0,0,0,0,124,265,214
265,219,0,0,374,0,0,374,265,219
265,221,46,0,0,0,0,46,265,221
265,222,0,0,1019,0,0,1019,265,222
265,223,0,0,298,0,0,298,265,223
265,229,0,0,373,0,0,373,265,229
265,230,625,0,0,0,0,625,265,230
265,232,484,0,408,0,0,892,265,232
265,233,0,0,0,578,0,578,265,233
265,234,0,0,1270,0,0,1270,265,234
265,235,484,0,972,0,0,1456,265,235
265,236,0,0,124,0,0,124,265,236
265,238,0,0,0,213,0,213,265,238
265,240,0,0,450,0,0,450,265,240
265,254,343,0,0,0,0,343,265,254
265,258,679,0,373,0,0,1052,265,258
265,259,0,0,354,0,0,354,265,259
265,261,104,0,473,0,0,577,265,261
265,262,5965,9055,2114,828,0,17962,265,262
265,263,0,303,1458,0,0,1761,265,263
265,264,2517,5684,2426,0,0,10627,265,264
265,265,5927,21027,373,2104,0,29431,265,265
265,266,0,1853,356,0,0,2209,265,266
265,267,343,0,166,400,0,909,265,267
265,316,0,0,72,0,0,72,265,316
266,2,0,0,124,0,0,124,266,2
266,6,0,0,217,0,0,217,266,6
266,18,180,0,82,0,0,262,266,18
266,21,0,0,90,0,0,90,266,21
266,25,0,0,162,0,0,162,266,25
266,59,0,0,75,0,0,75,266,59
266,74,114,0,0,0,0,114,266,74
266,91,0,0,119,0,0,119,266,91
266,100,180,0,0,0,0,180,266,100
266,102,0,0,49,0,0,49,266,102
266,138,114,0,0,0,0,114,266,138
266,156,292,0,0,0,0,292,266,156
266,161,0,0,196,0,0,196,266,161
266,166,0,0,0,327,0,327,266,166
266,167,327,0,0,0,0,327,266,167
266,168,0,0,320,0,0,320,266,168
266,170,0,0,124,0,0,124,266,170
266,171,158,0,0,0,0,158,266,171
266,194,0,0,0,274,0,274,266,194
266,195,75,0,0,0,0,75,266,195
266,204,0,0,0,678,0,678,266,204
266,207,0,0,48,0,0,48,266,207
266,210,814,0,0,0,0,814,266,210
266,211,180,0,0,0,0,180,266,211
266,213,0,327,356,0,0,683,266,213
266,214,0,0,135,0,0,135,266,214
266,219,217,0,0,0,0,217,266,219
266,221,327,0,0,0,0,327,266,221
266,222,294,0,154,198,0,646,266,222
266,223,75,0,0,0,0,75,266,223
266,224,327,0,0,0,0,327,266,224
266,229,0,0,82,0,0,82,266,229
266,232,0,0,212,0,0,212,266,232
266,233,0,0,697,0,0,697,266,233
266,234,0,0,287,0,0,287,266,234
266,254,240,0,0,0,0,240,266,254
266,263,0,0,634,276,0,910,266,263
266,264,114,304,0,114,0,532,266,264
266,265,0,1853,356,0,0,2209,266,265
266,266,655,5098,0,1477,0,7230,266,266
266,267,228,0,166,0,0,394,266,267
266,298,0,0,272,0,0,272,266,298
266,312,0,0,0,391,0,391,266,312
267,2,0,0,579,0,0,579,267,2
267,3,306,0,0,0,0,306,267,3
267,16,0,0,153,0,0,153,267,16
267,19,0,0,153,0,0,153,267,19
267,20,0,0,153,0,0,153,267,20
267,24,0,0,407,0,0,407,267,24
267,31,0,0,275,0,0,275,267,31
267,32,0,0,153,0,0,153,267,32
267,35,132,0,0,0,0,132,267,35
267,41,0,0,299,0,0,299,267,41
267,42,0,0,26,0,0,26,267,42
267,43,0,0,738,0,0,738,267,43
267,57,0,0,153,0,0,153,267,57
267,59,153,0,153,0,0,306,267,59
267,66,153,0,0,0,0,153,267,66
267,81,0,0,346,0,0,346,267,81
267,93,0,0,147,0,0,147,267,93
267,161,0,0,299,0,0,299,267,161
267,166,0,0,476,549,0,1025,267,166
267,167,153,0,0,0,0,153,267,167
267,169,306,0,406,0,0,712,267,169
267,199,0,0,501,0,0,501,267,199
267,205,592,0,0,0,0,592,267,205
267,209,370,0,166,0,0,536,267,209
267,210,0,0,166,0,0,166,267,210
267,213,318,0,0,0,0,318,267,213
267,215,423,0,275,0,0,698,267,215
267,218,318,0,0,0,0,318,267,218
267,221,1294,0,203,0,0,1497,267,221
267,223,540,0,0,0,0,540,267,223
267,225,0,0,41,0,0,41,267,225
267,229,0,0,795,0,0,795,267,229
267,230,306,0,0,0,0,306,267,230
267,231,0,0,257,0,0,257,267,231
267,232,0,0,755,0,0,755,267,232
267,233,927,2166,827,1206,0,5126,267,233
267,234,947,1595,166,0,0,2708,267,234
267,235,858,2173,445,0,0,3476,267,235
267,254,0,0,365,0,0,365,267,254
267,258,153,0,0,0,0,153,267,258
267,259,0,0,299,0,0,299,267,259
267,262,523,0,572,0,222,1317,267,262
267,263,460,0,1118,0,0,1578,267,263
267,264,1482,1244,915,0,0,3641,267,264
267,265,343,0,166,400,0,909,267,265
267,266,228,153,0,0,0,381,267,266
267,267,2758,11452,805,1585,0,16600,267,267
268,2,43,0,35,0,0,78,268,2
268,4,0,0,0,36,0,36,268,4
268,5,0,0,116,0,0,116,268,5
268,7,144,0,0,0,0,144,268,7
268,16,0,0,0,36,0,36,268,16
268,23,93,0,0,0,0,93,268,23
268,24,0,0,168,0,0,168,268,24
268,25,0,0,38,0,0,38,268,25
268,26,36,0,0,0,0,36,268,26
268,27,43,0,0,0,0,43,268,27
268,28,0,0,143,0,0,143,268,28
268,29,36,0,0,36,0,72,268,29
268,31,79,0,47,43,0,169,268,31
268,32,125,0,0,0,0,125,268,32
268,33,0,0,0,132,0,132,268,33
268,35,0,0,268,0,0,268,268,35
268,40,0,0,35,0,0,35,268,40
268,43,43,0,0,0,0,43,268,43
268,45,435,0,0,0,0,435,268,45
268,49,0,0,141,36,0,177,268,49
268,52,0,0,36,0,0,36,268,52
268,53,84,0,0,0,0,84,268,53
268,54,36,0,66,0,0,102,268,54
268,55,0,0,40,0,0,40,268,55
268,57,121,0,0,148,0,269,268,57
268,58,0,0,0,100,0,100,268,58
268,60,69,0,62,0,0,131,268,60
268,61,29,0,40,0,0,69,268,61
268,62,108,0,38,0,0,146,268,62
268,64,266,0,40,325,0,631,268,64
268,66,106,0,38,0,0,144,268,66
268,67,36,0,88,0,0,124,268,67
268,68,0,139,0,36,0,175,268,68
268,69,71,0,101,80,0,252,268,69
268,70,146,0,359,35,0,540,268,70
268,71,1212,264,0,341,134,1951,268,71
268,72,602,810,192,47,0,1651,268,72
268,73,109,79,276,73,53,590,268,73
268,74,0,0,86,0,0,86,268,74
268,76,38,0,161,0,0,199,268,76
268,77,316,0,38,0,0,354,268,77
268,78,0,0,40,0,0,40,268,78
268,79,144,0,0,0,0,144,268,79
268,80,71,0,0,0,0,71,268,80
268,81,129,0,0,0,0,129,268,81
268,82,73,0,47,132,191,443,268,82
268,83,36,0,0,0,0,36,268,83
268,84,0,0,87,0,0,87,268,84
268,95,155,0,0,0,0,155,268,95
268,96,36,0,0,0,0,36,268,96
268,97,0,0,168,0,0,168,268,97
268,102,56,0,0,0,0,56,268,102
268,125,420,0,0,0,0,420,268,125
268,137,35,0,0,0,0,35,268,137
268,141,0,0,300,0,0,300,268,141
268,165,338,0,0,0,0,338,268,165
268,197,35,0,0,0,0,35,268,197
268,239,128,0,0,0,0,128,268,239
268,241,53,0,0,0,0,53,268,241
268,251,200,0,0,0,0,200,268,251
268,268,522,3767,272,358,0,4919,268,268
268,269,1398,1208,503,420,0,3529,268,269
268,270,245,739,338,152,0,1474,268,270
268,271,36,43,0,36,0,115,268,271
268,272,322,302,103,0,0,727,268,272
268,273,108,36,0,94,0,238,268,273
268,274,587,0,0,0,0,587,268,274
268,275,132,0,0,0,0,132,268,275
268,277,109,0,673,0,67,849,268,277
268,278,0,0,453,0,0,453,268,278
268,279,0,0,996,0,0,996,268,279
268,280,303,143,0,0,0,446,268,280
268,281,795,0,0,159,0,954,268,281
268,282,36,0,190,0,0,226,268,282
268,283,0,0,0,126,0,126,268,283
268,286,0,0,90,0,0,90,268,286
268,288,35,0,0,0,0,35,268,288
268,289,82,0,446,0,0,528,268,289
268,296,0,0,16,0,0,16,268,296
268,298,0,0,0,551,0,551,268,298
268,300,883,188,210,36,225,1542,268,300
268,301,446,53,0,0,79,578,268,301
268,302,312,0,57,154,0,523,268,302
268,303,36,0,63,0,0,99,268,303
268,304,558,0,406,0,0,964,268,304
268,305,0,0,359,0,0,359,268,305
268,307,0,0,325,0,0,325,268,307
268,309,0,0,166,0,0,166,268,309
268,311,0,0,360,0,0,360,268,311
268,316,109,0,0,0,0,109,268,316
268,317,36,0,40,0,0,76,268,317
268,318,496,0,0,695,0,1191,268,318
268,319,157,0,0,0,0,157,268,319
268,320,0,0,233,98,0,331,268,320
268,321,36,0,0,0,0,36,268,321
268,322,0,0,0,242,0,242,268,322
268,324,36,0,892,0,0,928,268,324
268,325,0,0,279,0,0,279,268,325
268,327,204,0,0,0,0,204,268,327
268,336,504,0,0,0,0,504,268,336
268,337,0,0,57,0,0,57,268,337
268,339,79,0,45,0,0,124,268,339
268,340,27,0,0,0,0,27,268,340
269,2,0,0,130,0,0,130,269,2
269,3,139,0,0,0,0,139,269,3
269,5,0,0,151,0,0,151,269,5
269,7,277,0,0,0,0,277,269,7
269,18,184,0,0,0,0,184,269,18
269,22,0,0,73,0,0,73,269,22
269,23,0,0,300,0,0,300,269,23
269,25,0,0,214,0,0,214,269,25
269,27,0,0,106,0,0,106,269,27
269,28,0,0,0,26,0,26,269,28
269,29,120,0,258,0,0,378,269,29
269,31,139,0,106,0,0,245,269,31
269,34,59,0,0,0,0,59,269,34
269,43,63,0,0,0,0,63,269,43
269,49,0,0,92,0,0,92,269,49
269,53,0,0,238,0,0,238,269,53
269,54,26,0,28,0,0,54,269,54
269,56,0,0,0,379,0,379,269,56
269,57,236,0,0,0,0,236,269,57
269,58,0,0,109,0,0,109,269,58
269,59,168,0,0,0,0,168,269,59
269,60,323,0,0,0,0,323,269,60
269,61,415,0,0,0,0,415,269,61
269,62,26,0,130,0,0,156,269,62
269,63,0,0,214,0,0,214,269,63
269,64,638,0,0,215,0,853,269,64
269,65,1123,0,0,0,0,1123,269,65
269,66,186,145,0,0,0,331,269,66
269,67,48,0,111,0,0,159,269,67
269,68,448,0,347,0,0,795,269,68
269,69,172,0,0,80,0,252,269,69
269,70,663,0,0,0,0,663,269,70
269,71,955,321,0,0,284,1560,269,71
269,72,1703,308,0,35,0,2046,269,72
269,73,396,0,0,0,0,396,269,73
269,74,277,0,0,0,0,277,269,74
269,75,56,0,0,0,0,56,269,75
269,76,38,0,37,0,0,75,269,76
269,77,0,0,38,0,0,38,269,77
269,78,28,0,0,0,0,28,269,78
269,79,120,0,151,0,0,271,269,79
269,81,0,0,131,139,0,270,269,81
269,82,119,0,0,0,0,119,269,82
269,84,139,0,0,0,0,139,269,84
269,85,0,0,0,17,0,17,269,85
269,88,138,0,0,0,0,138,269,88
269,96,0,0,82,0,0,82,269,96
269,104,9,0,0,0,0,9,269,104
269,108,119,0,0,0,0,119,269,108
269,131,0,0,0,139,0,139,269,131
269,133,0,0,162,0,0,162,269,133
269,135,59,0,0,0,0,59,269,135
269,153,152,0,152,0,0,304,269,153
269,155,258,0,0,0,0,258,269,155
269,173,277,0,0,0,0,277,269,173
269,174,0,0,139,0,0,139,269,174
269,176,0,0,139,0,0,139,269,176
269,189,0,0,269,0,0,269,269,189
269,213,0,0,0,396,0,396,269,213
269,231,0,0,0,152,0,152,269,231
269,236,139,0,0,0,0,139,269,236
269,243,139,0,0,0,0,139,269,243
269,249,0,0,0,238,0,238,269,249
269,250,277,0,0,0,0,277,269,250
269,252,0,0,851,0,0,851,269,252
269,254,248,0,84,0,0,332,269,254
269,260,0,0,458,0,0,458,269,260
269,268,1271,1154,543,385,0,3353,269,268
269,269,4443,10733,648,295,402,16521,269,269
269,270,1234,2763,297,350,0,4644,269,270
269,271,139,139,0,0,0,278,269,271
269,272,0,38,258,436,0,732,269,272
269,276,0,0,1371,0,0,1371,269,276
269,277,145,0,335,500,0,980,269,277
269,278,0,0,703,0,0,703,269,278
269,279,0,0,553,0,0,553,269,279
269,280,0,0,258,0,0,258,269,280
269,282,201,0,0,0,0,201,269,282
269,283,91,0,0,0,0,91,269,283
269,286,0,0,0,139,0,139,269,286
269,287,0,0,412,0,0,412,269,287
269,289,410,0,0,0,0,410,269,289
269,293,0,0,0,128,0,128,269,293
269,294,0,0,1098,0,0,1098,269,294
269,295,0,0,895,0,0,895,269,295
269,298,0,0,272,0,0,272,269,298
269,300,1269,0,158,238,0,1665,269,300
269,301,106,0,86,0,0,192,269,301
269,302,377,0,947,0,0,1324,269,302
269,303,240,0,0,0,0,240,269,303
269,305,0,0,1060,0,0,1060,269,305
269,306,0,0,458,0,0,458,269,306
269,307,706,0,1419,0,0,2125,269,307
269,309,0,0,187,0,0,187,269,309
269,312,0,0,281,0,0,281,269,312
269,313,0,0,250,0,0,250,269,313
269,314,527,0,279,0,0,806,269,314
269,315,0,0,976,0,0,976,269,315
269,316,120,0,0,0,0,120,269,316
269,318,300,0,0,0,0,300,269,318
269,319,58,0,16,0,0,74,269,319
269,320,0,0,1303,0,0,1303,269,320
269,323,0,0,224,0,0,224,269,323
269,327,27,0,0,0,0,27,269,327
269,329,235,0,283,0,0,518,269,329
269,339,197,0,0,0,0,197,269,339
270,1,76,0,228,0,0,304,270,1
270,2,0,0,288,0,0,288,270,2
270,4,0,0,83,0,0,83,270,4
270,16,54,0,0,0,0,54,270,16
270,21,54,0,83,0,0,137,270,21
270,24,0,0,83,0,0,83,270,24
270,25,349,0,0,0,0,349,270,25
270,27,114,0,0,0,0,114,270,27
270,28,54,0,0,125,0,179,270,28
270,29,0,0,128,0,0,128,270,29
270,30,64,0,0,0,0,64,270,30
270,31,568,0,0,0,0,568,270,31
270,32,0,0,64,0,0,64,270,32
270,49,0,0,123,0,0,123,270,49
270,52,76,0,185,0,0,261,270,52
270,53,252,0,0,0,0,252,270,53
270,55,0,0,59,0,0,59,270,55
270,59,0,0,83,0,0,83,270,59
270,60,54,0,0,76,0,130,270,60
270,61,0,0,281,0,0,281,270,61
270,62,54,0,59,42,0,155,270,62
270,63,80,0,0,0,0,80,270,63
270,64,131,54,0,156,0,341,270,64
270,65,503,0,0,0,0,503,270,65
270,66,227,144,0,60,0,431,270,66
270,68,119,0,128,0,0,247,270,68
270,69,54,0,59,0,0,113,270,69
270,71,679,90,182,0,0,951,270,71
270,72,88,0,0,152,0,240,270,72
270,73,64,0,69,64,0,197,270,73
270,74,54,0,0,0,0,54,270,74
270,75,56,0,0,0,0,56,270,75
270,76,105,0,0,0,0,105,270,76
270,79,54,0,0,0,0,54,270,79
270,81,98,0,0,0,0,98,270,81
270,82,0,0,0,54,0,54,270,82
270,83,0,0,83,0,0,83,270,83
270,84,14,0,0,0,0,14,270,84
270,90,0,0,0,54,0,54,270,90
270,93,162,0,69,0,0,231,270,93
270,107,198,0,0,0,0,198,270,107
270,133,76,0,0,0,0,76,270,133
270,190,244,0,0,0,0,244,270,190
270,194,0,0,127,0,0,127,270,194
270,237,0,0,28,0,0,28,270,237
270,239,54,0,98,0,0,152,270,239
270,248,54,0,0,0,0,54,270,248
270,268,243,739,338,152,0,1472,270,268
270,269,1484,2706,146,274,0,4610,270,269
270,270,71,1376,0,0,0,1447,270,270
270,271,205,153,0,0,0,358,270,271
270,272,314,0,0,0,0,314,270,272
270,273,585,0,0,0,0,585,270,273
270,274,0,0,59,196,0,255,270,274
270,275,0,0,0,403,0,403,270,275
270,278,0,0,430,0,0,430,270,278
270,280,0,0,83,0,0,83,270,280
270,281,54,0,577,0,0,631,270,281
270,282,54,0,0,0,0,54,270,282
270,285,0,0,0,490,0,490,270,285
270,286,29,0,0,0,0,29,270,286
270,289,88,0,0,0,0,88,270,289
270,291,574,0,0,0,0,574,270,291
270,292,184,0,0,0,0,184,270,292
270,294,0,0,589,0,0,589,270,294
270,300,443,0,587,0,0,1030,270,300
270,301,73,0,0,0,0,73,270,301
270,302,373,0,69,0,0,442,270,302
270,303,54,0,98,0,0,152,270,303
270,304,0,0,0,54,0,54,270,304
270,305,54,0,220,0,0,274,270,305
270,312,517,0,0,0,0,517,270,312
270,314,0,0,586,0,0,586,270,314
270,315,0,0,0,348,0,348,270,315
270,318,108,0,0,0,0,108,270,318
270,319,17,0,0,0,0,17,270,319
270,323,584,0,0,0,0,584,270,323
270,327,54,0,0,0,0,54,270,327
270,329,54,0,0,0,0,54,270,329
270,334,54,0,0,0,0,54,270,334
270,338,122,0,0,0,0,122,270,338
270,340,108,0,0,0,0,108,270,340
271,14,0,0,0,36,0,36,271,14
271,18,124,0,231,0,0,355,271,18
271,19,128,0,0,0,0,128,271,19
271,26,0,0,156,0,0,156,271,26
271,27,60,0,0,0,0,60,271,27
271,36,131,0,0,0,0,131,271,36
271,39,124,0,0,0,0,124,271,39
271,40,0,0,20,0,0,20,271,40
271,45,618,0,261,0,0,879,271,45
271,54,0,0,0,37,0,37,271,54
271,56,0,0,0,148,0,148,271,56
271,59,0,0,0,51,0,51,271,59
271,64,0,0,131,120,0,251,271,64
271,65,231,0,0,109,0,340,271,65
271,66,48,0,38,0,0,86,271,66
271,68,0,0,0,243,0,243,271,68
271,72,0,0,321,0,0,321,271,72
271,79,0,0,25,0,0,25,271,79
271,80,132,0,0,0,0,132,271,80
271,81,0,0,0,43,0,43,271,81
271,82,70,0,0,0,0,70,271,82
271,83,0,0,0,69,0,69,271,83
271,85,0,0,0,47,0,47,271,85
271,88,138,0,153,0,0,291,271,88
271,89,0,0,0,207,0,207,271,89
271,90,0,0,0,62,0,62,271,90
271,113,0,0,0,94,0,94,271,113
271,116,292,0,0,0,0,292,271,116
271,131,0,0,8,0,0,8,271,131
271,135,565,0,0,0,0,565,271,135
271,136,87,0,0,0,0,87,271,136
271,142,338,0,0,0,0,338,271,142
271,144,0,0,1021,0,0,1021,271,144
271,154,601,0,0,0,0,601,271,154
271,182,403,0,0,0,0,403,271,182
271,195,0,0,0,317,0,317,271,195
271,218,0,0,0,639,0,639,271,218
271,219,139,0,773,0,0,912,271,219
271,223,0,0,0,274,0,274,271,223
271,226,0,0,521,0,0,521,271,226
271,236,0,0,225,112,0,337,271,236
271,268,196,43,0,36,0,275,271,268
271,269,0,139,0,0,0,139,271,269
271,270,128,153,0,0,0,281,271,270
271,271,0,295,0,0,0,295,271,271
271,272,271,673,0,77,0,1021,271,272
271,273,640,0,0,0,0,640,271,273
271,274,0,0,160,0,0,160,271,274
271,279,0,0,430,0,0,430,271,279
271,283,0,0,74,49,0,123,271,283
271,297,0,0,34,0,0,34,271,297
271,298,0,0,700,0,0,700,271,298
271,300,119,0,0,0,0,119,271,300
271,301,158,0,0,0,0,158,271,301
271,302,145,0,0,85,0,230,271,302
271,303,79,0,0,0,0,79,271,303
271,304,558,0,0,0,0,558,271,304
271,305,202,0,220,0,0,422,271,305
271,307,0,0,325,0,0,325,271,307
271,309,153,0,166,0,0,319,271,309
271,312,155,0,279,0,0,434,271,312
271,315,321,0,0,0,0,321,271,315
271,316,72,0,0,0,0,72,271,316
271,322,77,0,0,121,0,198,271,322
271,330,0,0,0,215,0,215,271,330
272,1,75,0,83,0,0,158,272,1
272,2,0,0,148,0,0,148,272,2
272,18,136,0,0,0,0,136,272,18
272,21,0,0,42,0,0,42,272,21
272,23,0,0,154,0,0,154,272,23
272,30,0,0,55,0,0,55,272,30
272,34,136,0,0,0,0,136,272,34
272,35,38,0,0,0,0,38,272,35
272,36,0,0,37,0,0,37,272,36
272,37,0,0,37,0,0,37,272,37
272,43,90,0,0,0,0,90,272,43
272,49,48,0,0,0,0,48,272,49
272,50,136,0,0,0,0,136,272,50
272,53,0,0,136,136,0,272,272,53
272,55,704,0,1336,0,0,2040,272,55
272,57,38,0,0,0,0,38,272,57
272,59,293,0,148,0,114,555,272,59
272,60,0,0,356,0,0,356,272,60
272,61,38,0,200,0,0,238,272,61
272,62,115,0,29,38,0,182,272,62
272,63,136,0,0,0,0,136,272,63
272,64,120,0,83,136,0,339,272,64
272,65,371,0,0,0,0,371,272,65
272,66,77,0,0,0,0,77,272,66
272,68,136,0,0,0,0,136,272,68
272,69,38,0,0,130,0,168,272,69
272,71,1993,0,0,0,0,1993,272,71
272,72,136,0,0,0,0,136,272,72
272,73,0,0,42,0,0,42,272,73
272,74,174,0,0,0,0,174,272,74
272,77,0,0,40,0,0,40,272,77
272,78,0,0,136,0,0,136,272,78
272,79,149,0,80,304,0,533,272,79
272,81,0,0,0,56,0,56,272,81
272,82,38,0,42,0,0,80,272,82
272,90,136,0,0,0,0,136,272,90
272,100,136,0,0,0,0,136,272,100
272,102,136,0,0,0,0,136,272,102
272,131,0,0,12,0,0,12,272,131
272,135,0,0,0,38,0,38,272,135
272,167,55,0,0,0,0,55,272,167
272,169,0,0,136,0,0,136,272,169
272,174,0,0,372,0,0,372,272,174
272,180,514,0,0,0,0,514,272,180
272,203,0,0,190,0,0,190,272,203
272,220,0,0,296,0,0,296,272,220
272,240,0,0,109,0,0,109,272,240
272,268,358,302,103,0,0,763,272,268
272,269,0,38,218,436,0,692,272,269
272,270,352,0,0,0,0,352,272,270
272,271,429,516,0,115,0,1060,272,271
272,272,2085,4011,0,1335,0,7431,272,272
272,273,2439,2203,0,418,0,5060,272,273
272,274,574,1081,0,478,0,2133,272,274
272,275,136,184,381,0,0,701,272,275
272,277,940,0,1020,0,0,1960,272,277
272,278,433,0,273,0,0,706,272,278
272,281,1294,0,0,0,0,1294,272,281
272,283,49,0,0,0,0,49,272,283
272,287,240,0,148,0,0,388,272,287
272,289,410,0,446,0,0,856,272,289
272,291,0,0,270,0,0,270,272,291
272,298,0,0,581,0,0,581,272,298
272,300,112,0,40,400,0,552,272,300
272,301,304,0,40,0,0,344,272,301
272,303,38,0,148,38,0,224,272,303
272,304,130,0,0,0,0,130,272,304
272,305,570,0,0,0,0,570,272,305
272,309,153,0,0,0,0,153,272,309
272,312,136,0,0,0,0,136,272,312
272,315,0,0,218,0,0,218,272,315
272,319,0,0,197,0,0,197,272,319
272,327,27,0,0,0,0,27,272,327
272,329,38,0,0,0,0,38,272,329
272,338,38,0,0,0,0,38,272,338
273,7,0,0,287,0,0,287,273,7
273,19,292,0,0,0,0,292,273,19
273,20,76,0,0,0,0,76,273,20
273,21,0,0,0,704,0,704,273,21
273,24,0,0,431,0,0,431,273,24
273,26,0,0,129,0,0,129,273,26
273,28,0,0,436,0,0,436,273,28
273,29,0,0,87,287,0,374,273,29
273,36,0,0,640,0,0,640,273,36
273,39,0,0,276,0,0,276,273,39
273,45,428,0,0,0,0,428,273,45
273,53,292,0,0,0,0,292,273,53
273,54,0,0,1034,0,0,1034,273,54
273,58,100,0,640,0,0,740,273,58
273,59,0,0,766,0,0,766,273,59
273,61,436,0,0,0,0,436,273,61
273,62,27,0,1397,0,0,1424,273,62
273,63,857,0,0,0,0,857,273,63
273,64,1014,0,0,613,0,1627,273,64
273,66,3868,0,0,0,0,3868,273,66
273,68,436,0,0,0,0,436,273,68
273,69,292,0,1006,0,0,1298,273,69
273,70,0,0,696,0,0,696,273,70
273,72,237,0,0,0,0,237,273,72
273,73,436,0,300,0,0,736,273,73
273,79,488,0,0,0,0,488,273,79
273,80,436,0,0,0,0,436,273,80
273,81,977,0,56,0,0,1033,273,81
273,87,0,0,276,0,0,276,273,87
273,92,436,0,0,0,0,436,273,92
273,98,436,0,0,0,0,436,273,98
273,108,0,0,27,0,0,27,273,108
273,111,109,0,0,0,0,109,273,111
273,119,0,0,977,0,0,977,273,119
273,137,0,0,673,0,0,673,273,137
273,138,65,0,0,0,0,65,273,138
273,147,119,0,0,0,0,119,273,147
273,203,0,0,190,0,0,190,273,203
273,210,292,0,568,0,0,860,273,210
273,217,0,0,310,0,0,310,273,217
273,234,0,0,264,0,0,264,273,234
273,237,0,0,766,0,0,766,273,237
273,248,0,0,0,1408,0,1408,273,248
273,268,387,36,0,94,0,517,273,268
273,270,292,0,0,0,0,292,273,270
273,271,640,0,0,0,0,640,273,271
273,272,3856,2203,0,111,0,6170,273,272
273,273,7959,21166,4653,2999,0,36777,273,273
273,274,403,4569,475,936,0,6383,273,274
273,275,0,0,5001,0,0,5001,273,275
273,276,6113,4818,1185,1564,0,13680,273,276
273,277,3710,886,0,0,0,4596,273,277
273,278,1137,0,677,0,0,1814,273,278
273,279,0,0,326,0,0,326,273,279
273,280,165,0,300,0,0,465,273,280
273,281,430,0,696,0,0,1126,273,281
273,282,0,0,318,0,0,318,273,282
273,284,353,0,688,0,0,1041,273,284
273,287,292,0,0,0,0,292,273,287
273,289,0,0,332,0,0,332,273,289
273,291,0,0,854,0,0,854,273,291
273,292,0,0,1203,0,0,1203,273,292
273,293,0,0,398,0,0,398,273,293
273,295,0,0,469,0,0,469,273,295
273,300,292,0,740,0,0,1032,273,300
273,301,454,0,0,0,0,454,273,301
273,302,1301,0,0,0,0,1301,273,302
273,303,436,0,0,0,0,436,273,303
273,305,0,0,359,0,0,359,273,305
273,307,0,0,768,0,0,768,273,307
273,315,0,0,365,0,0,365,273,315
273,316,72,0,0,0,0,72,273,316
273,322,77,0,0,0,0,77,273,322
273,324,0,0,502,0,0,502,273,324
273,337,81,0,0,0,0,81,273,337
274,1,0,0,196,0,0,196,274,1
274,2,0,0,849,0,0,849,274,2
274,5,196,0,0,0,0,196,274,5
274,6,0,0,419,0,0,419,274,6
274,9,208,0,414,0,0,622,274,9
274,19,0,0,128,0,0,128,274,19
274,21,0,0,0,230,0,230,274,21
274,22,0,0,263,0,0,263,274,22
274,23,527,0,1518,0,0,2045,274,23
274,26,0,0,159,0,0,159,274,26
274,27,135,0,309,0,0,444,274,27
274,28,0,0,98,0,0,98,274,28
274,29,0,0,356,0,0,356,274,29
274,30,0,0,58,0,0,58,274,30
274,31,196,0,159,0,0,355,274,31
274,32,0,0,21,0,0,21,274,32
274,36,131,0,0,0,0,131,274,36
274,37,0,0,18,0,0,18,274,37
274,39,94,0,47,0,0,141,274,39
274,40,0,0,0,27,0,27,274,40
274,44,152,0,0,0,0,152,274,44
274,45,78,0,0,0,0,78,274,45
274,49,0,0,814,0,0,814,274,49
274,52,0,0,94,0,0,94,274,52
274,53,0,0,208,0,0,208,274,53
274,54,1056,0,553,0,0,1609,274,54
274,55,196,0,0,102,0,298,274,55
274,56,0,0,437,0,0,437,274,56
274,57,196,0,0,0,0,196,274,57
274,59,25,0,833,0,0,858,274,59
274,60,515,0,0,0,0,515,274,60
274,62,0,0,506,0,0,506,274,62
274,63,641,0,0,0,0,641,274,63
274,64,485,0,120,154,0,759,274,64
274,65,353,0,0,116,0,469,274,65
274,66,58,0,213,0,0,271,274,66
274,68,0,0,1112,196,0,1308,274,68
274,72,0,0,546,0,0,546,274,72
274,73,0,0,332,0,0,332,274,73
274,74,0,0,49,0,0,49,274,74
274,75,35,0,0,0,0,35,274,75
274,76,0,0,115,0,0,115,274,76
274,77,0,0,159,0,0,159,274,77
274,79,0,0,259,0,0,259,274,79
274,80,0,0,222,0,0,222,274,80
274,81,103,0,0,0,0,103,274,81
274,82,0,0,42,0,0,42,274,82
274,84,0,0,47,0,0,47,274,84
274,87,33,0,33,0,0,66,274,87
274,88,101,0,138,0,0,239,274,88
274,91,0,0,159,0,0,159,274,91
274,96,67,0,0,0,0,67,274,96
274,97,196,0,0,0,0,196,274,97
274,98,0,0,7,0,0,7,274,98
274,105,50,0,0,0,0,50,274,105
274,110,0,0,439,0,0,439,274,110
274,117,0,0,309,0,0,309,274,117
274,122,0,0,751,0,0,751,274,122
274,128,0,0,0,10,0,10,274,128
274,133,229,0,159,0,0,388,274,133
274,165,0,0,546,0,0,546,274,165
274,167,0,0,284,0,0,284,274,167
274,192,0,0,294,0,0,294,274,192
274,195,0,0,214,0,0,214,274,195
274,200,0,0,109,0,0,109,274,200
274,208,0,0,513,0,0,513,274,208
274,209,0,0,174,0,0,174,274,209
274,215,0,0,714,0,0,714,274,215
274,223,0,0,312,0,0,312,274,223
274,234,0,0,264,0,0,264,274,234
274,238,0,0,309,135,0,444,274,238
274,239,250,0,0,0,0,250,274,239
274,240,0,0,502,0,0,502,274,240
274,241,0,0,276,0,0,276,274,241
274,247,894,0,1100,1158,0,3152,274,247
274,249,2130,0,661,0,0,2791,274,249
274,250,267,0,1026,0,0,1293,274,250
274,252,252,0,0,0,0,252,274,252
274,268,392,0,0,0,0,392,274,268
274,269,0,0,0,0,284,284,274,269
274,270,0,0,59,0,0,59,274,270
274,271,618,0,160,0,0,778,274,271
274,272,367,403,0,686,0,1456,274,272
274,273,403,4569,475,475,0,5922,274,273
274,274,11038,22588,0,1007,0,34633,274,274
274,275,6591,10781,1014,307,0,18693,274,275
274,276,3948,4064,7184,678,0,15874,274,276
274,277,274,0,175,0,0,449,274,277
274,278,1032,0,1843,0,0,2875,274,278
274,279,0,0,1099,0,0,1099,274,279
274,280,258,0,560,0,0,818,274,280
274,281,318,0,0,0,0,318,274,281
274,282,0,0,213,0,0,213,274,282
274,283,0,0,99,0,0,99,274,283
274,284,514,0,384,0,0,898,274,284
274,285,405,0,1066,0,0,1471,274,285
274,288,317,0,0,0,0,317,274,288
274,297,0,0,25,0,0,25,274,297
274,300,625,0,1392,0,0,2017,274,300
274,301,0,0,296,0,0,296,274,301
274,302,85,0,85,0,0,170,274,302
274,303,0,0,0,185,0,185,274,303
274,305,0,0,159,0,0,159,274,305
274,307,0,0,173,0,0,173,274,307
274,309,0,0,784,0,0,784,274,309
274,316,41,0,0,0,0,41,274,316
274,317,0,0,15,0,0,15,274,317
274,318,568,0,0,0,0,568,274,318
274,319,17,0,0,0,0,17,274,319
274,320,314,0,0,0,0,314,274,320
274,326,0,0,707,0,0,707,274,326
274,327,27,0,0,0,0,27,274,327
274,333,248,0,0,0,0,248,274,333
274,334,0,0,196,0,0,196,274,334
274,335,0,0,283,0,0,283,274,335
274,336,0,0,211,0,0,211,274,336
274,342,373,0,0,0,0,373,274,342
275,1,0,0,274,0,0,274,275,1
275,2,0,0,169,0,0,169,275,2
275,3,0,0,98,0,0,98,275,3
275,5,0,0,595,0,0,595,275,5
275,6,0,0,274,0,0,274,275,6
275,7,0,0,967,0,0,967,275,7
275,8,83,0,0,0,0,83,275,8
275,16,0,0,129,0,0,129,275,16
275,18,0,0,196,0,0,196,275,18
275,19,0,0,577,0,0,577,275,19
275,20,0,0,281,0,0,281,275,20
275,21,0,0,0,274,0,274,275,21
275,22,0,0,67,0,0,67,275,22
275,23,0,0,274,0,0,274,275,23
275,26,967,0,0,0,0,967,275,26
275,27,91,0,458,0,0,549,275,27
275,30,0,0,53,0,0,53,275,30
275,32,21,0,0,0,0,21,275,32
275,36,0,0,131,0,0,131,275,36
275,37,0,0,274,0,0,274,275,37
275,43,0,0,337,0,0,337,275,43
275,44,549,0,0,0,0,549,275,44
275,47,106,0,0,0,0,106,275,47
275,49,122,0,76,0,0,198,275,49
275,50,0,0,98,0,0,98,275,50
275,53,0,0,169,0,0,169,275,53
275,54,14,0,458,0,0,472,275,54
275,55,168,0,0,0,0,168,275,55
275,56,0,0,148,0,0,148,275,56
275,57,155,0,0,0,0,155,275,57
275,58,0,0,313,229,0,542,275,58
275,59,0,0,3536,0,0,3536,275,59
275,60,1040,0,1135,0,0,2175,275,60
275,61,0,0,349,0,0,349,275,61
275,62,0,0,133,0,0,133,275,62
275,63,349,0,0,0,0,349,275,63
275,64,394,0,573,0,0,967,275,64
275,66,549,0,0,0,0,549,275,66
275,68,0,0,0,377,0,377,275,68
275,71,193,0,0,0,0,193,275,71
275,73,549,0,0,0,0,549,275,73
275,76,122,0,0,0,0,122,275,76
275,77,0,0,414,0,0,414,275,77
275,79,0,0,159,0,0,159,275,79
275,80,0,0,274,0,0,274,275,80
275,84,51,0,51,0,0,102,275,84
275,92,0,0,274,0,0,274,275,92
275,94,377,0,35,0,0,412,275,94
275,95,0,0,135,0,0,135,275,95
275,104,0,0,377,0,0,377,275,104
275,108,0,0,274,0,0,274,275,108
275,117,0,0,274,0,0,274,275,117
275,123,0,0,594,0,0,594,275,123
275,126,0,0,72,0,0,72,275,126
275,130,0,0,30,0,0,30,275,130
275,144,274,0,0,0,0,274,275,144
275,151,0,0,1476,0,0,1476,275,151
275,154,0,0,0,967,0,967,275,154
275,164,396,0,0,0,0,396,275,164
275,166,0,0,274,0,0,274,275,166
275,169,0,0,334,0,0,334,275,169
275,172,0,0,258,121,0,379,275,172
275,187,0,0,342,0,0,342,275,187
275,206,0,0,159,0,0,159,275,206
275,222,0,0,252,0,0,252,275,222
275,237,0,0,26,0,0,26,275,237
275,238,274,0,1619,0,0,1893,275,238
275,239,0,0,880,0,0,880,275,239
275,246,223,0,0,0,0,223,275,246
275,247,1078,0,0,1200,0,2278,275,247
275,249,114,0,0,0,0,114,275,249
275,250,1464,0,453,0,0,1917,275,250
275,253,0,0,149,0,0,149,275,253
275,268,132,0,0,0,0,132,275,268
275,270,525,0,0,0,0,525,275,270
275,271,102,0,0,0,0,102,275,271
275,272,136,184,381,0,0,701,275,272
275,273,0,0,5001,0,0,5001,275,273
275,274,5334,10242,1159,307,0,17042,275,274
275,275,8628,24766,1094,1844,0,36332,275,275
275,276,727,527,2537,406,0,4197,275,276
275,277,289,0,673,0,0,962,275,277
275,278,0,0,946,348,0,1294,275,278
275,279,0,0,720,599,0,1319,275,279
275,281,274,0,0,0,0,274,275,281
275,285,0,0,533,0,0,533,275,285
275,287,0,0,574,0,0,574,275,287
275,289,0,0,446,0,0,446,275,289
275,291,785,0,0,0,0,785,275,291
275,292,233,0,0,0,0,233,275,292
275,300,823,0,0,0,0,823,275,300
275,302,274,0,70,0,0,344,275,302
275,307,0,0,325,0,0,325,275,307
275,313,0,0,421,0,0,421,275,313
275,315,0,0,1147,0,0,1147,275,315
275,316,0,0,72,0,0,72,275,316
275,317,14,0,0,0,0,14,275,317
275,318,439,0,0,0,0,439,275,318
275,319,967,0,0,0,0,967,275,319
275,321,152,0,0,0,0,152,275,321
275,330,0,0,290,0,0,290,275,330
275,332,218,0,0,0,0,218,275,332
275,339,0,0,377,0,0,377,275,339
276,2,0,0,627,0,0,627,276,2
276,3,0,0,462,0,0,462,276,3
276,5,0,0,797,0,0,797,276,5
276,7,0,0,849,0,0,849,276,7
276,9,0,0,601,0,0,601,276,9
276,12,0,0,569,0,0,569,276,12
276,19,0,0,850,0,0,850,276,19
276,21,0,0,0,72,0,72,276,21
276,24,0,0,482,0,0,482,276,24
276,26,0,0,627,0,0,627,276,26
276,27,0,0,571,0,0,571,276,27
276,28,0,0,849,0,0,849,276,28
276,31,0,0,699,0,0,699,276,31
276,35,0,0,601,0,0,601,276,35
276,42,0,0,849,0,0,849,276,42
276,49,601,0,74,0,0,675,276,49
276,51,0,0,601,0,0,601,276,51
276,52,0,0,1418,0,0,1418,276,52
276,53,0,0,0,601,0,601,276,53
276,54,1033,0,2335,0,0,3368,276,54
276,56,0,0,627,0,0,627,276,56
276,57,0,0,627,0,0,627,276,57
276,58,0,0,389,0,0,389,276,58
276,59,627,0,1225,0,0,1852,276,59
276,60,1568,0,1174,569,0,3311,276,60
276,61,502,0,0,195,0,697,276,61
276,62,0,0,654,0,0,654,276,62
276,65,0,0,118,601,0,719,276,65
276,66,0,0,0,990,0,990,276,66
276,68,0,0,923,0,0,923,276,68
276,69,0,0,0,195,0,195,276,69
276,71,0,0,874,0,0,874,276,71
276,72,176,0,647,0,0,823,276,72
276,73,0,0,963,0,0,963,276,73
276,74,0,0,276,0,0,276,276,74
276,76,0,0,601,0,0,601,276,76
276,79,601,0,804,0,0,1405,276,79
276,82,0,0,33,0,0,33,276,82
276,87,0,0,627,0,0,627,276,87
276,88,101,0,0,0,0,101,276,88
276,98,0,0,437,0,0,437,276,98
276,133,0,0,0,162,0,162,276,133
276,136,0,0,601,0,0,601,276,136
276,173,393,0,0,0,0,393,276,173
276,196,0,0,338,0,0,338,276,196
276,239,627,0,849,0,0,1476,276,239
276,242,569,0,0,0,0,569,276,242
276,243,627,0,0,0,0,627,276,243
276,244,0,0,1063,0,0,1063,276,244
276,249,0,0,462,0,0,462,276,249
276,250,0,0,571,0,0,571,276,250
276,251,601,0,0,0,0,601,276,251
276,253,0,0,601,0,0,601,276,253
276,258,0,0,654,0,0,654,276,258
276,269,0,0,869,0,0,869,276,269
276,272,0,0,885,0,0,885,276,272
276,273,6113,5224,1185,1158,0,13680,276,273
276,274,3734,4064,4919,678,0,13395,276,274
276,275,1198,527,1662,406,0,3793,276,275
276,276,22613,24380,1665,1515,0,50173,276,276
276,277,1387,2688,0,1085,0,5160,276,277
276,278,3167,6139,1643,1770,0,12719,276,278
276,279,0,0,0,405,0,405,276,279
276,282,601,0,0,0,0,601,276,282
276,285,0,0,1395,0,0,1395,276,285
276,287,601,0,0,0,0,601,276,287
276,291,1987,0,0,0,0,1987,276,291
276,300,0,0,923,0,0,923,276,300
276,301,0,0,654,0,0,654,276,301
276,302,0,0,1309,0,0,1309,276,302
276,303,885,0,0,0,0,885,276,303
276,309,0,0,493,0,0,493,276,309
276,318,0,0,0,731,0,731,276,318
276,330,601,0,0,0,0,601,276,330
276,341,33,0,0,0,0,33,276,341
277,1,0,0,276,0,0,276,277,1
277,24,244,0,0,0,0,244,277,24
277,28,0,0,673,0,0,673,277,28
277,29,0,0,642,0,0,642,277,29
277,31,0,0,642,0,0,642,277,31
277,40,488,0,0,0,0,488,277,40
277,42,0,0,168,0,0,168,277,42
277,52,679,0,0,0,0,679,277,52
277,53,0,0,642,0,0,642,277,53
277,54,627,0,0,0,0,627,277,54
277,56,0,0,253,0,0,253,277,56
277,57,0,0,276,0,0,276,277,57
277,58,155,0,0,0,0,155,277,58
277,59,244,0,0,0,0,244,277,59
277,60,0,0,102,0,0,102,277,60
277,63,155,0,0,0,0,155,277,63
277,64,308,0,0,0,0,308,277,64
277,68,0,0,249,0,0,249,277,68
277,70,0,0,0,181,0,181,277,70
277,71,0,0,168,0,0,168,277,71
277,72,1072,0,732,0,0,1804,277,72
277,76,0,0,266,0,0,266,277,76
277,77,244,0,244,0,0,488,277,77
277,78,0,0,698,0,0,698,277,78
277,83,619,0,0,0,0,619,277,83
277,100,0,0,282,0,0,282,277,100
277,125,161,0,0,0,0,161,277,125
277,237,26,0,0,0,0,26,277,237
277,238,0,0,619,0,0,619,277,238
277,247,894,0,0,0,0,894,277,247
277,250,108,0,254,0,0,362,277,250
277,252,1072,0,0,0,0,1072,277,252
277,268,109,0,673,0,67,849,277,268
277,269,145,0,335,500,0,980,277,269
277,272,940,0,1020,0,0,1960,277,272
277,273,3710,886,0,0,0,4596,277,273
277,274,289,0,175,0,0,464,277,274
277,275,274,0,673,0,0,947,277,275
277,276,1387,2688,0,1085,0,5160,277,276
277,277,14691,21217,2743,1013,0,39664,277,277
277,278,1309,11713,2970,2123,0,18115,277,278
277,279,0,1692,2664,1544,0,5900,277,279
277,280,0,0,266,0,0,266,277,280
277,281,4145,1965,168,319,0,6597,277,281
277,282,1946,2936,554,0,0,5436,277,282
277,284,0,0,1150,0,0,1150,277,284
277,285,395,0,0,0,0,395,277,285
277,286,0,0,207,0,0,207,277,286
277,287,223,0,0,0,0,223,277,287
277,289,0,0,1150,0,0,1150,277,289
277,293,0,0,0,657,0,657,277,293
277,294,0,0,873,0,0,873,277,294
277,295,0,0,604,0,0,604,277,295
277,296,0,0,16,0,0,16,277,296
277,300,244,0,989,0,0,1233,277,300
277,301,260,0,0,244,0,504,277,301
277,302,527,0,1164,0,0,1691,277,302
277,303,0,0,29,0,0,29,277,303
277,305,0,0,276,0,0,276,277,305
277,306,0,0,527,0,0,527,277,306
277,307,0,0,773,0,0,773,277,307
277,309,0,0,465,0,0,465,277,309
277,311,3651,0,0,0,0,3651,277,311
277,312,642,0,0,0,0,642,277,312
277,313,0,0,108,0,0,108,277,313
277,318,158,0,0,0,0,158,277,318
277,320,0,0,207,0,0,207,277,320
277,329,51,0,0,0,0,51,277,329
278,2,0,0,546,0,0,546,278,2
278,3,0,0,825,0,0,825,278,3
278,5,251,0,288,0,0,539,278,5
278,6,0,0,430,0,0,430,278,6
278,13,0,0,265,0,0,265,278,13
278,14,0,0,395,395,0,790,278,14
278,19,0,0,0,265,0,265,278,19
278,22,77,0,0,0,0,77,278,22
278,23,0,0,846,0,0,846,278,23
278,24,0,0,453,0,0,453,278,24
278,27,0,0,488,0,0,488,278,27
278,28,0,0,848,0,0,848,278,28
278,29,0,0,694,0,0,694,278,29
278,32,26,0,0,0,0,26,278,32
278,49,0,0,416,0,0,416,278,49
278,53,395,0,390,0,0,785,278,53
278,54,251,0,172,0,0,423,278,54
278,56,0,0,1207,0,0,1207,278,56
278,57,0,0,251,0,0,251,278,57
278,58,395,0,1015,0,0,1410,278,58
278,59,215,0,781,251,0,1247,278,59
278,60,0,0,0,228,0,228,278,60
278,61,251,0,1132,0,0,1383,278,61
278,62,0,0,1072,0,0,1072,278,62
278,63,11,0,405,0,0,416,278,63
278,64,0,0,703,0,0,703,278,64
278,65,0,0,726,0,0,726,278,65
278,66,58,0,1091,0,0,1149,278,66
278,67,0,0,430,0,0,430,278,67
278,68,0,0,1156,0,0,1156,278,68
278,69,0,0,663,0,0,663,278,69
278,70,0,0,288,0,0,288,278,70
278,72,632,0,273,0,0,905,278,72
278,73,0,0,657,0,0,657,278,73
278,74,0,0,228,0,0,228,278,74
278,75,274,0,395,0,0,669,278,75
278,77,0,0,395,0,0,395,278,77
278,79,0,0,790,0,0,790,278,79
278,80,0,0,172,0,0,172,278,80
278,81,0,0,416,0,0,416,278,81
278,82,251,0,793,0,0,1044,278,82
278,88,0,0,288,0,0,288,278,88
278,94,35,0,395,0,0,430,278,94
278,105,0,0,265,0,0,265,278,105
278,110,0,0,401,0,0,401,278,110
278,133,0,0,416,0,0,416,278,133
278,138,0,0,453,0,0,453,278,138
278,156,0,0,348,0,0,348,278,156
278,162,251,0,430,0,0,681,278,162
278,166,0,0,395,0,0,395,278,166
278,171,0,0,395,0,0,395,278,171
278,175,312,0,0,0,0,312,278,175
278,198,0,0,251,0,0,251,278,198
278,239,0,0,215,395,0,610,278,239
278,240,395,0,0,0,0,395,278,240
278,247,395,0,0,0,0,395,278,247
278,250,1627,0,0,395,0,2022,278,250
278,268,0,0,453,0,0,453,278,268
278,269,0,0,961,0,0,961,278,269
278,270,0,0,430,0,0,430,278,270
278,271,0,0,430,0,0,430,278,271
278,272,433,0,703,0,0,1136,278,272
278,273,2002,0,430,0,0,2432,278,273
278,274,645,0,1663,0,0,2308,278,274
278,275,0,0,248,348,0,596,278,275
278,276,4446,6470,677,1549,0,13142,278,276
278,277,1704,12280,2895,2123,0,19002,278,277
278,278,7479,61728,1615,11049,0,81871,278,278
278,279,225,5395,350,659,0,6629,278,279
278,280,237,0,703,237,0,1177,278,280
278,281,0,0,430,0,0,430,278,281
278,282,508,0,4931,237,0,5676,278,282
278,283,0,0,76,49,0,125,278,283
278,284,732,0,1752,348,0,2832,278,284
278,285,3250,1428,2686,221,0,7585,278,285
278,286,0,0,0,395,0,395,278,286
278,287,169,0,0,0,0,169,278,287
278,288,0,0,430,0,0,430,278,288
278,298,534,0,0,0,0,534,278,298
278,300,0,0,1435,0,0,1435,278,300
278,302,0,0,2066,0,0,2066,278,302
278,303,0,0,1325,0,0,1325,278,303
278,306,764,0,0,0,0,764,278,306
278,312,395,0,0,0,0,395,278,312
278,315,0,0,348,0,0,348,278,315
278,317,265,0,0,250,0,515,278,317
278,319,0,0,288,0,0,288,278,319
278,320,0,0,0,98,0,98,278,320
278,321,0,0,668,0,0,668,278,321
278,326,0,0,430,0,0,430,278,326
278,333,0,0,147,0,0,147,278,333
279,2,0,0,711,0,0,711,279,2
279,3,0,0,245,0,0,245,279,3
279,27,0,0,326,0,0,326,279,27
279,52,0,0,938,0,0,938,279,52
279,54,1573,0,0,0,0,1573,279,54
279,55,0,0,299,0,0,299,279,55
279,59,0,0,1437,0,0,1437,279,59
279,61,0,0,832,0,0,832,279,61
279,64,0,0,1263,0,0,1263,279,64
279,66,0,0,326,0,0,326,279,66
279,67,0,0,326,0,0,326,279,67
279,68,0,0,789,121,0,910,279,68
279,69,0,0,447,0,0,447,279,69
279,70,0,0,395,0,0,395,279,70
279,77,0,0,1175,0,0,1175,279,77
279,79,0,0,0,363,0,363,279,79
279,92,0,0,225,0,0,225,279,92
279,93,0,0,299,0,0,299,279,93
279,158,0,0,524,0,0,524,279,158
279,190,0,0,508,0,0,508,279,190
279,236,0,0,774,0,0,774,279,236
279,239,0,0,322,0,0,322,279,239
279,268,0,0,996,0,0,996,279,268
279,269,0,0,553,0,0,553,279,269
279,273,0,0,326,0,0,326,279,273
279,274,0,0,774,0,0,774,279,274
279,275,0,0,720,599,0,1319,279,275
279,276,0,0,0,405,0,405,279,276
279,277,0,1692,2390,1544,0,5626,279,277
279,278,225,4684,1397,1054,0,7360,279,278
279,279,599,32435,651,7437,0,41122,279,279
279,280,611,0,1168,299,0,2078,279,280
279,281,0,0,582,0,0,582,279,281
279,282,0,2172,1833,862,0,4867,279,282
279,283,0,299,0,0,0,299,279,283
279,284,3244,1456,3125,623,0,8448,279,284
279,285,1320,711,245,0,0,2276,279,285
279,287,0,711,0,0,0,711,279,287
279,288,0,0,350,0,0,350,279,288
279,289,0,0,326,0,0,326,279,289
279,298,534,0,0,0,0,534,279,298
279,300,0,0,1204,0,0,1204,279,300
279,302,0,0,774,0,0,774,279,302
279,303,0,0,1002,0,0,1002,279,303
279,318,0,0,774,0,0,774,279,318
279,339,0,0,369,0,0,369,279,339
279,341,0,0,0,862,0,862,279,341
280,1,353,0,188,0,0,541,280,1
280,3,0,0,170,0,0,170,280,3
280,5,0,0,868,0,0,868,280,5
280,8,111,0,0,0,0,111,280,8
280,9,0,0,0,0,207,207,280,9
280,11,23,0,0,0,0,23,280,11
280,14,0,0,155,0,0,155,280,14
280,23,0,0,115,0,0,115,280,23
280,24,0,0,327,0,0,327,280,24
280,28,38,0,0,0,0,38,280,28
280,29,23,0,0,0,0,23,280,29
280,30,0,0,47,0,0,47,280,30
280,31,106,0,122,0,0,228,280,31
280,35,0,0,312,0,0,312,280,35
280,44,0,0,56,0,0,56,280,44
280,49,74,0,0,0,0,74,280,49
280,52,0,0,179,0,0,179,280,52
280,53,0,0,168,0,0,168,280,53
280,57,143,0,0,0,0,143,280,57
280,59,0,0,267,0,0,267,280,59
280,64,240,0,167,0,0,407,280,64
280,66,159,0,0,0,0,159,280,66
280,68,0,0,0,122,0,122,280,68
280,69,143,0,0,0,0,143,280,69
280,70,425,0,133,0,0,558,280,70
280,71,94,0,986,0,0,1080,280,71
280,72,143,0,59,0,0,202,280,72
280,73,354,0,213,0,0,567,280,73
280,74,143,0,0,0,0,143,280,74
280,76,0,0,59,0,0,59,280,76
280,77,0,0,590,0,0,590,280,77
280,79,54,0,146,0,0,200,280,79
280,80,287,0,301,0,0,588,280,80
280,82,159,0,0,0,0,159,280,82
280,83,69,0,0,0,0,69,280,83
280,84,51,0,0,0,0,51,280,84
280,87,0,0,24,0,0,24,280,87
280,92,0,0,4,0,0,4,280,92
280,96,67,0,0,0,0,67,280,96
280,100,0,0,185,0,0,185,280,100
280,102,49,0,0,0,0,49,280,102
280,106,330,0,0,0,0,330,280,106
280,123,0,0,647,0,0,647,280,123
280,126,261,0,0,0,0,261,280,126
280,177,0,0,46,0,0,46,280,177
280,184,0,0,201,0,0,201,280,184
280,199,900,0,0,0,0,900,280,199
280,221,263,0,0,0,0,263,280,221
280,223,179,0,0,0,0,179,280,223
280,242,178,0,250,0,0,428,280,242
280,268,267,143,0,0,0,410,280,268
280,270,0,0,83,0,0,83,280,270
280,273,165,0,300,0,0,465,280,273
280,274,258,0,560,0,0,818,280,274
280,277,0,0,266,0,0,266,280,277
280,278,237,0,961,237,0,1435,280,278
280,279,299,711,733,299,0,2042,280,279
280,280,2802,8094,899,519,0,12314,280,280
280,281,3232,2800,1195,408,0,7635,280,281
280,282,672,341,967,228,0,2208,280,282
280,283,288,0,107,0,132,527,280,283
280,284,353,0,2011,0,0,2364,280,284
280,286,57,0,73,0,0,130,280,286
280,287,570,468,183,0,0,1221,280,287
280,288,39,0,163,43,0,245,280,288
280,289,0,0,1407,0,0,1407,280,289
280,290,0,0,1369,0,0,1369,280,290
280,291,0,0,1515,785,0,2300,280,291
280,292,687,0,987,0,0,1674,280,292
280,293,143,0,1404,0,0,1547,280,293
280,294,542,0,1178,0,0,1720,280,294
280,295,0,0,2252,823,0,3075,280,295
280,297,0,0,34,0,0,34,280,297
280,298,0,0,816,301,0,1117,280,298
280,300,798,0,321,316,0,1435,280,300
280,301,727,0,0,0,0,727,280,301
280,302,271,697,440,189,0,1597,280,302
280,303,1146,0,484,189,0,1819,280,303
280,305,0,0,1200,0,0,1200,280,305
280,306,0,0,523,0,0,523,280,306
280,307,0,0,768,0,0,768,280,307
280,309,0,0,166,0,0,166,280,309
280,310,259,0,282,0,0,541,280,310
280,312,0,0,437,0,0,437,280,312
280,313,0,0,0,99,0,99,280,313
280,314,0,0,16,0,0,16,280,314
280,315,0,0,562,0,0,562,280,315
280,316,165,0,0,0,0,165,280,316
280,317,0,0,572,0,0,572,280,317
280,318,103,0,110,0,0,213,280,318
280,319,17,0,0,0,0,17,280,319
280,320,125,0,299,0,0,424,280,320
280,321,526,0,0,0,0,526,280,321
280,322,229,0,155,0,0,384,280,322
280,323,206,0,490,0,0,696,280,323
280,324,0,0,667,0,0,667,280,324
280,339,143,0,0,0,0,143,280,339
281,5,0,0,986,0,0,986,281,5
281,7,0,0,159,0,0,159,281,7
281,20,442,0,0,0,0,442,281,20
281,24,0,0,485,0,0,485,281,24
281,27,0,0,173,0,0,173,281,27
281,28,159,0,124,0,0,283,281,28
281,30,39,0,0,0,0,39,281,30
281,31,0,0,631,0,0,631,281,31
281,32,159,0,0,0,0,159,281,32
281,34,655,0,0,0,0,655,281,34
281,41,121,0,0,0,0,121,281,41
281,54,0,0,220,0,0,220,281,54
281,57,155,0,0,0,0,155,281,57
281,59,0,0,173,0,0,173,281,59
281,60,318,0,111,0,0,429,281,60
281,61,204,0,0,0,0,204,281,61
281,62,0,0,577,0,0,577,281,62
281,64,537,0,0,0,0,537,281,64
281,65,379,0,0,0,0,379,281,65
281,66,43,0,0,0,0,43,281,66
281,68,0,0,196,0,0,196,281,68
281,71,0,0,0,124,0,124,281,71
281,72,581,0,0,0,0,581,281,72
281,73,796,0,275,159,0,1230,281,73
281,76,304,0,173,0,0,477,281,76
281,77,0,0,159,0,0,159,281,77
281,80,0,0,0,49,0,49,281,80
281,81,159,0,0,0,0,159,281,81
281,82,202,0,801,0,0,1003,281,82
281,83,531,0,0,0,0,531,281,83
281,84,0,0,124,0,0,124,281,84
281,87,67,0,0,0,0,67,281,87
281,89,0,0,290,0,0,290,281,89
281,94,0,0,173,0,0,173,281,94
281,95,0,0,223,0,0,223,281,95
281,98,8,0,0,0,0,8,281,98
281,106,0,0,196,0,0,196,281,106
281,121,24,0,0,0,0,24,281,121
281,129,204,0,0,0,0,204,281,129
281,214,124,0,0,0,0,124,281,214
281,247,838,0,1198,0,0,2036,281,247
281,250,108,0,0,0,0,108,281,250
281,268,477,0,0,159,0,636,281,268
281,270,54,0,577,0,0,631,281,270
281,272,1673,0,0,0,0,1673,281,272
281,273,430,0,300,0,0,730,281,273
281,274,318,0,0,0,0,318,281,274
281,275,274,0,0,0,0,274,281,275
281,277,3909,2755,168,319,0,7151,281,277
281,278,0,0,430,0,0,430,281,278
281,279,0,0,582,0,0,582,281,279
281,280,3232,3675,243,408,0,7558,281,280
281,281,7501,7137,962,4525,0,20125,281,281
281,282,1989,2166,391,1877,0,6423,281,282
281,283,91,412,415,0,0,918,281,283
281,284,149,0,1069,0,0,1218,281,284
281,285,159,0,533,0,0,692,281,285
281,287,118,0,624,0,0,742,281,287
281,288,68,0,667,0,0,735,281,288
281,289,662,0,940,0,0,1602,281,289
281,290,0,0,894,0,0,894,281,290
281,292,0,0,291,442,0,733,281,292
281,293,0,0,0,295,0,295,281,293
281,294,159,0,589,0,0,748,281,294
281,295,555,0,469,0,0,1024,281,295
281,296,0,0,33,0,0,33,281,296
281,297,0,0,27,0,0,27,281,297
281,298,0,0,1300,0,0,1300,281,298
281,299,0,0,96,0,0,96,281,299
281,300,1611,0,0,202,0,1813,281,300
281,301,596,0,0,1482,0,2078,281,301
281,302,0,0,906,520,0,1426,281,302
281,303,594,0,499,0,0,1093,281,303
281,305,202,0,622,0,0,824,281,305
281,307,298,0,325,0,0,623,281,307
281,310,0,0,282,0,0,282,281,310
281,312,0,0,292,0,0,292,281,312
281,314,0,0,16,0,0,16,281,314
281,315,0,0,185,0,0,185,281,315
281,317,0,0,545,0,0,545,281,317
281,319,241,0,0,0,0,241,281,319
281,321,111,0,0,0,0,111,281,321
281,322,0,0,417,0,0,417,281,322
281,323,0,0,539,0,0,539,281,323
281,324,0,0,502,0,0,502,281,324
281,339,223,0,275,0,0,498,281,339
281,340,159,0,0,0,0,159,281,340
282,2,0,0,471,0,0,471,282,2
282,21,83,0,0,0,0,83,282,21
282,24,0,0,475,0,0,475,282,24
282,31,0,0,218,0,0,218,282,31
282,49,140,0,318,0,0,458,282,49
282,55,0,0,30,0,0,30,282,55
282,58,0,0,401,0,0,401,282,58
282,59,49,0,584,0,0,633,282,59
282,61,0,0,210,0,0,210,282,61
282,63,0,0,1208,0,0,1208,282,63
282,64,0,0,314,0,0,314,282,64
282,66,749,0,218,0,0,967,282,66
282,67,80,0,0,0,0,80,282,67
282,68,143,0,0,279,0,422,282,68
282,72,284,0,60,0,0,344,282,72
282,73,0,0,61,0,0,61,282,73
282,79,433,0,0,0,0,433,282,79
282,80,13,0,0,0,0,13,282,80
282,91,201,0,0,0,0,201,282,91
282,106,0,0,151,0,0,151,282,106
282,127,0,0,201,0,0,201,282,127
282,151,0,0,882,0,0,882,282,151
282,196,0,0,338,0,0,338,282,196
282,207,1321,0,0,0,0,1321,282,207
282,217,0,0,284,0,0,284,282,217
282,229,0,0,0,273,0,273,282,229
282,233,616,0,0,0,0,616,282,233
282,236,41,0,0,0,0,41,282,236
282,237,0,0,28,0,0,28,282,237
282,240,0,59,0,0,0,59,282,240
282,246,113,0,0,0,0,113,282,246
282,268,36,0,190,0,0,226,282,268
282,269,201,0,0,0,0,201,282,269
282,270,54,0,0,0,0,54,282,270
282,274,0,0,213,0,0,213,282,274
282,276,601,0,0,0,0,601,282,276
282,277,1946,2936,611,0,0,5493,282,277
282,278,1259,0,5178,237,0,6674,282,278
282,279,0,2172,1833,862,0,4867,282,279
282,280,672,341,133,228,0,1374,282,280
282,281,1398,2166,173,1877,0,5614,282,281
282,282,6030,15141,0,4149,0,25320,282,282
282,283,971,689,355,97,0,2112,282,283
282,284,83,284,1161,0,0,1528,282,284
282,286,0,0,237,106,0,343,282,286
282,287,292,0,0,0,0,292,282,287
282,288,0,0,261,0,0,261,282,288
282,290,1238,0,155,0,0,1393,282,290
282,291,1253,0,0,0,0,1253,282,291
282,292,316,0,0,0,0,316,282,292
282,293,35,0,54,0,0,89,282,293
282,295,0,0,2773,823,0,3596,282,295
282,300,535,0,0,0,0,535,282,300
282,302,978,0,92,201,0,1271,282,302
282,303,98,0,239,0,0,337,282,303
282,304,585,0,834,0,0,1419,282,304
282,305,947,0,0,0,0,947,282,305
282,308,0,0,465,0,0,465,282,308
282,318,1110,0,0,0,0,1110,282,318
282,319,201,0,0,0,0,201,282,319
282,321,189,0,767,0,0,956,282,321
282,323,909,0,436,0,0,1345,282,323
282,324,0,0,0,986,0,986,282,324
282,325,409,0,0,0,0,409,282,325
282,330,0,0,0,882,0,882,282,330
283,5,49,0,0,0,0,49,283,5
283,7,0,0,5,0,0,5,283,7
283,9,0,0,49,0,0,49,283,9
283,23,0,0,54,0,0,54,283,23
283,25,0,0,74,0,0,74,283,25
283,29,0,0,32,0,0,32,283,29
283,30,0,0,130,0,0,130,283,30
283,32,0,0,0,70,0,70,283,32
283,35,0,0,54,0,0,54,283,35
283,44,0,0,70,0,0,70,283,44
283,56,0,0,96,110,0,206,283,56
283,58,0,0,32,0,0,32,283,58
283,59,0,0,70,0,0,70,283,59
283,60,0,0,99,0,0,99,283,60
283,62,91,0,0,0,0,91,283,62
283,63,0,0,0,59,0,59,283,63
283,64,0,0,252,0,0,252,283,64
283,66,58,0,0,0,0,58,283,66
283,68,0,0,99,0,0,99,283,68
283,69,0,0,86,0,0,86,283,69
283,72,0,0,153,0,0,153,283,72
283,73,49,0,481,0,0,530,283,73
283,75,109,0,0,0,0,109,283,75
283,76,0,0,54,0,0,54,283,76
283,77,0,0,112,0,0,112,283,77
283,80,0,0,0,29,0,29,283,80
283,82,0,0,21,0,0,21,283,82
283,88,0,0,112,0,0,112,283,88
283,90,0,0,54,0,0,54,283,90
283,92,0,0,4,0,0,4,283,92
283,108,23,0,0,0,0,23,283,108
283,134,183,0,0,0,0,183,283,134
283,137,0,0,99,0,0,99,283,137
283,195,0,0,317,0,0,317,283,195
283,268,0,0,54,126,0,180,283,268
283,269,91,0,0,0,0,91,283,269
283,271,0,0,74,49,0,123,283,271
283,272,49,0,0,0,0,49,283,272
283,274,0,0,99,0,0,99,283,274
283,278,0,0,76,49,0,125,283,278
283,279,0,299,0,0,0,299,283,279
283,280,337,0,54,0,132,523,283,280
283,281,91,68,648,0,0,807,283,281
283,282,771,890,355,97,0,2113,283,282
283,283,49,4032,88,323,0,4492,283,283
283,284,1460,97,0,0,0,1557,283,284
283,286,183,0,0,0,0,183,283,286
283,287,527,0,0,0,0,527,283,287
283,293,0,0,714,869,0,1583,283,293
283,298,0,0,328,0,0,328,283,298
283,300,49,0,265,0,0,314,283,300
283,301,79,0,459,0,0,538,283,301
283,302,0,0,294,0,0,294,283,302
283,303,128,0,76,79,0,283,283,303
283,305,140,0,0,0,0,140,283,305
283,315,0,0,200,0,0,200,283,315
283,322,0,0,492,0,0,492,283,322
283,334,0,0,86,0,0,86,283,334
283,339,0,0,130,0,0,130,283,339
284,2,0,0,272,0,0,272,284,2
284,7,0,0,0,353,0,353,284,7
284,9,0,0,250,0,0,250,284,9
284,23,0,0,299,0,0,299,284,23
284,43,63,0,0,0,0,63,284,43
284,52,0,0,384,0,0,384,284,52
284,54,353,0,0,0,0,353,284,54
284,55,72,0,0,0,0,72,284,55
284,57,0,0,304,0,0,304,284,57
284,59,353,0,0,0,0,353,284,59
284,66,0,0,693,0,0,693,284,66
284,68,0,0,230,0,0,230,284,68
284,69,0,0,384,0,0,384,284,69
284,73,955,0,870,0,0,1825,284,73
284,76,1203,0,0,0,0,1203,284,76
284,81,0,0,870,0,0,870,284,81
284,82,724,0,870,76,0,1670,284,82
284,83,69,0,602,0,0,671,284,83
284,84,51,0,0,0,0,51,284,84
284,96,0,0,308,0,0,308,284,96
284,99,96,0,0,0,0,96,284,99
284,104,21,0,0,0,0,21,284,104
284,109,158,0,0,0,0,158,284,109
284,208,0,0,325,0,0,325,284,208
284,242,353,0,0,0,0,353,284,242
284,250,602,0,0,0,0,602,284,250
284,251,400,0,0,0,0,400,284,251
284,272,0,0,655,0,0,655,284,272
284,273,353,0,688,0,0,1041,284,273
284,274,764,0,384,0,0,1148,284,274
284,277,0,0,1150,0,0,1150,284,277
284,278,732,0,1752,348,0,2832,284,278
284,279,2819,1145,3125,934,0,8023,284,279
284,280,353,0,2011,0,0,2364,284,280
284,281,124,0,1069,0,0,1193,284,281
284,282,516,284,689,0,0,1489,284,282
284,283,1460,97,0,0,0,1557,284,283
284,284,655,22231,3481,6925,0,33292,284,284
284,285,1876,2080,1779,1520,0,7255,284,285
284,288,0,0,84,0,0,84,284,288
284,290,707,0,0,0,0,707,284,290
284,291,25,0,0,0,0,25,284,291
284,294,0,0,1012,0,0,1012,284,294
284,300,51,0,0,0,0,51,284,300
284,301,0,0,1039,0,0,1039,284,301
284,302,0,0,788,0,0,788,284,302
284,303,0,0,279,0,0,279,284,303
284,305,0,0,384,0,0,384,284,305
284,319,0,0,0,353,0,353,284,319
285,5,0,0,467,0,0,467,285,5
285,6,0,0,666,0,0,666,285,6
285,21,0,0,83,0,0,83,285,21
285,29,490,0,0,0,0,490,285,29
285,31,0,0,1395,0,0,1395,285,31
285,43,0,0,68,0,0,68,285,43
285,53,0,0,1221,0,0,1221,285,53
285,56,0,0,1133,0,0,1133,285,56
285,57,0,0,1395,0,0,1395,285,57
285,60,0,0,533,0,0,533,285,60
285,61,0,0,490,0,0,490,285,61
285,63,0,0,533,0,0,533,285,63
285,66,0,0,533,0,0,533,285,66
285,73,0,0,1578,0,0,1578,285,73
285,75,0,0,467,0,0,467,285,75
285,79,490,0,0,0,0,490,285,79
285,82,0,0,498,0,0,498,285,82
285,83,0,0,69,0,0,69,285,83
285,102,0,0,0,90,0,90,285,102
285,229,0,0,365,0,0,365,285,229
285,247,490,0,0,0,0,490,285,247
285,250,0,0,725,0,0,725,285,250
285,251,405,0,0,0,0,405,285,251
285,270,0,0,0,490,0,490,285,270
285,274,405,0,1066,0,0,1471,285,274
285,275,0,0,533,0,0,533,285,275
285,276,0,0,1395,0,0,1395,285,276
285,278,3645,1665,2686,221,0,8217,285,278
285,279,1256,711,245,0,0,2212,285,279
285,281,159,0,533,0,0,692,285,281
285,284,1451,2080,1779,1520,0,6830,285,284
285,285,18501,61511,5851,10433,0,96296,285,285
285,291,3330,0,270,467,0,4067,285,291
285,294,1887,0,1012,0,0,2899,285,294
285,300,1095,0,0,405,0,1500,285,300
285,302,0,0,533,0,0,533,285,302
285,303,1282,0,1395,0,0,2677,285,303
285,311,0,0,533,0,0,533,285,311
285,323,0,0,586,0,0,586,285,323
285,326,405,0,0,0,0,405,285,326
285,328,0,0,162,0,0,162,285,328
285,334,104,0,0,0,0,104,285,334
285,336,0,0,533,0,0,533,285,336
286,23,56,0,0,0,0,56,286,23
286,24,0,0,93,0,0,93,286,24
286,32,0,0,147,50,0,197,286,32
286,35,0,0,325,0,0,325,286,35
286,50,0,0,74,0,0,74,286,50
286,54,37,0,0,0,0,37,286,54
286,62,0,0,93,0,0,93,286,62
286,64,0,0,121,0,0,121,286,64
286,66,67,0,0,0,0,67,286,66
286,67,0,0,88,0,0,88,286,67
286,69,0,0,235,0,0,235,286,69
286,71,193,0,0,0,0,193,286,71
286,73,0,0,86,0,0,86,286,73
286,74,55,0,0,0,0,55,286,74
286,75,17,0,0,0,0,17,286,75
286,77,199,0,0,0,0,199,286,77
286,78,0,0,18,0,0,18,286,78
286,79,0,0,126,0,0,126,286,79
286,81,21,0,207,0,0,228,286,81
286,82,0,0,106,0,0,106,286,82
286,84,17,0,0,0,0,17,286,84
286,87,33,0,0,0,0,33,286,87
286,92,86,0,0,0,0,86,286,92
286,127,0,0,706,0,0,706,286,127
286,131,0,0,860,0,0,860,286,131
286,153,152,0,0,0,0,152,286,153
286,213,0,0,675,0,0,675,286,213
286,239,0,0,0,61,0,61,286,239
286,244,0,0,486,0,0,486,286,244
286,245,0,0,278,0,0,278,286,245
286,247,86,0,0,0,0,86,286,247
286,268,0,0,90,0,0,90,286,268
286,269,0,0,0,139,0,139,286,269
286,270,29,0,0,0,0,29,286,270
286,277,244,0,207,0,0,451,286,277
286,278,0,0,0,395,0,395,286,278
286,280,57,0,18,0,0,75,286,280
286,282,0,0,237,106,0,343,286,282
286,283,183,0,0,0,0,183,286,283
286,286,3815,3834,0,484,0,8133,286,286
286,287,2529,969,887,693,379,5457,286,287
286,288,0,0,196,0,0,196,286,288
286,289,0,0,539,0,0,539,286,289
286,290,231,0,969,0,0,1200,286,290
286,291,785,0,0,0,0,785,286,291
286,292,687,0,0,0,0,687,286,292
286,293,0,0,0,869,0,869,286,293
286,294,0,0,589,930,0,1519,286,294
286,295,431,0,2456,0,0,2887,286,295
286,296,0,0,561,0,0,561,286,296
286,298,250,0,1516,0,0,1766,286,298
286,299,0,0,96,0,0,96,286,299
286,300,0,0,1006,86,0,1092,286,300
286,301,29,0,0,0,0,29,286,301
286,302,1993,0,374,0,0,2367,286,302
286,303,244,197,440,70,0,951,286,303
286,304,0,0,87,373,0,460,286,304
286,305,373,0,811,736,0,1920,286,305
286,306,421,0,1385,808,0,2614,286,306
286,307,0,0,327,0,0,327,286,307
286,309,0,0,591,487,0,1078,286,309
286,311,29,0,2243,0,0,2272,286,311
286,313,0,0,250,0,0,250,286,313
286,314,257,0,279,0,0,536,286,314
286,315,366,0,378,185,0,929,286,315
286,318,0,0,0,103,0,103,286,318
286,321,251,0,0,0,0,251,286,321
286,322,87,0,51,0,0,138,286,322
286,323,206,0,0,0,0,206,286,323
286,324,0,0,330,0,0,330,286,324
286,325,29,0,22,0,0,51,286,325
286,326,0,0,425,0,0,425,286,326
286,328,197,0,0,0,0,197,286,328
286,329,0,0,240,0,0,240,286,329
287,3,0,0,115,0,0,115,287,3
287,5,0,0,106,0,0,106,287,5
287,9,0,0,26,0,0,26,287,9
287,10,0,0,0,118,0,118,287,10
287,14,0,0,245,0,0,245,287,14
287,17,0,0,118,0,0,118,287,17
287,30,64,0,0,0,0,64,287,30
287,44,42,0,0,0,0,42,287,44
287,56,78,0,0,0,0,78,287,56
287,57,0,0,128,0,0,128,287,57
287,60,102,0,0,0,0,102,287,60
287,63,11,0,0,238,0,249,287,63
287,64,0,0,255,0,0,255,287,64
287,66,0,0,0,43,0,43,287,66
287,69,106,0,0,0,0,106,287,69
287,70,106,0,710,0,0,816,287,70
287,71,106,0,115,0,0,221,287,71
287,73,230,0,288,0,0,518,287,73
287,76,0,0,315,0,0,315,287,76
287,99,106,0,0,0,0,106,287,99
287,106,211,0,0,0,0,211,287,106
287,137,234,0,0,0,0,234,287,137
287,219,0,0,154,0,0,154,287,219
287,247,0,0,788,0,0,788,287,247
287,269,0,0,158,0,0,158,287,269
287,272,0,0,148,0,0,148,287,272
287,273,292,0,0,0,0,292,287,273
287,275,0,0,527,0,0,527,287,275
287,276,601,0,0,0,0,601,287,276
287,277,223,0,0,0,0,223,287,277
287,278,169,0,0,0,0,169,287,278
287,279,0,711,0,0,0,711,287,279
287,280,676,468,238,0,0,1382,287,280
287,281,118,0,624,0,0,742,287,281
287,282,292,0,0,0,0,292,287,282
287,283,527,0,0,0,0,527,287,283
287,286,1430,812,1323,138,379,4082,287,286
287,287,11551,14410,1479,817,1019,29276,287,287
287,288,2072,0,354,470,245,3141,287,288
287,289,1565,410,1543,1510,796,5824,287,289
287,290,0,0,251,0,0,251,287,290
287,291,574,0,513,0,0,1087,287,291
287,292,687,0,0,0,0,687,287,292
287,293,0,0,581,0,0,581,287,293
287,294,1083,0,1627,0,0,2710,287,294
287,295,0,0,1740,0,0,1740,287,295
287,298,0,0,1229,0,0,1229,287,298
287,300,824,0,288,340,0,1452,287,300
287,301,945,0,0,0,0,945,287,301
287,302,234,0,49,0,0,283,287,302
287,303,359,0,374,0,245,978,287,303
287,305,0,106,0,0,0,106,287,305
287,306,0,0,879,0,0,879,287,306
287,307,0,0,325,0,0,325,287,307
287,308,106,0,0,0,0,106,287,308
287,309,324,0,0,0,0,324,287,309
287,311,0,0,0,764,0,764,287,311
287,319,17,0,0,0,0,17,287,319
287,321,0,0,635,242,0,877,287,321
287,342,473,0,0,0,0,473,287,342
288,2,77,0,0,0,0,77,288,2
288,4,0,0,84,0,0,84,288,4
288,6,0,0,166,0,0,166,288,6
288,21,0,0,56,0,0,56,288,21
288,23,32,0,0,0,0,32,288,23
288,28,0,0,481,0,0,481,288,28
288,29,0,0,347,0,0,347,288,29
288,30,0,0,82,0,0,82,288,30
288,54,0,0,573,0,0,573,288,54
288,63,0,0,147,0,0,147,288,63
288,64,0,0,0,120,0,120,288,64
288,66,43,0,0,0,0,43,288,66
288,68,39,0,0,0,0,39,288,68
288,71,0,0,393,0,0,393,288,71
288,72,122,0,0,0,0,122,288,72
288,73,94,0,0,0,0,94,288,73
288,81,39,0,0,0,0,39,288,81
288,82,258,0,0,0,0,258,288,82
288,87,24,0,0,0,0,24,288,87
288,100,0,0,228,0,0,228,288,100
288,133,0,0,75,0,0,75,288,133
288,251,0,0,0,240,0,240,288,251
288,268,35,0,0,0,0,35,288,268
288,272,240,0,0,0,0,240,288,272
288,274,317,0,0,0,0,317,288,274
288,275,0,0,0,319,0,319,288,275
288,278,0,0,430,0,0,430,288,278
288,279,0,0,350,0,0,350,288,279
288,280,0,0,163,43,0,206,288,280
288,281,68,0,0,0,0,68,288,281
288,282,0,0,261,0,0,261,288,282
288,284,0,0,84,0,0,84,288,284
288,286,0,0,1026,0,0,1026,288,286
288,287,1832,0,537,470,245,3084,288,287
288,288,271,7024,2765,642,0,10702,288,288
288,289,1425,2309,1316,2259,0,7309,288,289
288,290,873,0,1491,114,0,2478,288,290
288,291,458,2633,2140,1543,0,6774,288,291
288,293,0,0,1719,0,0,1719,288,293
288,294,431,0,1091,0,0,1522,288,294
288,295,0,0,2173,0,0,2173,288,295
288,297,84,0,0,0,0,84,288,297
288,298,0,75,1564,0,0,1639,288,298
288,299,104,0,0,104,0,208,288,299
288,300,262,0,0,0,0,262,288,300
288,301,117,0,0,0,0,117,288,301
288,302,328,0,0,0,0,328,288,302
288,303,0,0,446,0,0,446,288,303
288,304,39,0,0,0,0,39,288,304
288,306,0,0,1003,0,0,1003,288,306
288,307,0,0,671,0,0,671,288,307
288,311,0,0,88,0,0,88,288,311
288,315,0,0,321,0,0,321,288,315
288,316,480,0,0,0,0,480,288,316
288,319,62,0,0,0,0,62,288,319
288,331,0,0,132,0,0,132,288,331
288,338,0,0,134,0,0,134,288,338
288,339,0,0,95,575,0,670,288,339
289,1,0,0,410,0,0,410,289,1
289,5,0,0,505,0,0,505,289,5
289,21,59,0,0,0,0,59,289,21
289,27,0,0,332,0,0,332,289,27
289,32,0,0,540,0,0,540,289,32
289,43,82,0,0,0,0,82,289,43
289,49,410,0,0,0,0,410,289,49
289,54,0,0,446,0,0,446,289,54
289,57,0,0,0,82,0,82,289,57
289,64,0,0,509,0,0,509,289,64
289,66,79,0,0,0,0,79,289,66
289,68,0,0,375,0,0,375,289,68
289,70,0,0,582,0,0,582,289,70
289,73,0,0,1097,0,0,1097,289,73
289,82,0,0,880,0,0,880,289,82
289,99,271,0,0,0,0,271,289,99
289,102,0,0,53,0,0,53,289,102
289,136,162,0,0,0,0,162,289,136
289,214,0,0,1305,0,0,1305,289,214
289,234,0,0,0,261,0,261,289,234
289,268,0,0,446,0,0,446,289,268
289,269,492,0,0,0,0,492,289,269
289,270,88,0,0,0,0,88,289,270
289,271,0,0,0,639,0,639,289,271
289,272,410,0,446,0,0,856,289,272
289,273,0,0,332,0,0,332,289,273
289,275,0,0,446,0,0,446,289,275
289,277,0,0,1150,0,0,1150,289,277
289,279,0,0,326,0,0,326,289,279
289,280,0,0,961,0,0,961,289,280
289,281,658,0,971,0,0,1629,289,281
289,282,937,0,0,0,0,937,289,282
289,284,0,0,331,0,0,331,289,284
289,286,0,0,539,0,0,539,289,286
289,287,1565,410,956,2050,796,5777,289,287
289,288,1507,2776,772,2259,0,7314,289,288
289,289,1683,23738,2411,2702,0,30534,289,289
289,290,1601,3481,1131,0,0,6213,289,290
289,291,1043,1082,771,441,0,3337,289,291
289,292,1016,0,1203,687,0,2906,289,292
289,293,0,0,1675,0,0,1675,289,293
289,294,0,0,1019,0,0,1019,289,294
289,295,823,0,469,431,0,1723,289,295
289,297,0,0,54,32,0,86,289,297
289,298,1530,0,1842,876,0,4248,289,298
289,300,1569,0,919,0,0,2488,289,300
289,301,540,0,97,102,0,739,289,301
289,302,36,0,1062,307,0,1405,289,302
289,303,612,0,1901,0,0,2513,289,303
289,304,0,0,305,0,0,305,289,304
289,305,0,0,220,0,0,220,289,305
289,307,0,0,327,0,0,327,289,307
289,313,0,0,122,0,0,122,289,313
289,321,111,0,0,0,0,111,289,321
290,4,0,0,572,0,0,572,290,4
290,19,0,0,629,0,0,629,290,19
290,23,0,0,1030,0,0,1030,290,23
290,27,0,0,311,0,0,311,290,27
290,28,0,0,1012,0,0,1012,290,28
290,30,0,0,629,0,0,629,290,30
290,31,0,0,302,0,0,302,290,31
290,32,0,0,231,0,0,231,290,32
290,57,143,0,0,0,0,143,290,57
290,67,0,0,478,0,0,478,290,67
290,68,0,0,477,0,0,477,290,68
290,69,0,0,536,0,0,536,290,69
290,71,0,0,774,0,0,774,290,71
290,80,0,0,774,0,0,774,290,80
290,81,0,0,231,0,0,231,290,81
290,82,0,0,238,0,0,238,290,82
290,93,0,0,822,0,0,822,290,93
290,94,0,0,623,0,0,623,290,94
290,126,0,0,0,283,0,283,290,126
290,131,0,0,231,0,0,231,290,131
290,270,76,0,0,0,0,76,290,270
290,278,534,0,0,0,0,534,290,278
290,280,0,0,1940,0,0,1940,290,280
290,281,0,0,894,0,0,894,290,281
290,282,1238,0,155,0,0,1393,290,282
290,283,0,0,945,0,0,945,290,283
290,284,707,0,0,0,0,707,290,284
290,286,231,0,969,0,0,1200,290,286
290,287,0,0,251,0,0,251,290,287
290,288,873,0,1548,57,0,2478,290,288
290,289,1937,1871,1131,1305,0,6244,290,289
290,290,231,33803,1731,2243,0,38008,290,290
290,291,271,0,0,802,0,1073,290,291
290,293,533,2685,1147,4896,0,9261,290,293
290,294,0,0,738,0,0,738,290,294
290,295,1646,0,754,0,0,2400,290,295
290,297,95,0,0,0,0,95,290,297
290,298,1543,0,0,0,0,1543,290,298
290,300,860,0,1264,0,0,2124,290,300
290,301,0,0,839,0,0,839,290,301
290,302,0,0,728,0,0,728,290,302
290,303,0,0,2088,231,0,2319,290,303
290,309,0,0,465,0,0,465,290,309
290,321,0,0,0,231,0,231,290,321
290,323,0,0,0,539,0,539,290,323
290,337,0,0,162,0,0,162,290,337
291,20,15,0,0,0,0,15,291,20
291,23,0,0,208,0,0,208,291,23
291,32,0,0,248,0,0,248,291,32
291,36,0,0,854,0,0,854,291,36
291,39,0,0,162,0,0,162,291,39
291,57,0,0,702,0,0,702,291,57
291,63,0,0,270,0,0,270,291,63
291,65,0,0,2675,0,0,2675,291,65
291,68,0,0,1082,0,0,1082,291,68
291,70,0,0,235,0,0,235,291,70
291,71,0,0,967,0,0,967,291,71
291,72,879,0,0,0,0,879,291,72
291,73,0,0,1236,380,0,1616,291,73
291,74,0,0,1360,0,0,1360,291,74
291,77,0,0,498,0,0,498,291,77
291,80,0,0,248,0,0,248,291,80
291,82,574,0,1594,0,0,2168,291,82
291,83,0,0,270,0,0,270,291,83
291,96,0,0,270,0,0,270,291,96
291,105,785,0,0,0,0,785,291,105
291,106,0,0,467,0,0,467,291,106
291,137,0,0,0,248,0,248,291,137
291,225,399,0,0,0,0,399,291,225
291,241,0,0,1017,0,0,1017,291,241
291,270,574,0,0,0,0,574,291,270
291,272,0,0,270,0,0,270,291,272
291,273,0,0,854,0,0,854,291,273
291,275,785,0,0,0,0,785,291,275
291,276,1987,0,0,0,0,1987,291,276
291,280,0,0,2119,785,0,2904,291,280
291,282,785,0,0,0,0,785,291,282
291,285,3330,0,270,467,0,4067,291,285
291,286,1472,0,0,0,0,1472,291,286
291,287,0,0,513,0,0,513,291,287
291,288,458,2633,2140,1543,0,6774,291,288
291,289,2356,1082,771,441,0,4650,291,289
291,290,0,0,0,802,0,802,291,290
291,291,17415,27492,4274,5449,0,54630,291,291
291,292,4642,1900,1508,1461,0,9511,291,292
291,293,1472,649,1245,260,0,3626,291,293
291,294,0,0,51,693,0,744,291,294
291,295,863,0,3394,1059,0,5316,291,295
291,296,15,0,16,0,0,31,291,296
291,297,91,0,0,0,0,91,291,297
291,298,574,785,1396,802,0,3557,291,298
291,299,88,0,96,0,0,184,291,299
291,300,4174,0,1577,0,0,5751,291,300
291,301,0,0,625,0,0,625,291,301
291,302,0,0,1624,0,0,1624,291,302
291,303,0,0,481,0,0,481,291,303
291,305,0,0,0,330,0,330,291,305
291,314,0,0,604,0,0,604,291,314
291,322,0,0,248,0,0,248,291,322
291,323,0,0,270,0,0,270,291,323
291,327,0,0,0,248,0,248,291,327
291,334,61,0,0,0,0,61,291,334
291,337,0,0,154,0,0,154,291,337
292,5,0,0,687,0,0,687,292,5
292,8,0,0,0,687,0,687,292,8
292,28,0,0,2848,0,0,2848,292,28
292,37,0,0,287,0,0,287,292,37
292,43,0,0,344,0,0,344,292,43
292,52,61,0,0,0,0,61,292,52
292,56,0,0,1604,0,0,1604,292,56
292,57,0,0,192,0,0,192,292,57
292,64,0,0,3079,0,0,3079,292,64
292,73,0,0,846,0,0,846,292,73
292,79,0,0,125,0,0,125,292,79
292,127,838,0,0,0,0,838,292,127
292,129,60,0,0,0,0,60,292,129
292,169,0,0,509,0,0,509,292,169
292,199,0,0,0,269,0,269,292,199
292,249,0,0,233,0,0,233,292,249
292,270,184,0,0,0,0,184,292,270
292,273,0,0,1203,0,0,1203,292,273
292,275,233,0,0,0,0,233,292,275
292,280,920,0,733,0,0,1653,292,280
292,281,0,0,291,442,0,733,292,281
292,282,316,0,0,0,0,316,292,282
292,286,687,0,0,0,0,687,292,286
292,288,0,0,0,316,0,316,292,288
292,289,1016,0,1950,687,0,3653,292,289
292,291,5012,1968,1753,1293,0,10026,292,291
292,292,5575,30493,3525,7346,0,46939,292,292
292,293,1128,1254,0,1185,0,3567,292,293
292,295,5922,754,1502,368,0,8546,292,295
292,296,679,108,0,0,0,787,292,296
292,298,2993,0,328,0,0,3321,292,298
292,300,233,0,1816,0,0,2049,292,300
292,302,0,0,1195,0,0,1195,292,302
292,303,316,0,0,0,0,316,292,303
292,305,0,0,544,0,0,544,292,305
292,319,0,0,747,0,0,747,292,319
292,321,0,0,267,0,0,267,292,321
292,341,0,0,0,509,0,509,292,341
293,1,0,0,869,0,0,869,293,1
293,4,0,0,495,0,0,495,293,4
293,5,0,0,1545,0,0,1545,293,5
293,22,0,0,526,0,0,526,293,22
293,27,0,0,67,0,0,67,293,27
293,32,0,0,1069,0,0,1069,293,32
293,39,0,0,38,0,0,38,293,39
293,44,0,0,0,484,0,484,293,44
293,53,0,0,352,0,0,352,293,53
293,56,0,0,484,0,0,484,293,56
293,58,0,0,526,0,0,526,293,58
293,60,0,0,1890,0,0,1890,293,60
293,61,0,0,526,0,0,526,293,61
293,64,0,0,352,0,0,352,293,64
293,65,0,0,652,0,0,652,293,65
293,66,0,0,526,0,0,526,293,66
293,71,323,0,237,0,0,560,293,71
293,72,0,0,596,0,0,596,293,72
293,73,0,0,808,0,0,808,293,73
293,79,41,0,41,0,0,82,293,79
293,83,0,0,945,0,0,945,293,83
293,86,0,0,484,0,0,484,293,86
293,87,0,0,484,0,0,484,293,87
293,93,0,0,1283,0,0,1283,293,93
293,100,0,0,808,0,0,808,293,100
293,128,0,0,869,0,0,869,293,128
293,144,0,0,714,0,0,714,293,144
293,169,0,0,869,0,0,869,293,169
293,239,0,0,0,869,0,869,293,239
293,273,0,0,398,0,0,398,293,273
293,277,0,0,889,0,0,889,293,277
293,280,143,0,808,0,0,951,293,280
293,281,0,0,0,295,0,295,293,281
293,282,35,0,54,0,0,89,293,282
293,283,0,0,714,0,0,714,293,283
293,286,0,0,0,869,0,869,293,286
293,287,0,0,398,0,0,398,293,287
293,288,0,0,1719,0,0,1719,293,288
293,289,0,540,1675,0,0,2215,293,289
293,290,533,3553,1147,4896,0,10129,293,290
293,291,0,840,1245,260,0,2345,293,291
293,292,1361,1021,344,869,0,3595,293,292
293,293,967,43903,513,12282,0,57665,293,293
293,294,0,484,5527,0,0,6011,293,294
293,295,3513,472,3596,0,0,7581,293,295
293,296,0,0,66,0,0,66,293,296
293,298,7516,250,2208,250,1710,11934,293,298
293,299,0,0,96,0,0,96,293,299
293,300,0,0,2687,0,0,2687,293,300
293,302,0,0,1913,0,0,1913,293,302
293,303,2423,0,6200,0,0,8623,293,303
293,305,0,0,591,0,0,591,293,305
293,311,0,0,831,0,0,831,293,311
293,313,0,0,114,0,0,114,293,313
294,1,0,0,860,0,0,860,294,1
294,2,0,0,2830,0,0,2830,294,2
294,14,0,0,1145,0,0,1145,294,14
294,15,0,0,110,0,0,110,294,15
294,17,0,0,20,0,0,20,294,17
294,27,0,0,1659,0,0,1659,294,27
294,32,0,0,663,0,0,663,294,32
294,33,0,0,0,542,0,542,294,33
294,36,0,0,575,0,0,575,294,36
294,53,0,0,0,467,0,467,294,53
294,60,69,0,0,0,0,69,294,60
294,64,0,0,670,0,0,670,294,64
294,67,0,0,589,0,0,589,294,67
294,68,542,0,667,0,0,1209,294,68
294,70,84,0,667,0,0,751,294,70
294,73,0,0,1720,0,0,1720,294,73
294,76,0,0,589,0,0,589,294,76
294,77,0,0,651,0,0,651,294,77
294,78,0,0,667,0,0,667,294,78
294,82,0,0,542,0,0,542,294,82
294,96,53,0,667,0,0,720,294,96
294,97,35,0,0,0,0,35,294,97
294,101,0,0,667,0,0,667,294,101
294,111,336,0,0,0,0,336,294,111
294,113,0,0,667,0,0,667,294,113
294,131,1083,0,0,0,0,1083,294,131
294,144,0,0,824,0,0,824,294,144
294,212,0,0,656,0,0,656,294,212
294,248,0,0,508,0,0,508,294,248
294,269,0,0,1098,0,0,1098,294,269
294,270,0,0,589,0,0,589,294,270
294,277,0,0,873,0,0,873,294,277
294,280,542,0,1178,0,0,1720,294,280
294,281,159,0,589,0,0,748,294,281
294,284,0,0,1012,0,0,1012,294,284
294,285,1887,0,0,930,0,2817,294,285
294,286,0,0,589,930,0,1519,294,286
294,287,1083,0,873,693,0,2649,294,287
294,288,431,0,766,0,0,1197,294,288
294,289,0,0,1527,0,0,1527,294,289
294,290,0,0,738,0,0,738,294,290
294,291,0,0,51,693,0,744,294,291
294,293,0,484,5344,0,0,5828,294,293
294,294,1083,79475,7940,12920,0,101418,294,294
294,295,431,4854,2628,1395,0,9308,294,295
294,296,0,0,50,0,0,50,294,296
294,300,0,0,2643,0,0,2643,294,300
294,302,0,0,742,0,0,742,294,302
294,303,0,0,3723,0,0,3723,294,303
294,305,802,0,0,0,0,802,294,305
294,312,0,0,467,0,0,467,294,312
294,322,0,0,802,0,0,802,294,322
294,326,0,0,422,0,0,422,294,326
294,328,0,0,873,0,0,873,294,328
294,329,0,0,1145,0,0,1145,294,329
294,333,0,0,1145,0,0,1145,294,333
295,6,555,0,0,0,0,555,295,6
295,24,0,0,321,0,0,321,295,24
295,32,0,0,20,0,0,20,295,32
295,36,0,0,1059,0,0,1059,295,36
295,49,0,0,0,59,0,59,295,49
295,54,0,0,819,0,0,819,295,54
295,55,0,0,321,0,0,321,295,55
295,57,0,0,1059,0,0,1059,295,57
295,61,0,0,349,431,0,780,295,61
295,65,0,0,469,0,0,469,295,65
295,68,0,0,895,0,0,895,295,68
295,69,0,0,895,0,0,895,295,69
295,70,0,0,1426,0,0,1426,295,70
295,71,0,0,0,823,0,823,295,71
295,72,0,0,895,0,0,895,295,72
295,73,0,0,395,0,0,395,295,73
295,74,0,0,555,0,0,555,295,74
295,75,0,0,469,0,0,469,295,75
295,77,1389,0,431,0,0,1820,295,77
295,78,0,0,895,0,0,895,295,78
295,82,0,0,395,0,0,395,295,82
295,88,0,0,1304,0,0,1304,295,88
295,91,0,0,555,0,0,555,295,91
295,97,0,0,1013,0,0,1013,295,97
295,241,0,0,555,0,0,555,295,241
295,269,0,0,895,0,0,895,295,269
295,273,0,0,469,0,0,469,295,273
295,277,0,0,604,0,0,604,295,277
295,280,0,0,1013,823,0,1836,295,280
295,281,555,0,1136,0,0,1691,295,281
295,282,0,0,2773,0,0,2773,295,282
295,286,1254,0,2456,555,0,4265,295,286
295,287,0,0,1136,0,0,1136,295,287
295,288,0,0,1506,0,0,1506,295,288
295,289,823,0,469,431,0,1723,295,289
295,290,1646,0,754,0,0,2400,295,290
295,291,1741,0,3394,1059,0,6194,295,291
295,292,5922,679,1502,368,0,8471,295,292
295,293,3513,472,3596,0,0,7581,295,293
295,294,431,4854,2663,1395,0,9343,295,294
295,295,8743,50466,10927,12430,1778,84344,295,295
295,296,1661,823,0,950,0,3434,295,296
295,297,0,0,42,0,0,42,295,297
295,298,752,0,469,431,0,1652,295,298
295,300,0,0,4410,0,0,4410,295,300
295,302,0,0,604,0,0,604,295,302
295,303,0,0,2549,0,0,2549,295,303
295,304,0,0,555,0,0,555,295,304
295,305,823,0,0,0,0,823,295,305
295,340,0,0,108,0,0,108,295,340
296,20,0,0,15,0,0,15,296,20
296,27,0,0,30,0,0,30,296,27
296,35,0,0,15,0,0,15,296,35
296,54,0,0,16,0,0,16,296,54
296,55,0,0,16,0,0,16,296,55
296,56,0,0,301,0,0,301,296,56
296,66,30,0,0,0,0,30,296,66
296,82,0,0,0,127,0,127,296,82
296,100,0,0,19,0,0,19,296,100
296,268,0,0,16,0,0,16,296,268
296,269,119,0,0,0,0,119,296,269
296,277,0,0,16,0,0,16,296,277
296,281,0,0,33,0,0,33,296,281
296,286,0,0,561,0,0,561,296,286
296,291,30,0,16,0,0,46,296,291
296,292,679,108,0,0,0,787,296,292
296,293,0,0,66,0,0,66,296,293
296,294,0,0,50,0,0,50,296,294
296,295,1661,0,895,950,0,3506,296,295
296,296,50,278,0,1406,742,2476,296,296
296,297,89,0,0,0,0,89,296,297
296,298,40,0,272,0,0,312,296,298
296,301,15,0,49,0,0,64,296,301
296,302,0,0,56,0,0,56,296,302
296,303,21,0,16,0,0,37,296,303
296,305,0,0,19,0,0,19,296,305
296,308,0,0,0,15,0,15,296,308
296,315,30,0,0,0,0,30,296,315
296,321,0,0,16,0,0,16,296,321
296,325,0,0,158,0,0,158,296,325
297,2,50,0,0,0,0,50,297,2
297,64,0,0,83,0,0,83,297,64
297,72,0,0,39,0,0,39,297,72
297,73,0,0,71,0,0,71,297,73
297,79,37,0,0,0,0,37,297,79
297,99,0,0,39,0,0,39,297,99
297,106,0,0,61,0,0,61,297,106
297,243,25,0,0,0,0,25,297,243
297,271,0,0,34,0,0,34,297,271
297,274,25,0,25,0,0,50,297,274
297,280,0,0,34,0,0,34,297,280
297,281,0,0,27,0,0,27,297,281
297,288,84,0,0,0,0,84,297,288
297,289,25,0,0,32,0,57,297,289
297,290,25,0,0,70,0,95,297,290
297,291,66,0,0,0,0,66,297,291
297,295,0,0,42,0,0,42,297,295
297,296,89,0,0,0,0,89,297,296
297,297,321,353,138,243,130,1185,297,297
297,298,522,184,561,41,0,1308,297,298
297,299,0,0,34,0,0,34,297,299
297,300,0,0,30,0,0,30,297,300
297,301,0,0,111,0,0,111,297,301
298,1,0,0,657,0,0,657,298,1
298,4,0,0,272,0,0,272,298,4
298,5,0,0,644,0,0,644,298,5
298,6,0,0,301,0,0,301,298,6
298,25,0,0,0,14,0,14,298,25
298,27,0,0,250,0,0,250,298,27
298,30,0,0,250,0,0,250,298,30
298,32,0,0,301,0,0,301,298,32
298,35,102,0,0,0,0,102,298,35
298,36,0,0,301,0,0,301,298,36
298,37,0,0,672,0,0,672,298,37
298,52,0,0,272,0,0,272,298,52
298,54,0,0,853,0,0,853,298,54
298,56,0,0,584,0,0,584,298,56
298,57,0,0,1162,0,0,1162,298,57
298,60,0,0,272,0,0,272,298,60
298,62,0,0,1255,0,0,1255,298,62
298,63,35,0,700,0,0,735,298,63
298,64,0,0,1745,0,0,1745,298,64
298,65,0,0,272,0,0,272,298,65
298,66,0,0,1508,0,0,1508,298,66
298,67,0,0,272,0,0,272,298,67
298,68,0,0,2857,0,0,2857,298,68
298,71,0,0,371,0,0,371,298,71
298,72,0,0,1951,0,0,1951,298,72
298,73,0,0,1100,0,0,1100,298,73
298,74,0,0,308,0,0,308,298,74
298,76,261,0,272,0,0,533,298,76
298,77,0,0,308,0,0,308,298,77
298,78,0,0,529,0,0,529,298,78
298,79,534,0,301,0,0,835,298,79
298,80,0,0,250,0,0,250,298,80
298,81,0,0,272,0,0,272,298,81
298,82,0,0,657,0,0,657,298,82
298,83,0,0,558,0,0,558,298,83
298,87,250,0,0,0,0,250,298,87
298,91,0,0,308,0,0,308,298,91
298,99,0,0,371,0,0,371,298,99
298,108,0,0,1315,0,0,1315,298,108
298,116,0,0,0,470,0,470,298,116
298,151,0,0,581,0,0,581,298,151
298,189,0,0,371,0,0,371,298,189
298,238,0,0,250,0,0,250,298,238
298,266,0,0,272,0,0,272,298,266
298,268,0,0,0,551,0,551,298,268
298,269,0,0,272,0,0,272,298,269
298,271,0,0,700,0,0,700,298,271
298,272,0,0,581,0,0,581,298,272
298,273,301,0,0,0,0,301,298,273
298,278,0,0,272,0,0,272,298,278
298,279,534,0,0,0,0,534,298,279
298,280,0,0,816,301,0,1117,298,280
298,281,301,0,1244,0,0,1545,298,281
298,283,0,0,328,0,0,328,298,283
298,286,0,0,1516,0,0,1516,298,286
298,287,0,0,1229,0,0,1229,298,287
298,288,0,75,1836,0,0,1911,298,288
298,289,1530,0,1298,876,0,3704,298,289
298,290,2077,0,0,0,0,2077,298,290
298,291,954,785,1396,802,0,3937,298,291
298,292,2306,0,328,0,0,2634,298,292
298,293,7193,250,2208,250,1710,11611,298,293
298,295,1076,0,469,431,0,1976,298,295
298,296,40,0,272,0,0,312,298,296
298,297,772,184,561,41,0,1558,298,297
298,298,8477,87098,16386,25161,0,137122,298,298
298,299,710,646,1601,680,0,3637,298,299
298,300,0,0,1168,551,0,1719,298,300
298,301,1003,0,272,0,0,1275,298,301
298,302,0,0,1654,0,362,2016,298,302
298,303,250,0,1168,26,0,1444,298,303
298,304,534,0,581,0,0,1115,298,304
298,305,0,0,328,534,0,862,298,305
298,306,421,0,0,0,0,421,298,306
298,307,310,0,0,0,0,310,298,307
298,313,0,0,250,0,0,250,298,313
298,315,0,0,350,0,0,350,298,315
298,317,0,0,579,0,0,579,298,317
298,318,0,0,371,0,0,371,298,318
298,322,77,0,0,0,0,77,298,322
298,325,0,0,22,0,0,22,298,325
298,328,0,0,657,0,0,657,298,328
298,339,0,0,250,0,0,250,298,339
299,1,0,0,88,0,0,88,299,1
299,25,0,0,96,0,0,96,299,25
299,45,0,0,88,0,0,88,299,45
299,55,0,0,96,0,0,96,299,55
299,65,0,0,96,0,0,96,299,65
299,68,0,0,0,104,0,104,299,68
299,78,0,0,109,0,0,109,299,78
299,82,0,0,218,0,0,218,299,82
299,83,0,0,104,0,0,104,299,83
299,100,104,0,0,0,0,104,299,100
299,104,9,0,0,0,0,9,299,104
299,132,0,0,104,0,0,104,299,132
299,235,0,0,88,0,0,88,299,235
299,281,0,0,96,0,0,96,299,281
299,286,0,0,96,0,0,96,299,286
299,288,104,0,114,0,0,218,299,288
299,291,0,0,306,0,0,306,299,291
299,293,0,0,96,0,0,96,299,293
299,297,0,0,34,0,0,34,299,297
299,298,541,646,1903,402,0,3492,299,298
299,299,209,1784,345,161,0,2499,299,299
299,300,0,0,114,0,0,114,299,300
299,301,0,0,86,0,0,86,299,301
299,302,0,0,288,0,0,288,299,302
299,303,0,0,114,0,0,114,299,303
299,319,79,0,0,0,0,79,299,319
300,1,0,0,111,0,0,111,300,1
300,2,0,0,295,0,0,295,300,2
300,3,0,0,95,0,0,95,300,3
300,8,0,0,83,0,0,83,300,8
300,9,0,0,20,0,0,20,300,9
300,10,0,0,132,0,0,132,300,10
300,16,0,0,223,0,0,223,300,16
300,18,124,0,88,0,0,212,300,18
300,21,1241,0,0,0,0,1241,300,21
300,22,0,0,67,0,0,67,300,22
300,27,332,0,226,0,0,558,300,27
300,28,0,0,102,0,0,102,300,28
300,29,571,0,297,0,0,868,300,29
300,30,129,0,64,0,0,193,300,30
300,31,23,0,128,0,0,151,300,31
300,32,93,0,315,0,0,408,300,32
300,33,31,0,0,0,0,31,300,33
300,34,39,0,30,39,0,108,300,34
300,35,511,0,0,0,0,511,300,35
300,36,131,0,0,412,0,543,300,36
300,37,0,0,231,0,0,231,300,37
300,39,285,0,134,0,0,419,300,39
300,40,0,0,18,0,0,18,300,40
300,41,121,0,0,0,0,121,300,41
300,42,24,0,0,0,0,24,300,42
300,43,126,0,63,0,0,189,300,43
300,49,74,0,121,0,0,195,300,49
300,50,55,0,74,0,0,129,300,50
300,51,289,0,289,0,0,578,300,51
300,52,0,0,1212,0,0,1212,300,52
300,53,0,0,566,0,0,566,300,53
300,54,95,0,40,0,0,135,300,54
300,55,168,0,0,0,0,168,300,55
300,56,973,0,0,0,0,973,300,56
300,57,75,0,730,155,0,960,300,57
300,58,0,0,306,0,0,306,300,58
300,59,267,0,1797,0,0,2064,300,59
300,60,671,0,0,0,0,671,300,60
300,62,0,0,27,0,0,27,300,62
300,63,52,0,0,0,0,52,300,63
300,64,550,0,251,0,0,801,300,64
300,65,687,0,126,231,0,1044,300,65
300,66,149,0,194,466,0,809,300,66
300,67,80,0,486,0,0,566,300,67
300,68,402,0,282,0,590,1274,300,68
300,69,905,0,0,0,0,905,300,69
300,70,285,0,213,0,121,619,300,70
300,71,2502,0,660,0,0,3162,300,71
300,72,1527,2683,206,642,256,5314,300,72
300,73,328,353,440,330,0,1451,300,73
300,74,186,0,255,39,0,480,300,74
300,75,46,0,139,0,0,185,300,75
300,76,193,0,0,0,0,193,300,76
300,77,137,0,0,0,0,137,300,77
300,78,102,0,102,0,0,204,300,78
300,79,41,0,0,511,59,611,300,79
300,80,44,0,534,0,0,578,300,80
300,81,111,0,0,80,0,191,300,81
300,82,684,0,114,0,40,838,300,82
300,83,354,0,98,74,0,526,300,83
300,84,51,0,18,0,0,69,300,84
300,85,24,0,0,0,0,24,300,85
300,86,18,0,0,0,0,18,300,86
300,87,33,0,0,0,0,33,300,87
300,88,138,0,110,0,0,248,300,88
300,90,48,0,0,0,0,48,300,90
300,91,0,0,545,0,0,545,300,91
300,94,0,0,43,0,0,43,300,94
300,95,224,0,0,0,0,224,300,95
300,96,94,0,82,0,0,176,300,96
300,97,35,0,0,0,0,35,300,97
300,98,0,0,9,0,0,9,300,98
300,99,0,0,118,0,0,118,300,99
300,101,0,0,404,0,0,404,300,101
300,102,49,0,0,0,0,49,300,102
300,103,0,0,26,0,0,26,300,103
300,104,21,0,26,0,0,47,300,104
300,105,322,0,0,0,0,322,300,105
300,106,35,0,0,0,0,35,300,106
300,107,0,0,0,49,0,49,300,107
300,108,511,0,125,0,0,636,300,108
300,110,0,0,540,0,0,540,300,110
300,111,0,0,0,336,0,336,300,111
300,124,507,0,0,0,0,507,300,124
300,127,1890,0,0,0,0,1890,300,127
300,136,0,0,0,247,0,247,300,136
300,137,0,0,237,0,0,237,300,137
300,141,162,0,0,0,0,162,300,141
300,144,994,0,0,0,0,994,300,144
300,147,432,0,826,0,0,1258,300,147
300,152,0,0,346,187,0,533,300,152
300,153,0,0,152,0,0,152,300,153
300,154,0,0,1073,0,0,1073,300,154
300,162,25,0,0,0,0,25,300,162
300,164,0,0,0,32,0,32,300,164
300,166,0,0,273,0,0,273,300,166
300,169,0,0,34,0,0,34,300,169
300,170,0,0,0,211,0,211,300,170
300,172,0,0,496,0,0,496,300,172
300,175,0,0,0,495,0,495,300,175
300,176,0,0,582,0,0,582,300,176
300,177,0,0,46,0,0,46,300,177
300,178,0,0,21,0,0,21,300,178
300,182,0,0,511,0,0,511,300,182
300,185,351,0,0,0,0,351,300,185
300,192,0,0,276,0,0,276,300,192
300,200,0,0,0,109,0,109,300,200
300,202,0,0,444,0,0,444,300,202
300,205,0,0,384,0,0,384,300,205
300,222,0,0,128,0,0,128,300,222
300,227,0,0,240,0,0,240,300,227
300,233,220,0,0,0,0,220,300,233
300,235,1202,0,0,0,0,1202,300,235
300,236,1021,0,0,0,0,1021,300,236
300,237,26,0,0,202,0,228,300,237
300,238,0,0,0,151,0,151,300,238
300,239,425,0,119,0,0,544,300,239
300,240,285,0,0,0,0,285,300,240
300,241,0,0,58,0,0,58,300,241
300,247,456,0,0,0,0,456,300,247
300,249,0,0,526,0,0,526,300,249
300,251,1117,0,0,0,0,1117,300,251
300,252,745,0,254,0,0,999,300,252
300,253,0,0,24,0,0,24,300,253
300,256,0,0,0,261,0,261,300,256
300,257,433,0,880,0,0,1313,300,257
300,260,0,0,689,0,0,689,300,260
300,268,883,188,210,0,225,1506,300,268
300,269,1022,0,0,238,0,1260,300,269
300,270,207,0,0,0,0,207,300,270
300,272,682,0,40,400,0,1122,300,272
300,273,997,0,292,0,0,1289,300,273
300,274,741,0,1869,0,0,2610,300,274
300,275,274,0,0,0,0,274,300,275
300,276,0,0,923,0,0,923,300,276
300,277,244,0,989,0,0,1233,300,277
300,278,0,0,2254,0,0,2254,300,278
300,279,0,0,1204,0,0,1204,300,279
300,280,872,0,355,316,0,1543,300,280
300,281,1393,0,0,420,0,1813,300,281
300,282,535,0,151,0,0,686,300,282
300,283,0,0,265,0,0,265,300,283
300,284,51,0,0,0,0,51,300,284
300,285,690,0,440,0,0,1130,300,285
300,286,118,0,175,86,0,379,300,286
300,287,780,0,288,340,0,1408,300,287
300,288,262,0,1834,0,0,2096,300,288
300,289,1569,0,919,0,0,2488,300,289
300,290,936,0,2138,0,0,3074,300,290
300,291,1818,0,2544,0,0,4362,300,291
300,292,0,0,1816,0,0,1816,300,292
300,293,0,0,1878,0,0,1878,300,293
300,294,0,0,2643,0,0,2643,300,294
300,295,0,0,4410,0,0,4410,300,295
300,297,88,0,30,0,0,118,300,297
300,298,0,0,819,0,0,819,300,298
300,300,21243,52444,2125,2327,0,78139,300,300
300,301,4179,885,0,0,0,5064,300,301
300,302,2522,1928,2830,687,0,7967,300,302
300,303,2535,2260,1306,705,0,6806,300,303
300,304,558,0,1911,513,0,2982,300,304
300,305,570,0,3223,0,0,3793,300,305
300,307,0,0,625,0,0,625,300,307
300,308,0,0,391,0,0,391,300,308
300,309,305,0,946,0,0,1251,300,309
300,310,0,0,914,813,0,1727,300,310
300,311,0,0,1030,81,0,1111,300,311
300,312,0,0,1434,0,0,1434,300,312
300,313,575,0,820,0,0,1395,300,313
300,314,899,0,4120,0,0,5019,300,314
300,315,0,0,2625,0,0,2625,300,315
300,316,430,0,443,44,0,917,300,316
300,317,29,0,0,0,0,29,300,317
300,318,1511,0,912,103,0,2526,300,318
300,319,139,0,35,0,0,174,300,319
300,320,125,0,1946,0,0,2071,300,320
300,321,2308,0,2597,543,0,5448,300,321
300,322,647,0,107,534,0,1288,300,322
300,323,2143,0,4253,0,0,6396,300,323
300,324,736,0,981,0,0,1717,300,324
300,325,514,0,0,0,0,514,300,325
300,326,0,0,1489,619,0,2108,300,326
300,327,263,0,59,0,0,322,300,327
300,328,165,0,153,0,0,318,300,328
300,329,18,0,62,0,0,80,300,329
300,330,164,0,948,0,0,1112,300,330
300,332,86,0,0,426,0,512,300,332
300,333,48,0,270,0,0,318,300,333
300,338,0,0,134,0,0,134,300,338
300,339,0,0,343,0,0,343,300,339
300,340,86,0,0,0,0,86,300,340
300,341,86,0,0,0,0,86,300,341
301,1,0,0,57,0,0,57,301,1
301,2,0,0,86,0,0,86,301,2
301,4,79,0,57,0,0,136,301,4
301,6,52,0,0,0,0,52,301,6
301,20,783,0,0,0,0,783,301,20
301,21,0,0,163,0,0,163,301,21
301,24,0,0,80,0,0,80,301,24
301,27,79,0,151,0,0,230,301,27
301,28,236,0,0,0,0,236,301,28
301,29,159,0,0,0,0,159,301,29
301,31,0,0,86,0,0,86,301,31
301,32,0,0,21,0,0,21,301,32
301,34,0,0,39,0,0,39,301,34
301,41,26,0,121,0,0,147,301,41
301,49,204,0,0,50,0,254,301,49
301,53,0,0,126,79,0,205,301,53
301,54,0,0,15,0,0,15,301,54
301,55,168,0,52,0,0,220,301,55
301,57,52,0,0,0,0,52,301,57
301,58,175,0,0,0,0,175,301,58
301,60,183,0,0,0,0,183,301,60
301,61,172,0,0,0,0,172,301,61
301,62,105,0,0,0,0,105,301,62
301,63,11,0,12,0,0,23,301,63
301,64,267,0,131,0,0,398,301,64
301,65,116,0,0,0,0,116,301,65
301,66,210,0,183,123,0,516,301,66
301,67,209,0,0,0,0,209,301,67
301,68,158,0,149,0,0,307,301,68
301,70,312,0,0,0,0,312,301,70
301,72,414,0,0,0,0,414,301,72
301,73,176,0,0,312,0,488,301,73
301,75,0,0,147,0,0,147,301,75
301,76,79,0,0,0,0,79,301,76
301,77,0,0,0,79,0,79,301,77
301,79,0,0,158,0,0,158,301,79
301,80,0,0,106,0,0,106,301,80
301,81,87,0,0,0,0,87,301,81
301,82,0,0,153,66,0,219,301,82
301,84,51,0,86,74,0,211,301,84
301,88,0,0,170,0,0,170,301,88
301,95,79,0,0,0,0,79,301,95
301,97,35,0,0,0,0,35,301,97
301,99,85,0,0,0,0,85,301,99
301,102,0,0,49,0,0,49,301,102
301,118,0,0,166,0,0,166,301,118
301,121,0,0,376,0,0,376,301,121
301,124,0,0,80,0,0,80,301,124
301,169,0,0,202,0,0,202,301,169
301,186,146,0,0,0,0,146,301,186
301,190,0,0,156,0,0,156,301,190
301,200,0,0,149,0,0,149,301,200
301,234,52,0,0,0,0,52,301,234
301,237,255,0,0,0,0,255,301,237
301,241,0,0,58,0,0,58,301,241
301,253,0,0,24,0,0,24,301,253
301,254,188,0,0,0,0,188,301,254
301,268,519,53,0,0,79,651,301,268
301,269,52,0,86,0,0,138,301,269
301,270,54,0,0,0,0,54,301,270
301,271,158,0,0,0,0,158,301,271
301,272,304,0,0,0,0,304,301,272
301,273,454,0,0,0,0,454,301,273
301,275,377,0,0,0,0,377,301,275
301,276,0,0,654,0,0,654,301,276
301,277,260,0,0,244,0,504,301,277
301,280,909,0,0,0,0,909,301,280
301,281,0,0,0,1919,0,1919,301,281
301,283,79,0,459,0,0,538,301,283
301,284,0,0,1039,0,0,1039,301,284
301,286,29,0,0,0,0,29,301,286
301,287,945,0,0,0,0,945,301,287
301,288,77,0,0,0,0,77,301,288
301,289,540,0,97,102,0,739,301,289
301,290,0,0,839,0,0,839,301,290
301,291,0,0,625,0,0,625,301,291
301,296,15,0,49,0,0,64,301,296
301,297,0,0,111,0,0,111,301,297
301,298,1003,0,272,0,0,1275,301,298
301,299,0,0,86,0,0,86,301,299
301,300,4550,885,57,0,0,5492,301,300
301,301,625,2355,0,0,0,2980,301,301
301,302,2030,1082,322,154,0,3588,301,302
301,303,620,58,189,0,0,867,301,303
301,304,0,0,152,0,0,152,301,304
301,305,0,0,701,0,0,701,301,305
301,306,79,0,0,0,0,79,301,306
301,307,0,0,0,1531,0,1531,301,307
301,309,0,0,958,153,0,1111,301,309
301,310,0,0,80,0,0,80,301,310
301,311,0,0,2067,0,0,2067,301,311
301,312,0,0,813,274,0,1087,301,312
301,314,0,0,481,0,0,481,301,314
301,315,0,0,507,0,0,507,301,315
301,316,72,0,0,0,0,72,301,316
301,317,15,0,74,0,0,89,301,317
301,318,348,0,112,0,0,460,301,318
301,319,0,0,209,0,0,209,301,319
301,320,303,0,299,0,0,602,301,320
301,321,111,0,0,0,0,111,301,321
301,322,0,0,131,79,0,210,301,322
301,323,0,0,539,0,0,539,301,323
301,324,0,0,686,0,0,686,301,324
301,326,0,0,742,0,0,742,301,326
301,327,27,0,318,0,0,345,301,327
301,329,350,0,0,0,0,350,301,329
301,339,0,0,176,0,0,176,301,339
301,341,140,0,0,0,0,140,301,341
302,3,0,0,129,0,0,129,302,3
302,5,65,0,92,0,0,157,302,5
302,7,85,0,0,0,0,85,302,7
302,22,85,0,0,0,0,85,302,22
302,23,79,0,0,0,0,79,302,23
302,24,85,0,0,170,0,255,302,24
302,25,76,0,0,0,0,76,302,25
302,26,0,0,152,0,0,152,302,26
302,27,0,0,83,0,0,83,302,27
302,28,102,0,209,0,0,311,302,28
302,30,0,0,64,0,0,64,302,30
302,35,85,0,0,0,0,85,302,35
302,38,0,0,29,0,0,29,302,38
302,53,0,0,140,0,0,140,302,53
302,57,0,0,75,0,0,75,302,57
302,59,0,0,156,0,0,156,302,59
302,60,0,0,202,0,0,202,302,60
302,61,288,0,0,0,0,288,302,61
302,63,85,0,0,0,0,85,302,63
302,64,290,0,85,0,0,375,302,64
302,66,58,0,92,0,0,150,302,66
302,67,0,0,92,0,0,92,302,67
302,68,272,0,226,0,0,498,302,68
302,69,0,0,92,0,0,92,302,69
302,71,361,0,167,76,0,604,302,71
302,72,0,0,97,0,0,97,302,72
302,73,85,0,135,397,0,617,302,73
302,74,85,0,118,0,0,203,302,74
302,75,91,0,0,0,0,91,302,75
302,79,85,0,0,0,0,85,302,79
302,80,85,0,0,0,0,85,302,80
302,81,120,0,0,0,0,120,302,81
302,82,85,0,250,0,0,335,302,82
302,83,0,0,75,0,0,75,302,83
302,84,0,0,140,0,0,140,302,84
302,87,143,0,0,0,0,143,302,87
302,92,0,0,4,0,0,4,302,92
302,93,0,0,40,273,0,313,302,93
302,108,143,0,0,0,0,143,302,108
302,122,389,0,0,0,0,389,302,122
302,126,0,0,284,0,0,284,302,126
302,129,35,0,0,0,0,35,302,129
302,130,0,0,85,0,0,85,302,130
302,134,541,0,0,0,0,541,302,134
302,139,37,0,0,0,0,37,302,139
302,152,0,0,85,0,0,85,302,152
302,154,601,0,0,0,0,601,302,154
302,178,0,0,76,0,0,76,302,178
302,216,301,0,0,0,0,301,302,216
302,222,0,0,223,0,0,223,302,222
302,237,85,0,0,0,0,85,302,237
302,251,200,0,0,0,0,200,302,251
302,268,312,0,57,154,0,523,302,268
302,269,292,0,947,0,0,1239,302,269
302,270,373,0,69,0,0,442,302,270
302,271,145,0,0,85,0,230,302,271
302,272,38,0,0,0,0,38,302,272
302,273,872,0,1254,0,0,2126,302,273
302,274,359,0,92,0,0,451,302,274
302,275,0,0,70,0,0,70,302,275
302,276,0,0,1309,0,0,1309,302,276
302,277,527,0,1164,0,0,1691,302,277
302,278,0,0,1819,0,0,1819,302,278
302,279,0,0,774,0,0,774,302,279
302,280,271,697,595,189,0,1752,302,280
302,281,0,0,906,520,0,1426,302,281
302,282,1219,0,92,201,0,1512,302,282
302,283,119,0,294,0,0,413,302,283
302,284,0,0,788,0,0,788,302,284
302,285,0,0,533,0,0,533,302,285
302,286,29,0,207,0,0,236,302,286
302,287,533,0,49,0,0,582,302,287
302,288,246,0,0,0,0,246,302,288
302,289,198,0,1062,307,0,1567,302,289
302,290,0,0,728,0,0,728,302,290
302,291,0,0,1968,0,0,1968,302,291
302,292,0,0,933,0,0,933,302,292
302,293,0,0,1198,0,0,1198,302,293
302,294,0,0,742,0,0,742,302,294
302,295,823,0,604,0,0,1427,302,295
302,296,0,0,56,0,0,56,302,296
302,297,0,0,62,0,0,62,302,297
302,298,0,0,2235,0,362,2597,302,298
302,299,0,0,402,0,0,402,302,299
302,300,2746,1216,1073,746,0,5781,302,300
302,301,1338,1082,322,274,0,3016,302,301
302,302,3683,12354,129,0,0,16166,302,302
302,303,787,966,736,30,0,2519,302,303
302,304,1326,0,981,0,0,2307,302,304
302,305,2433,0,4177,0,0,6610,302,305
302,306,0,0,2212,0,0,2212,302,306
302,307,599,0,3323,298,0,4220,302,307
302,308,202,0,245,0,0,447,302,308
302,309,1811,0,1199,475,0,3485,302,309
302,310,0,0,282,0,0,282,302,310
302,311,143,0,1424,425,0,1992,302,311
302,312,259,0,838,0,0,1097,302,312
302,314,0,0,3098,0,0,3098,302,314
302,315,0,0,1039,0,0,1039,302,315
302,316,0,0,0,145,0,145,302,316
302,317,0,0,15,0,0,15,302,317
302,318,0,0,395,0,0,395,302,318
302,319,12,0,89,0,0,101,302,319
302,320,274,0,1488,0,0,1762,302,320
302,321,916,0,349,0,0,1265,302,321
302,322,309,0,572,0,0,881,302,322
302,323,0,0,997,0,0,997,302,323
302,324,85,0,202,0,0,287,302,324
302,325,485,0,0,0,0,485,302,325
302,326,419,0,1377,0,0,1796,302,326
302,327,27,0,41,0,0,68,302,327
302,329,51,0,148,0,0,199,302,329
302,339,76,0,0,0,0,76,302,339
302,340,0,0,0,26,0,26,302,340
303,3,0,0,32,0,0,32,303,3
303,4,455,0,495,0,0,950,303,4
303,5,187,0,0,0,0,187,303,5
303,18,0,0,79,0,0,79,303,18
303,21,111,0,0,0,0,111,303,21
303,23,0,0,130,0,0,130,303,23
303,24,0,0,163,0,0,163,303,24
303,26,29,0,0,0,0,29,303,26
303,29,0,0,1158,0,0,1158,303,29
303,30,64,0,0,0,0,64,303,30
303,31,112,0,0,0,0,112,303,31
303,40,0,0,27,0,0,27,303,40
303,52,0,0,371,0,0,371,303,52
303,53,0,0,34,0,0,34,303,53
303,54,0,0,40,0,0,40,303,54
303,55,0,0,139,0,0,139,303,55
303,57,0,0,242,0,0,242,303,57
303,59,0,0,254,0,0,254,303,59
303,60,202,0,0,0,0,202,303,60
303,62,0,0,29,0,0,29,303,62
303,63,31,0,63,0,0,94,303,63
303,64,106,0,588,0,0,694,303,64
303,66,0,0,34,0,0,34,303,66
303,67,0,0,32,0,0,32,303,67
303,68,79,0,115,0,0,194,303,68
303,69,0,0,86,0,0,86,303,69
303,70,31,0,276,0,0,307,303,70
303,71,79,0,167,0,0,246,303,71
303,72,115,0,0,26,0,141,303,72
303,73,216,0,98,0,0,314,303,73
303,75,0,0,29,0,0,29,303,75
303,78,0,0,0,189,0,189,303,78
303,79,0,0,889,0,0,889,303,79
303,81,257,0,0,26,0,283,303,81
303,82,29,0,31,0,0,60,303,82
303,83,0,0,0,69,0,69,303,83
303,86,26,0,0,138,0,164,303,86
303,87,142,0,0,0,0,142,303,87
303,91,20,0,0,0,0,20,303,91
303,94,31,0,43,0,0,74,303,94
303,95,321,0,0,0,0,321,303,95
303,96,0,0,38,26,0,64,303,96
303,100,0,0,38,0,0,38,303,100
303,102,49,0,0,0,0,49,303,102
303,108,26,0,0,0,0,26,303,108
303,111,18,0,0,0,0,18,303,111
303,127,107,0,0,0,0,107,303,127
303,133,0,0,517,0,0,517,303,133
303,136,0,0,192,0,0,192,303,136
303,142,31,0,0,0,0,31,303,142
303,147,0,0,318,0,0,318,303,147
303,161,26,0,0,494,0,520,303,161
303,165,0,0,58,0,0,58,303,165
303,194,0,0,282,0,0,282,303,194
303,205,55,0,0,0,0,55,303,205
303,238,0,0,147,0,0,147,303,238
303,247,894,0,0,0,0,894,303,247
303,252,0,0,29,0,0,29,303,252
303,268,93,0,63,0,0,156,303,268
303,269,0,0,214,0,0,214,303,269
303,270,54,0,127,0,0,181,303,270
303,271,106,0,0,0,0,106,303,271
303,272,38,0,148,0,0,186,303,272
303,276,885,0,0,0,0,885,303,276
303,277,0,0,29,0,0,29,303,277
303,278,0,0,1209,250,0,1459,303,278
303,279,0,0,1002,0,0,1002,303,279
303,280,1204,0,295,189,0,1688,303,280
303,281,437,0,499,0,0,936,303,281
303,282,71,0,536,0,0,607,303,282
303,283,58,0,76,79,0,213,303,283
303,284,0,0,279,0,0,279,303,284
303,285,1282,0,1395,405,0,3082,303,285
303,286,244,197,513,70,0,1024,303,286
303,287,359,0,86,0,245,690,303,287
303,288,0,0,446,0,0,446,303,288
303,289,532,0,1201,0,0,1733,303,289
303,290,0,0,2417,231,0,2648,303,290
303,291,0,0,481,248,0,729,303,291
303,292,316,0,747,0,0,1063,303,292
303,293,2423,0,6369,0,0,8792,303,293
303,294,0,0,2159,802,0,2961,303,294
303,295,0,0,3701,0,0,3701,303,295
303,296,21,0,16,0,0,37,303,296
303,298,250,0,1868,26,0,2144,303,298
303,299,0,0,114,0,0,114,303,299
303,300,3023,1935,2248,26,0,7232,303,300
303,301,316,58,189,304,0,867,303,301
303,302,1538,2228,83,30,0,3879,303,302
303,303,543,10031,125,244,0,10943,303,303
303,304,0,570,1416,0,0,1986,303,304
303,305,246,497,3601,0,0,4344,303,305
303,306,834,0,3837,481,0,5152,303,306
303,307,732,0,3773,1340,0,5845,303,307
303,308,0,0,1552,0,0,1552,303,308
303,309,0,0,869,606,0,1475,303,309
303,310,0,0,318,0,0,318,303,310
303,311,0,0,5723,1527,0,7250,303,311
303,312,26,0,1001,274,0,1301,303,312
303,313,230,0,918,230,0,1378,303,313
303,314,0,0,4529,0,0,4529,303,314
303,315,0,0,2014,651,0,2665,303,315
303,316,72,0,65,0,0,137,303,316
303,317,0,0,0,0,20,20,303,317
303,318,103,0,548,0,0,651,303,318
303,319,14,0,0,0,0,14,303,319
303,320,0,0,867,0,0,867,303,320
303,321,111,0,223,152,0,486,303,321
303,322,29,0,702,0,0,731,303,322
303,323,696,0,1273,1093,0,3062,303,323
303,324,26,0,0,0,0,26,303,324
303,325,0,0,621,0,0,621,303,325
303,326,498,0,1997,0,0,2495,303,326
303,327,169,0,0,0,0,169,303,327
303,335,157,0,348,0,0,505,303,335
303,340,0,0,74,0,0,74,303,340
303,341,26,0,0,0,0,26,303,341
304,1,0,0,993,0,0,993,304,1
304,9,0,0,558,0,0,558,304,9
304,28,0,0,993,0,0,993,304,28
304,29,0,0,1106,0,0,1106,304,29
304,32,0,0,606,0,0,606,304,32
304,54,0,0,912,0,848,1760,304,54
304,57,0,0,636,0,0,636,304,57
304,62,0,0,1985,0,0,1985,304,62
304,65,0,0,636,0,0,636,304,65
304,66,58,0,0,0,0,58,304,66
304,69,0,0,993,0,0,993,304,69
304,71,0,0,406,0,0,406,304,71
304,72,176,0,0,0,0,176,304,72
304,73,0,0,1364,0,0,1364,304,73
304,74,98,0,452,0,0,550,304,74
304,76,0,0,1115,0,0,1115,304,76
304,82,0,0,652,373,0,1025,304,82
304,84,0,0,558,0,0,558,304,84
304,88,0,0,0,831,0,831,304,88
304,97,40,0,0,0,0,40,304,97
304,125,203,0,0,0,0,203,304,125
304,163,336,0,0,0,0,336,304,163
304,198,0,0,246,0,0,246,304,198
304,221,0,0,225,0,0,225,304,221
304,242,0,0,339,0,0,339,304,242
304,251,0,0,217,0,0,217,304,251
304,252,0,0,204,0,0,204,304,252
304,268,594,0,406,0,0,1000,304,268
304,270,0,0,0,54,0,54,304,270
304,271,558,0,0,0,0,558,304,271
304,272,130,0,0,0,0,130,304,272
304,280,0,0,604,0,0,604,304,280
304,282,585,0,834,0,0,1419,304,282
304,286,0,0,18,373,0,391,304,286
304,288,39,0,0,0,0,39,304,288
304,298,534,0,581,0,0,1115,304,298
304,300,558,0,1655,513,0,2726,304,300
304,301,0,0,152,0,0,152,304,301
304,302,788,0,1566,0,0,2354,304,302
304,303,0,0,1739,0,0,1739,304,303
304,304,4797,46117,6971,3936,0,61821,304,304
304,305,660,8328,3997,1355,0,14340,304,305
304,307,599,0,325,0,0,924,304,307
304,308,0,0,751,0,0,751,304,308
304,309,0,0,342,162,0,504,304,309
304,311,824,0,879,415,0,2118,304,311
304,312,2500,4869,641,2324,0,10334,304,312
304,313,230,0,0,0,0,230,304,313
304,314,1966,0,2045,0,0,4011,304,314
304,315,912,0,2413,651,0,3976,304,315
304,316,0,0,0,202,0,202,304,316
304,318,103,0,0,0,0,103,304,318
304,319,0,0,18,0,0,18,304,319
304,320,125,0,299,0,0,424,304,320
304,321,1841,0,1759,0,0,3600,304,321
304,322,77,1855,395,403,0,2730,304,322
304,323,1384,3028,948,1109,0,6469,304,323
304,324,373,0,825,915,0,2113,304,324
304,325,514,0,359,0,0,873,304,325
304,326,197,0,1113,572,0,1882,304,326
304,328,55,0,993,0,0,1048,304,328
304,332,86,0,0,646,0,732,304,332
304,341,77,0,0,0,0,77,304,341
305,1,0,0,359,0,0,359,305,1
305,2,0,0,220,202,0,422,305,2
305,5,0,0,405,0,0,405,305,5
305,6,0,0,404,0,0,404,305,6
305,14,0,0,621,0,0,621,305,14
305,15,0,0,202,0,0,202,305,15
305,16,0,0,265,0,0,265,305,16
305,19,0,0,220,0,0,220,305,19
305,21,0,0,220,0,0,220,305,21
305,24,0,0,202,0,0,202,305,24
305,27,0,0,185,0,0,185,305,27
305,32,0,0,1701,0,0,1701,305,32
305,35,0,0,621,0,0,621,305,35
305,43,836,0,0,0,0,836,305,43
305,49,0,0,409,0,0,409,305,49
305,51,0,0,202,0,0,202,305,51
305,52,0,0,1994,0,0,1994,305,52
305,54,0,0,320,0,0,320,305,54
305,55,0,0,220,0,0,220,305,55
305,56,0,0,1030,0,0,1030,305,56
305,57,202,0,1234,0,0,1436,305,57
305,59,0,0,660,0,0,660,305,59
305,62,570,0,1635,0,0,2205,305,62
305,63,370,0,71,0,0,441,305,63
305,64,0,0,2302,0,0,2302,305,64
305,65,404,0,0,0,0,404,305,65
305,66,657,0,440,0,0,1097,305,66
305,68,202,0,249,0,0,451,305,68
305,69,0,0,440,0,0,440,305,69
305,70,0,0,780,0,0,780,305,70
305,72,202,0,768,330,0,1300,305,72
305,73,0,0,2986,330,0,3316,305,73
305,76,570,0,0,0,0,570,305,76
305,77,0,0,202,0,0,202,305,77
305,79,0,0,665,0,0,665,305,79
305,80,44,0,202,0,0,246,305,80
305,81,0,0,1060,0,0,1060,305,81
305,82,0,0,2693,0,0,2693,305,82
305,83,69,0,0,0,0,69,305,83
305,87,0,0,202,0,0,202,305,87
305,96,0,0,702,0,0,702,305,96
305,97,35,0,0,0,0,35,305,97
305,104,0,0,621,0,0,621,305,104
305,105,0,0,406,0,0,406,305,105
305,106,43,0,0,202,0,245,305,106
305,144,0,0,0,1231,0,1231,305,144
305,188,0,0,202,0,0,202,305,188
305,229,0,0,202,0,0,202,305,229
305,247,0,0,131,0,0,131,305,247
305,251,0,0,376,0,0,376,305,251
305,262,0,0,621,0,0,621,305,262
305,264,0,0,621,0,0,621,305,264
305,268,0,0,359,0,0,359,305,268
305,269,0,0,1060,0,0,1060,305,269
305,270,256,0,220,0,0,476,305,270
305,271,0,0,220,0,0,220,305,271
305,273,0,0,359,0,0,359,305,273
305,277,0,0,276,0,0,276,305,277
305,280,0,0,1200,0,0,1200,305,280
305,281,202,0,622,0,0,824,305,281
305,282,947,0,0,0,0,947,305,282
305,283,140,0,0,0,0,140,305,283
305,284,0,0,384,0,0,384,305,284
305,286,2251,0,1031,0,0,3282,305,286
305,287,106,0,0,0,0,106,305,287
305,288,0,0,325,0,0,325,305,288
305,289,0,0,220,0,0,220,305,289
305,291,0,0,0,330,0,330,305,291
305,292,0,0,544,0,0,544,305,292
305,293,0,0,591,0,0,591,305,293
305,294,802,0,0,0,0,802,305,294
305,295,823,0,0,0,0,823,305,295
305,296,0,0,19,0,0,19,305,296
305,298,0,0,328,534,0,862,305,298
305,300,947,0,2603,0,0,3550,305,300
305,301,0,0,701,0,0,701,305,301
305,302,2435,0,4724,0,0,7159,305,302
305,303,448,0,2373,0,0,2821,305,303
305,304,660,8399,3157,1486,0,13702,305,304
305,305,7718,70655,6731,5232,0,90336,305,305
305,306,0,6338,529,1240,0,8107,305,306
305,307,370,0,2775,0,0,3145,305,307
305,308,570,0,0,0,0,570,305,308
305,309,0,0,249,0,0,249,305,309
305,310,0,259,142,0,0,401,305,310
305,311,675,1772,0,102,0,2549,305,311
305,312,831,440,1767,1132,0,4170,305,312
305,313,230,202,604,0,0,1036,305,313
305,314,0,202,523,918,0,1643,305,314
305,315,0,202,402,0,0,604,305,315
305,316,72,0,0,88,0,160,305,316
305,318,0,0,359,0,0,359,305,318
305,319,29,0,220,0,0,249,305,319
305,320,125,0,299,0,0,424,305,320
305,321,202,0,1411,0,0,1613,305,321
305,322,232,0,2663,202,0,3097,305,322
305,323,220,0,0,0,0,220,305,323
305,324,376,0,502,0,0,878,305,324
305,325,570,570,409,990,0,2539,305,325
305,329,0,0,220,0,0,220,305,329
305,332,0,0,291,0,0,291,305,332
305,338,207,0,0,0,0,207,305,338
305,340,0,0,669,0,0,669,305,340
306,1,0,0,764,0,0,764,306,1
306,4,0,0,206,0,0,206,306,4
306,14,922,0,0,808,0,1730,306,14
306,23,81,0,0,0,0,81,306,23
306,25,0,0,472,0,0,472,306,25
306,29,0,0,879,0,0,879,306,29
306,33,0,0,808,0,0,808,306,33
306,61,246,0,0,0,0,246,306,61
306,64,0,0,1123,421,0,1544,306,64
306,65,0,0,458,922,0,1380,306,65
306,67,0,0,458,0,0,458,306,67
306,68,0,0,879,0,0,879,306,68
306,70,0,0,458,0,0,458,306,70
306,79,0,0,523,0,0,523,306,79
306,81,0,0,1337,0,0,1337,306,81
306,82,0,0,1003,0,0,1003,306,82
306,97,0,0,704,0,0,704,306,97
306,110,0,0,301,0,0,301,306,110
306,218,0,0,610,0,0,610,306,218
306,224,0,0,421,0,0,421,306,224
306,237,0,0,527,0,0,527,306,237
306,246,0,0,808,0,0,808,306,246
306,269,0,0,458,0,0,458,306,269
306,277,0,0,527,0,0,527,306,277
306,278,764,0,0,0,0,764,306,278
306,280,0,0,523,0,0,523,306,280
306,286,421,0,1165,808,0,2394,306,286
306,287,0,0,879,0,0,879,306,287
306,298,421,0,0,0,0,421,306,298
306,300,0,0,1290,0,0,1290,306,300
306,301,79,0,0,0,0,79,306,301
306,302,0,0,2212,0,0,2212,306,302
306,303,834,0,4013,961,0,5808,306,303
306,305,0,6338,749,1240,0,8327,306,305
306,306,0,38880,1046,4400,0,44326,306,306
306,307,0,0,458,298,0,756,306,307
306,308,944,0,2344,1642,0,4930,306,308
306,309,0,0,187,0,0,187,306,309
306,310,0,0,421,0,0,421,306,310
306,311,1293,1481,1349,816,0,4939,306,311
306,313,459,0,0,0,0,459,306,313
306,314,741,0,978,0,0,1719,306,314
306,322,0,0,879,0,0,879,306,322
307,1,0,0,773,0,0,773,307,1
307,2,0,0,0,300,0,300,307,2
307,14,0,0,325,0,0,325,307,14
307,16,0,0,706,0,0,706,307,16
307,18,0,0,613,0,0,613,307,18
307,25,0,0,301,0,0,301,307,25
307,27,0,0,1536,0,0,1536,307,27
307,28,0,0,298,0,0,298,307,28
307,32,0,0,649,0,0,649,307,32
307,36,0,0,875,0,0,875,307,36
307,49,0,0,0,710,0,710,307,49
307,51,0,0,282,0,0,282,307,51
307,54,0,0,325,0,0,325,307,54
307,59,0,0,325,0,0,325,307,59
307,61,0,0,768,0,0,768,307,61
307,62,0,0,298,0,0,298,307,62
307,63,0,0,712,0,0,712,307,63
307,65,0,0,325,0,0,325,307,65
307,66,0,0,768,0,0,768,307,66
307,67,0,0,1369,0,0,1369,307,67
307,68,0,0,327,0,0,327,307,68
307,69,0,0,325,0,0,325,307,69
307,70,0,0,325,0,0,325,307,70
307,72,0,0,0,613,0,613,307,72
307,73,0,0,325,0,0,325,307,73
307,77,0,0,325,0,0,325,307,77
307,78,0,0,768,0,0,768,307,78
307,79,0,0,1665,277,0,1942,307,79
307,80,0,0,327,0,0,327,307,80
307,82,0,0,1071,0,0,1071,307,82
307,84,0,0,298,0,0,298,307,84
307,91,0,0,28,0,0,28,307,91
307,96,0,0,367,0,0,367,307,96
307,106,0,0,341,0,0,341,307,106
307,107,0,0,367,0,0,367,307,107
307,110,0,0,325,0,0,325,307,110
307,123,300,0,0,0,0,300,307,123
307,162,0,0,325,0,0,325,307,162
307,165,0,0,298,0,0,298,307,165
307,167,0,0,298,0,0,298,307,167
307,230,0,0,327,0,0,327,307,230
307,268,0,0,325,0,0,325,307,268
307,269,706,0,1419,0,0,2125,307,269
307,271,0,0,325,0,0,325,307,271
307,273,0,0,768,0,0,768,307,273
307,274,0,0,173,0,0,173,307,274
307,275,0,0,325,0,0,325,307,275
307,277,0,0,773,0,0,773,307,277
307,280,0,0,768,0,0,768,307,280
307,281,298,0,325,0,0,623,307,281
307,282,26,0,0,0,0,26,307,282
307,286,0,0,327,0,0,327,307,286
307,287,0,0,325,0,0,325,307,287
307,288,0,0,347,0,0,347,307,288
307,289,0,0,327,0,0,327,307,289
307,298,310,0,0,0,0,310,307,298
307,300,0,0,625,0,0,625,307,300
307,301,0,0,0,1531,0,1531,307,301
307,302,0,0,3366,298,0,3664,307,302
307,303,706,0,4052,1340,0,6098,307,303
307,304,599,0,325,0,0,924,307,304
307,305,670,0,3100,0,0,3770,307,305
307,306,0,0,458,298,0,756,307,306
307,307,4695,49679,4208,12436,0,71018,307,307
307,308,2017,180,4358,521,0,7076,307,308
307,309,0,0,325,174,0,499,307,309
307,310,1929,0,325,0,0,2254,307,310
307,311,0,0,1976,0,0,1976,307,311
307,312,0,0,82,0,0,82,307,312
307,313,0,0,712,0,0,712,307,313
307,314,298,0,651,0,0,949,307,314
307,315,0,0,1092,0,0,1092,307,315
307,317,0,0,0,710,0,710,307,317
307,318,0,0,651,0,0,651,307,318
307,319,0,0,325,0,0,325,307,319
307,321,0,0,623,0,0,623,307,321
307,323,298,0,0,0,0,298,307,323
307,325,0,0,1055,0,0,1055,307,325
307,326,0,0,327,0,0,327,307,326
307,329,0,0,773,0,0,773,307,329
307,336,0,0,0,300,0,300,307,336
307,339,0,0,0,154,0,154,307,339
307,340,0,0,259,0,0,259,307,340
308,17,0,0,245,0,0,245,308,17
308,45,240,0,0,0,0,240,308,45
308,51,0,0,220,0,0,220,308,51
308,61,0,0,560,0,0,560,308,61
308,63,0,0,440,0,0,440,308,63
308,65,0,0,391,0,0,391,308,65
308,66,0,0,220,0,0,220,308,66
308,68,0,0,220,0,0,220,308,68
308,69,0,0,535,0,0,535,308,69
308,70,0,0,245,0,0,245,308,70
308,73,0,0,220,0,0,220,308,73
308,77,0,0,391,0,0,391,308,77
308,79,0,0,360,0,0,360,308,79
308,83,0,0,202,0,0,202,308,83
308,91,0,0,0,202,0,202,308,91
308,93,0,0,249,0,0,249,308,93
308,97,0,0,220,0,0,220,308,97
308,282,0,0,465,0,0,465,308,282
308,287,106,0,0,0,0,106,308,287
308,296,0,0,0,15,0,15,308,296
308,300,0,0,391,0,0,391,308,300
308,302,202,0,245,0,0,447,308,302
308,303,0,0,1552,0,0,1552,308,303
308,304,0,0,751,0,0,751,308,304
308,305,570,0,0,0,0,570,308,305
308,306,944,0,0,1642,0,2586,308,306
308,307,2017,180,4358,521,0,7076,308,307
308,308,0,26511,440,2661,0,29612,308,308
308,309,0,1185,166,174,0,1525,308,309
308,310,387,0,220,0,0,607,308,310
308,311,0,4276,1266,1595,0,7137,308,311
308,312,0,0,391,0,0,391,308,312
308,315,360,0,0,0,0,360,308,315
308,319,0,0,220,0,0,220,308,319
308,336,0,0,220,0,0,220,308,336
309,2,0,0,645,0,0,645,309,2
309,4,382,0,166,0,0,548,309,4
309,5,0,0,427,0,0,427,309,5
309,6,0,0,229,0,0,229,309,6
309,28,0,0,176,0,0,176,309,28
309,34,0,0,153,0,0,153,309,34
309,54,0,0,166,0,0,166,309,54
309,58,0,0,166,0,0,166,309,58
309,63,0,0,332,0,0,332,309,63
309,64,0,0,631,0,0,631,309,64
309,65,0,0,985,0,0,985,309,65
309,66,0,0,332,162,0,494,309,66
309,68,0,0,1001,0,0,1001,309,68
309,69,0,0,176,0,0,176,309,69
309,71,0,0,166,0,0,166,309,71
309,73,0,0,575,0,0,575,309,73
309,76,0,0,631,0,0,631,309,76
309,80,0,0,162,174,0,336,309,80
309,81,0,0,797,153,0,950,309,81
309,83,0,0,153,0,0,153,309,83
309,100,0,0,153,0,0,153,309,100
309,102,0,0,162,0,0,162,309,102
309,106,0,0,162,0,0,162,309,106
309,156,0,0,427,0,0,427,309,156
309,162,153,0,0,0,0,153,309,162
309,168,0,0,153,0,0,153,309,168
309,238,0,0,249,0,0,249,309,238
309,239,0,0,249,0,0,249,309,239
309,268,0,0,166,0,0,166,309,268
309,269,0,0,187,0,0,187,309,269
309,271,153,0,166,0,0,319,309,271
309,272,153,0,0,0,0,153,309,272
309,274,0,0,784,0,0,784,309,274
309,276,0,0,493,0,0,493,309,276
309,277,0,0,465,0,0,465,309,277
309,280,0,0,166,0,0,166,309,280
309,286,0,0,758,487,0,1245,309,286
309,287,324,0,176,0,0,500,309,287
309,290,0,0,465,0,0,465,309,290
309,293,0,0,714,0,0,714,309,293
309,300,305,0,946,0,0,1251,309,300
309,301,0,0,958,153,0,1111,309,301
309,302,1811,0,319,475,0,2605,309,302
309,303,0,0,532,606,0,1138,309,303
309,304,0,0,342,162,0,504,309,304
309,305,0,0,249,0,0,249,309,305
309,306,0,0,363,0,0,363,309,306
309,307,0,0,325,174,0,499,309,307
309,308,0,1011,166,348,0,1525,309,308
309,309,1222,16709,1183,4843,0,23957,309,309
309,310,0,0,1569,0,0,1569,309,310
309,311,0,0,1976,167,0,2143,309,311
309,312,906,0,1173,0,0,2079,309,312
309,313,427,0,1124,174,0,1725,309,313
309,314,1495,3874,2581,3124,0,11074,309,314
309,315,427,0,1139,190,0,1756,309,315
309,319,0,0,465,0,0,465,309,319
309,323,0,0,353,0,0,353,309,323
309,324,0,0,465,0,0,465,309,324
309,325,0,0,249,0,0,249,309,325
309,328,0,0,342,0,0,342,309,328
310,36,0,0,885,0,0,885,310,36
310,54,0,0,278,0,0,278,310,54
310,71,0,0,282,0,0,282,310,71
310,72,0,0,139,0,0,139,310,72
310,77,0,0,259,0,0,259,310,77
310,82,0,0,0,33,0,33,310,82
310,93,0,0,259,0,0,259,310,93
310,167,0,0,81,0,0,81,310,167
310,244,0,0,139,0,0,139,310,244
310,250,255,0,0,0,0,255,310,250
310,280,0,0,282,0,0,282,310,280
310,281,0,0,282,0,0,282,310,281
310,300,0,0,595,813,0,1408,310,300
310,301,0,0,80,0,0,80,310,301
310,303,0,0,318,0,0,318,310,303
310,305,0,259,142,0,0,401,310,305
310,306,0,0,421,0,0,421,310,306
310,307,1929,0,325,0,0,2254,310,307
310,308,259,0,359,0,0,618,310,308
310,309,0,0,1569,0,0,1569,310,309
310,310,0,6743,489,288,0,7520,310,310
310,311,0,1740,579,190,0,2509,310,311
310,312,518,0,139,497,0,1154,310,312
310,313,1003,1339,0,813,0,3155,310,313
310,314,1178,128,748,0,0,2054,310,314
310,315,0,0,350,0,0,350,310,315
310,322,0,0,282,0,0,282,310,322
310,329,0,0,139,0,0,139,310,329
310,331,0,0,0,669,0,669,310,331
310,340,0,0,318,0,0,318,310,340
311,2,0,0,1546,0,0,1546,311,2
311,3,0,0,806,0,0,806,311,3
311,4,0,0,554,0,0,554,311,4
311,7,0,0,740,0,0,740,311,7
311,21,110,0,0,0,0,110,311,21
311,22,0,0,554,0,0,554,311,22
311,27,0,0,477,0,0,477,311,27
311,28,0,0,806,0,0,806,311,28
311,29,0,0,806,0,0,806,311,29
311,30,740,0,509,0,0,1249,311,30
311,51,0,0,438,0,0,438,311,51
311,53,0,0,462,0,0,462,311,53
311,54,0,0,462,0,0,462,311,54
311,56,0,0,462,0,0,462,311,56
311,59,0,0,0,438,0,438,311,59
311,60,0,0,942,0,0,942,311,60
311,62,0,0,462,0,0,462,311,62
311,63,0,0,477,0,0,477,311,63
311,64,0,0,1569,0,0,1569,311,64
311,65,0,0,81,0,0,81,311,65
311,66,95,0,0,0,0,95,311,66
311,68,0,0,0,1165,0,1165,311,68
311,71,0,0,912,0,0,912,311,71
311,73,740,0,1268,438,0,2446,311,73
311,74,0,0,896,0,0,896,311,74
311,77,0,0,0,740,0,740,311,77
311,81,0,0,554,0,0,554,311,81
311,82,0,0,1282,0,0,1282,311,82
311,96,0,0,912,0,0,912,311,96
311,102,49,0,0,0,0,49,311,102
311,106,0,0,0,84,0,84,311,106
311,131,0,0,143,0,0,143,311,131
311,227,0,0,740,0,0,740,311,227
311,268,0,0,360,0,0,360,311,268
311,277,3651,0,0,0,0,3651,311,277
311,285,0,0,533,0,0,533,311,285
311,286,29,0,2243,0,0,2272,311,286
311,287,0,0,0,764,0,764,311,287
311,288,0,0,88,0,0,88,311,288
311,293,0,0,831,0,0,831,311,293
311,300,0,0,1103,81,0,1184,311,300
311,301,0,0,2067,0,0,2067,311,301
311,302,143,0,1424,425,0,1992,311,302
311,303,0,0,5421,764,0,6185,311,303
311,304,824,0,879,415,0,2118,311,304
311,305,675,1772,0,0,0,2447,311,305
311,306,1454,1481,4216,735,0,7886,311,306
311,307,0,0,1976,0,0,1976,311,307
311,308,0,2794,1266,1347,0,5407,311,308
311,309,427,0,1976,167,0,2570,311,309
311,310,0,1740,667,190,0,2597,311,310
311,311,8342,44941,4608,10128,0,68019,311,311
311,312,1527,995,0,991,0,3513,311,312
311,313,84,651,88,365,0,1188,311,313
311,314,1505,0,1146,0,0,2651,311,314
311,318,0,0,912,0,0,912,311,318
311,321,0,0,477,0,0,477,311,321
311,322,0,0,806,0,0,806,311,322
311,328,0,0,0,764,0,764,311,328
311,336,0,0,181,0,0,181,311,336
312,1,517,0,161,0,0,678,312,1
312,6,0,0,494,0,0,494,312,6
312,20,0,0,82,0,0,82,312,20
312,25,0,0,294,0,0,294,312,25
312,28,0,0,281,0,0,281,312,28
312,29,0,0,281,0,0,281,312,29
312,49,74,0,0,0,0,74,312,49
312,56,0,0,281,0,0,281,312,56
312,61,0,0,141,0,0,141,312,61
312,66,0,0,541,0,0,541,312,66
312,68,0,0,436,0,0,436,312,68
312,71,0,0,155,0,0,155,312,71
312,72,0,0,85,0,0,85,312,72
312,73,0,0,281,0,0,281,312,73
312,74,0,0,154,0,0,154,312,74
312,78,141,0,584,0,0,725,312,78
312,79,0,0,279,0,0,279,312,79
312,82,0,0,30,0,0,30,312,82
312,83,0,0,0,155,0,155,312,83
312,106,155,0,0,0,0,155,312,106
312,150,0,0,540,0,0,540,312,150
312,165,32,0,0,0,0,32,312,165
312,168,0,0,155,0,0,155,312,168
312,170,0,0,143,0,0,143,312,170
312,174,0,0,257,0,0,257,312,174
312,181,0,0,0,23,0,23,312,181
312,271,155,0,279,0,0,434,312,271
312,272,136,0,0,0,0,136,312,272
312,274,0,0,272,0,0,272,312,274
312,277,642,0,0,0,0,642,312,277
312,278,395,0,0,0,0,395,312,278
312,280,259,0,437,0,0,696,312,280
312,281,0,0,292,0,0,292,312,281
312,294,0,0,467,0,0,467,312,294
312,300,0,0,1279,274,0,1553,312,300
312,301,0,0,541,0,0,541,312,301
312,302,0,0,992,274,0,1266,312,302
312,303,285,0,754,0,0,1039,312,303
312,304,2500,4527,641,2667,0,10335,312,304
312,305,831,642,1226,932,0,3631,312,305
312,307,300,0,0,0,0,300,312,307
312,308,0,0,391,0,0,391,312,308
312,309,906,0,1349,0,0,2255,312,309
312,310,259,0,139,497,0,895,312,310
312,311,1527,995,477,991,0,3990,312,311
312,312,7009,14514,1716,1317,0,24556,312,312
312,313,497,1518,250,775,0,3040,312,313
312,314,2984,2626,3217,3227,0,12054,312,314
312,315,643,1702,1929,902,0,5176,312,315
312,318,259,0,112,0,0,371,312,318
312,322,0,0,155,0,0,155,312,322
312,323,2523,0,729,615,0,3867,312,323
312,324,478,0,0,0,0,478,312,324
312,325,22,0,202,0,0,224,312,325
312,326,0,0,459,0,0,459,312,326
312,330,0,0,215,0,0,215,312,330
312,338,0,0,653,0,0,653,312,338
313,5,230,0,0,0,0,230,313,5
313,7,0,0,114,0,0,114,313,7
313,29,0,0,108,0,0,108,313,29
313,32,0,0,250,0,0,250,313,32
313,48,0,0,108,0,0,108,313,48
313,63,0,0,108,0,0,108,313,63
313,64,0,0,458,0,0,458,313,64
313,65,0,0,197,0,0,197,313,65
313,66,0,0,458,0,0,458,313,66
313,68,0,0,357,0,0,357,313,68
313,69,0,0,250,0,0,250,313,69
313,70,0,0,114,0,0,114,313,70
313,73,0,0,587,0,0,587,313,73
313,79,0,0,459,0,0,459,313,79
313,80,0,0,250,0,0,250,313,80
313,81,0,0,337,0,0,337,313,81
313,82,0,0,724,0,0,724,313,82
313,95,0,0,0,421,0,421,313,95
313,99,0,0,0,421,0,421,313,99
313,119,230,0,0,0,0,230,313,119
313,180,0,0,353,0,0,353,313,180
313,209,230,0,0,0,0,230,313,209
313,269,0,0,250,0,0,250,313,269
313,275,0,0,421,0,0,421,313,275
313,277,0,0,108,0,0,108,313,277
313,280,0,0,0,99,0,99,313,280
313,286,0,0,250,0,0,250,313,286
313,287,0,0,112,0,0,112,313,287
313,289,0,0,122,0,0,122,313,289
313,293,0,0,114,0,0,114,313,293
313,298,0,0,250,0,0,250,313,298
313,300,575,0,820,0,0,1395,313,300
313,303,230,0,806,230,0,1266,313,303
313,304,230,0,0,0,0,230,313,304
313,305,0,202,604,0,0,806,313,305
313,306,230,0,0,0,0,230,313,306
313,307,0,0,712,0,0,712,313,307
313,309,0,0,659,174,0,833,313,309
313,310,1003,1339,0,813,0,3155,313,310
313,311,511,651,88,365,0,1615,313,311
313,312,497,1289,250,775,0,2811,313,312
313,313,1365,12864,0,1656,0,15885,313,313
313,314,3528,494,465,257,0,4744,313,314
313,315,0,828,1144,321,0,2293,313,315
313,324,0,0,250,0,0,250,313,324
313,325,0,0,260,0,0,260,313,325
314,1,0,0,424,0,0,424,314,1
314,6,0,0,298,0,0,298,314,6
314,18,0,0,1282,0,0,1282,314,18
314,27,0,0,1159,0,0,1159,314,27
314,29,0,0,279,0,0,279,314,29
314,31,0,0,724,0,0,724,314,31
314,35,0,0,724,0,0,724,314,35
314,37,0,0,0,527,0,527,314,37
314,57,0,0,978,0,0,978,314,57
314,63,0,0,978,0,0,978,314,63
314,65,0,0,573,0,0,573,314,65
314,68,0,0,788,0,0,788,314,68
314,69,0,0,527,0,0,527,314,69
314,70,0,0,43,0,0,43,314,70
314,71,0,0,724,899,0,1623,314,71
314,73,899,0,1282,0,0,2181,314,73
314,79,0,0,21,0,0,21,314,79
314,81,0,0,1361,0,0,1361,314,81
314,83,0,0,424,0,0,424,314,83
314,85,899,0,0,0,0,899,314,85
314,95,102,0,0,0,0,102,314,95
314,136,0,0,0,90,0,90,314,136
314,151,0,0,899,0,0,899,314,151
314,163,238,0,0,0,0,238,314,163
314,247,0,0,2006,0,0,2006,314,247
314,269,527,0,561,0,0,1088,314,269
314,270,0,0,586,0,0,586,314,270
314,280,0,0,16,0,0,16,314,280
314,281,0,0,16,0,0,16,314,281
314,286,257,0,279,0,0,536,314,286
314,291,0,0,604,0,0,604,314,291
314,300,899,0,3332,0,0,4231,314,300
314,301,0,0,481,0,0,481,314,301
314,302,0,0,2944,0,0,2944,314,302
314,303,0,0,4034,0,0,4034,314,303
314,304,1966,0,3055,845,0,5866,314,304
314,305,0,0,978,0,0,978,314,305
314,306,971,0,978,0,0,1949,314,306
314,307,298,0,327,0,0,625,314,307
314,309,2018,3874,4106,1988,0,11986,314,309
314,310,1198,0,398,449,0,2045,314,310
314,311,1505,0,1636,740,0,3881,314,311
314,312,2237,2354,4213,3227,0,12031,314,312
314,313,3299,494,0,487,0,4280,314,313
314,314,775,57833,9771,9256,0,77635,314,314
314,315,1330,3972,3583,1686,0,10571,314,315
314,318,0,0,788,0,0,788,314,318
314,321,111,0,2743,0,0,2854,314,321
314,322,0,0,1551,0,0,1551,314,322
314,324,0,0,2911,1303,0,4214,314,324
314,325,0,0,788,0,0,788,314,325
314,326,0,0,0,595,0,595,314,326
314,328,0,0,122,0,0,122,314,328
314,334,0,0,88,0,0,88,314,334
314,339,0,0,0,162,0,162,314,339
314,340,0,0,573,0,0,573,314,340
315,1,0,0,185,0,0,185,315,1
315,2,0,0,378,0,0,378,315,2
315,5,0,0,181,0,0,181,315,5
315,6,0,0,321,0,0,321,315,6
315,11,669,0,0,0,0,669,315,11
315,12,0,0,856,0,0,856,315,12
315,23,0,0,786,0,0,786,315,23
315,27,0,0,721,0,0,721,315,27
315,28,0,0,185,0,0,185,315,28
315,29,185,0,625,0,0,810,315,29
315,31,0,0,185,0,0,185,315,31
315,32,0,0,678,0,0,678,315,32
315,34,0,0,185,30,0,215,315,34
315,35,0,0,196,0,0,196,315,35
315,51,0,0,321,0,0,321,315,51
315,54,0,0,350,0,0,350,315,54
315,56,0,0,699,0,0,699,315,56
315,58,0,0,202,0,0,202,315,58
315,61,0,0,218,0,0,218,315,61
315,64,0,0,202,0,0,202,315,64
315,65,0,0,1119,0,0,1119,315,65
315,66,0,0,539,0,0,539,315,66
315,67,898,0,0,0,0,898,315,67
315,68,321,0,734,643,0,1698,315,68
315,70,0,0,539,0,0,539,315,70
315,71,0,0,682,0,0,682,315,71
315,73,0,0,1395,0,0,1395,315,73
315,76,0,0,378,0,0,378,315,76
315,78,185,0,0,185,0,370,315,78
315,79,0,0,592,0,0,592,315,79
315,80,348,0,0,0,0,348,315,80
315,81,377,0,1448,0,0,1825,315,81
315,82,0,0,1021,0,0,1021,315,82
315,86,0,0,200,0,0,200,315,86
315,91,185,0,0,0,0,185,315,91
315,95,0,0,350,0,0,350,315,95
315,100,0,0,202,185,0,387,315,100
315,106,0,0,185,0,0,185,315,106
315,130,0,0,0,185,0,185,315,130
315,187,0,0,242,0,0,242,315,187
315,231,0,0,200,0,0,200,315,231
315,247,185,0,0,0,0,185,315,247
315,269,0,0,976,0,0,976,315,269
315,270,0,0,0,348,0,348,315,270
315,272,0,0,218,0,0,218,315,272
315,273,0,0,347,0,0,347,315,273
315,274,0,0,202,0,0,202,315,274
315,275,0,0,1147,0,0,1147,315,275
315,278,0,0,348,0,0,348,315,278
315,280,0,0,912,0,0,912,315,280
315,281,0,0,185,0,0,185,315,281
315,283,0,0,200,0,0,200,315,283
315,286,181,0,658,185,0,1024,315,286
315,288,0,0,321,0,0,321,315,288
315,296,30,0,0,0,0,30,315,296
315,298,0,0,350,0,0,350,315,298
315,300,321,0,2345,0,0,2666,315,300
315,301,0,0,507,0,0,507,315,301
315,302,0,0,1225,0,0,1225,315,302
315,303,29,0,1033,651,0,1713,315,303
315,304,912,0,2615,330,0,3857,315,304
315,305,0,202,402,200,0,804,315,305
315,307,0,0,1092,0,0,1092,315,307
315,308,360,0,0,0,0,360,315,308
315,309,427,0,1346,0,0,1773,315,309
315,310,0,0,350,0,0,350,315,310
315,312,964,1702,1929,702,0,5297,315,312
315,313,0,507,1494,321,0,2322,315,313
315,314,1558,3782,3381,1969,0,10690,315,314
315,315,7451,65965,5130,8753,0,87299,315,315
315,316,0,0,568,0,0,568,315,316
315,319,181,0,901,0,0,1082,315,319
315,321,332,0,736,0,0,1068,315,321
315,322,0,321,679,0,269,1269,315,322
315,323,0,330,403,0,0,733,315,323
315,324,604,3587,4983,162,0,9336,315,324
315,325,0,0,1315,0,0,1315,315,325
315,326,257,0,202,0,0,459,315,326
315,329,0,0,588,0,0,588,315,329
315,334,0,0,218,0,0,218,315,334
315,338,0,0,200,0,0,200,315,338
315,339,0,0,664,0,0,664,315,339
316,1,0,0,103,0,0,103,316,1
316,2,0,0,72,0,0,72,316,2
316,5,44,0,0,0,0,44,316,5
316,6,87,0,0,0,0,87,316,6
316,18,44,0,0,0,0,44,316,18
316,23,53,0,0,0,0,53,316,23
316,24,0,0,144,0,0,144,316,24
316,25,0,0,81,0,0,81,316,25
316,26,0,0,94,0,0,94,316,26
316,28,49,0,46,0,0,95,316,28
316,29,188,0,0,0,0,188,316,29
316,30,64,0,0,0,0,64,316,30
316,31,235,0,479,0,0,714,316,31
316,32,87,0,93,0,165,345,316,32
316,35,0,0,99,0,0,99,316,35
316,49,44,0,0,88,0,132,316,49
316,52,0,0,208,0,0,208,316,52
316,54,72,0,0,0,0,72,316,54
316,55,14,0,173,0,0,187,316,55
316,56,0,0,0,94,0,94,316,56
316,57,72,0,0,0,0,72,316,57
316,58,306,0,0,0,0,306,316,58
316,59,0,0,174,0,0,174,316,59
316,64,327,0,0,0,0,327,316,64
316,65,0,0,78,0,0,78,316,65
316,66,0,0,95,0,0,95,316,66
316,68,190,0,0,144,0,334,316,68
316,69,116,0,0,0,0,116,316,69
316,70,94,0,0,0,0,94,316,70
316,71,0,0,78,0,0,78,316,71
316,72,44,0,0,89,0,133,316,72
316,73,352,0,0,0,0,352,316,73
316,74,0,0,95,0,0,95,316,74
316,75,72,0,0,0,0,72,316,75
316,77,0,0,124,0,0,124,316,77
316,78,72,0,48,0,0,120,316,78
316,79,72,0,95,0,0,167,316,79
316,80,88,0,21,0,0,109,316,80
316,81,477,0,157,172,0,806,316,81
316,82,72,0,383,72,0,527,316,82
316,83,0,0,49,0,0,49,316,83
316,84,0,0,103,0,0,103,316,84
316,88,101,0,0,0,0,101,316,88
316,89,189,0,0,0,0,189,316,89
316,92,72,0,0,0,0,72,316,92
316,93,0,0,0,72,0,72,316,93
316,94,72,0,0,0,0,72,316,94
316,99,0,0,72,0,0,72,316,99
316,100,0,0,0,53,0,53,316,100
316,101,0,0,0,87,0,87,316,101
316,103,0,0,6,0,0,6,316,103
316,104,18,0,0,0,0,18,316,104
316,105,257,0,0,0,0,257,316,105
316,106,72,0,0,0,0,72,316,106
316,107,239,0,95,0,0,334,316,107
316,113,303,0,0,0,0,303,316,113
316,125,0,0,0,528,0,528,316,125
316,135,0,0,53,0,0,53,316,135
316,136,87,0,0,0,0,87,316,136
316,138,0,0,87,0,0,87,316,138
316,152,0,0,94,0,0,94,316,152
316,153,0,0,73,0,0,73,316,153
316,164,174,0,0,0,0,174,316,164
316,167,158,0,227,0,0,385,316,167
316,182,0,0,439,0,0,439,316,182
316,219,60,0,0,0,0,60,316,219
316,236,88,0,0,0,0,88,316,236
316,250,108,0,0,0,0,108,316,250
316,265,0,0,72,0,0,72,316,265
316,268,109,0,0,0,0,109,316,268
316,269,120,0,0,0,0,120,316,269
316,271,72,0,0,0,0,72,316,271
316,273,72,0,0,0,0,72,316,273
316,275,0,0,72,0,0,72,316,275
316,280,165,0,0,0,0,165,316,280
316,288,480,0,0,0,0,480,316,288
316,300,430,0,443,44,0,917,316,300
316,301,72,0,0,0,0,72,316,301
316,302,0,0,0,145,0,145,316,302
316,303,72,0,94,0,0,166,316,303
316,304,0,0,0,202,0,202,316,304
316,305,72,0,0,88,0,160,316,305
316,315,0,0,568,0,0,568,316,315
316,316,2560,2117,0,806,0,5483,316,316
316,317,137,62,0,0,0,199,316,317
316,318,72,133,397,0,0,602,316,318
316,319,816,0,103,109,137,1165,316,319
316,320,1478,797,207,0,0,2482,316,320
316,321,897,0,0,0,0,897,316,321
316,322,1921,0,0,54,0,1975,316,322
316,323,0,0,239,0,0,239,316,323
316,325,1807,0,0,0,0,1807,316,325
316,327,49,254,25,72,0,400,316,327
316,328,547,0,253,94,0,894,316,328
316,329,2375,133,225,478,809,4020,316,329
316,330,421,0,78,0,0,499,316,330
316,331,0,0,325,120,0,445,316,331
316,334,0,0,0,110,0,110,316,334
316,338,32,0,0,0,0,32,316,338
316,339,53,0,124,94,0,271,316,339
316,340,85,56,0,0,0,141,316,340
316,341,253,932,0,398,0,1583,316,341
316,342,373,0,0,110,0,483,316,342
317,2,14,0,0,0,0,14,317,2
317,4,15,0,0,0,0,15,317,4
317,5,52,0,0,0,0,52,317,5
317,7,0,0,21,0,0,21,317,7
317,11,7,0,0,0,0,7,317,11
317,18,263,0,0,0,0,263,317,18
317,19,14,0,0,0,0,14,317,19
317,23,0,0,14,0,0,14,317,23
317,24,0,0,29,0,0,29,317,24
317,27,36,0,0,0,0,36,317,27
317,29,7,0,15,22,0,44,317,29
317,30,7,0,0,0,0,7,317,30
317,31,15,0,28,0,0,43,317,31
317,32,28,0,0,0,0,28,317,32
317,34,39,0,0,29,0,68,317,34
317,36,69,0,0,0,0,69,317,36
317,43,0,0,28,0,0,28,317,43
317,50,0,0,28,0,0,28,317,50
317,51,104,0,0,0,0,104,317,51
317,53,21,0,0,0,0,21,317,53
317,54,37,0,0,0,0,37,317,54
317,58,0,0,0,14,0,14,317,58
317,59,48,0,0,0,0,48,317,59
317,63,50,0,0,0,0,50,317,63
317,64,63,0,0,140,0,203,317,64
317,65,93,0,0,116,0,209,317,65
317,67,14,0,0,0,0,14,317,67
317,68,212,15,132,57,0,416,317,68
317,69,0,0,125,14,0,139,317,69
317,70,172,0,0,42,0,214,317,70
317,71,14,0,0,20,0,34,317,71
317,72,14,0,0,0,0,14,317,72
317,73,121,0,0,29,0,150,317,73
317,74,14,0,0,0,0,14,317,74
317,76,53,0,16,0,0,69,317,76
317,78,35,0,118,0,0,153,317,78
317,79,43,0,62,0,0,105,317,79
317,80,43,0,0,0,0,43,317,80
317,81,276,0,0,14,0,290,317,81
317,82,72,301,24,28,0,425,317,82
317,83,166,0,55,0,0,221,317,83
317,84,0,0,31,14,0,45,317,84
317,85,47,0,0,0,0,47,317,85
317,89,35,0,0,0,0,35,317,89
317,90,7,0,0,0,0,7,317,90
317,92,0,0,14,0,0,14,317,92
317,93,0,0,31,0,0,31,317,93
317,95,28,0,0,0,0,28,317,95
317,96,80,0,0,0,0,80,317,96
317,99,7,0,0,0,0,7,317,99
317,100,0,0,365,0,0,365,317,100
317,101,0,0,83,0,0,83,317,101
317,102,128,0,0,0,0,128,317,102
317,103,0,0,10,0,0,10,317,103
317,104,9,0,0,0,0,9,317,104
317,105,119,0,0,0,0,119,317,105
317,107,99,0,0,0,0,99,317,107
317,118,14,0,0,0,0,14,317,118
317,131,11,0,0,0,0,11,317,131
317,154,0,0,0,226,0,226,317,154
317,165,14,0,0,0,0,14,317,165
317,169,42,0,0,0,0,42,317,169
317,191,0,0,28,0,0,28,317,191
317,200,0,0,109,0,0,109,317,200
317,211,0,0,623,0,0,623,317,211
317,228,455,0,0,0,0,455,317,228
317,229,0,0,398,0,0,398,317,229
317,241,14,0,0,0,0,14,317,241
317,268,36,0,0,0,0,36,317,268
317,269,0,0,40,0,0,40,317,269
317,274,0,0,15,0,0,15,317,274
317,275,14,0,0,0,0,14,317,275
317,278,265,0,0,0,0,265,317,278
317,281,0,0,545,0,0,545,317,281
317,290,0,0,647,0,0,647,317,290
317,295,0,0,531,0,0,531,317,295
317,298,0,0,579,0,0,579,317,298
317,300,92,0,0,0,0,92,317,300
317,301,15,0,74,0,0,89,317,301
317,302,0,0,15,0,0,15,317,302
317,303,0,0,0,250,20,270,317,303
317,307,0,0,0,710,0,710,317,307
317,316,137,62,0,0,0,199,317,316
317,317,444,290,0,0,0,734,317,317
317,318,784,14,105,0,0,903,317,318
317,319,289,0,15,0,0,304,317,319
317,320,28,0,0,0,0,28,317,320
317,321,111,0,0,0,0,111,317,321
317,322,105,0,0,28,0,133,317,322
317,325,14,0,0,0,0,14,317,325
317,327,109,0,0,0,0,109,317,327
317,328,226,0,0,0,0,226,317,328
317,329,371,0,8,0,0,379,317,329
317,331,210,0,0,0,0,210,317,331
317,334,55,0,16,0,0,71,317,334
317,335,0,0,323,0,0,323,317,335
317,337,0,0,15,0,0,15,317,337
317,339,58,0,46,0,20,124,317,339
317,340,85,80,15,0,0,180,317,340
317,341,146,0,0,29,0,175,317,341
317,342,21,0,0,0,0,21,317,342
318,1,0,0,201,0,0,201,318,1
318,2,0,0,158,0,0,158,318,2
318,4,150,0,0,0,0,150,318,4
318,5,0,0,112,0,0,112,318,5
318,19,0,0,110,0,0,110,318,19
318,26,0,0,152,0,0,152,318,26
318,27,158,0,110,437,0,705,318,27
318,29,0,0,635,0,0,635,318,29
318,31,0,0,124,0,0,124,318,31
318,32,0,0,205,0,0,205,318,32
318,36,184,0,101,0,0,285,318,36
318,44,0,0,152,0,0,152,318,44
318,45,166,0,0,0,0,166,318,45
318,51,104,0,0,0,0,104,318,51
318,53,58,0,144,0,0,202,318,53
318,54,0,0,101,0,0,101,318,54
318,55,49,0,0,0,0,49,318,55
318,60,103,0,0,0,0,103,318,60
318,63,0,0,0,103,0,103,318,63
318,64,126,0,43,0,0,169,318,64
318,65,0,0,586,0,0,586,318,65
318,67,0,0,67,0,0,67,318,67
318,68,560,0,112,317,0,989,318,68
318,70,172,0,135,101,0,408,318,70
318,71,207,0,112,0,0,319,318,71
318,72,192,0,110,700,0,1002,318,72
318,73,204,0,335,103,0,642,318,73
318,75,0,0,59,0,0,59,318,75
318,76,0,0,0,103,0,103,318,76
318,79,41,0,175,0,0,216,318,79
318,80,413,0,0,0,0,413,318,80
318,81,111,0,272,103,0,486,318,81
318,82,0,0,247,141,0,388,318,82
318,84,0,0,26,0,0,26,318,84
318,85,24,0,0,0,0,24,318,85
318,95,0,0,112,0,0,112,318,95
318,96,0,0,112,0,0,112,318,96
318,104,0,0,26,0,0,26,318,104
318,106,158,0,0,0,0,158,318,106
318,113,105,0,0,0,0,105,318,113
318,123,0,0,103,0,0,103,318,123
318,129,0,0,45,0,0,45,318,129
318,162,62,0,0,0,0,62,318,162
318,166,103,0,0,0,0,103,318,166
318,167,0,0,110,0,0,110,318,167
318,186,0,0,73,0,0,73,318,186
318,208,0,0,268,0,0,268,318,208
318,243,0,0,570,0,0,570,318,243
318,251,0,0,0,40,0,40,318,251
318,268,692,0,0,695,0,1387,318,268
318,269,300,0,0,0,0,300,318,269
318,270,108,0,0,0,0,108,318,270
318,274,434,0,0,0,0,434,318,274
318,275,378,0,0,0,0,378,318,275
318,276,0,0,0,731,0,731,318,276
318,277,158,0,0,0,0,158,318,277
318,279,0,0,774,0,0,774,318,279
318,280,103,0,110,0,0,213,318,280
318,282,1110,0,0,0,0,1110,318,282
318,286,0,0,0,103,0,103,318,286
318,298,0,0,371,0,0,371,318,298
318,300,1468,0,912,103,0,2483,318,300
318,301,348,0,112,0,0,460,318,301
318,302,0,0,395,0,0,395,318,302
318,303,103,0,201,0,0,304,318,303
318,304,103,0,0,40,0,143,318,304
318,305,0,0,359,0,0,359,318,305
318,307,0,0,651,0,0,651,318,307
318,311,0,0,912,0,0,912,318,311
318,312,0,0,112,0,0,112,318,312
318,314,0,0,788,0,0,788,318,314
318,316,72,133,397,0,0,602,318,316
318,317,670,14,97,0,0,781,318,317
318,318,0,10641,225,0,0,10866,318,318
318,319,240,0,112,593,0,945,318,319
318,320,660,190,411,250,0,1511,318,320
318,321,427,0,0,0,0,427,318,321
318,322,27,0,127,24,0,178,318,322
318,323,0,0,112,0,0,112,318,323
318,324,0,0,112,0,0,112,318,324
318,325,0,0,1006,0,0,1006,318,325
318,327,211,0,311,27,0,549,318,327
318,328,0,0,543,0,0,543,318,328
318,329,1929,0,0,7,0,1936,318,329
318,339,0,0,75,0,0,75,318,339
318,340,76,0,0,0,0,76,318,340
319,1,33,0,0,0,0,33,319,1
319,4,0,0,18,0,0,18,319,4
319,5,270,0,29,0,0,299,319,5
319,23,0,0,18,0,0,18,319,23
319,24,17,0,14,60,0,91,319,24
319,27,17,0,192,12,0,221,319,27
319,29,48,0,0,0,0,48,319,29
319,30,17,0,31,0,0,48,319,30
319,31,79,0,14,12,0,105,319,31
319,32,33,0,32,0,21,86,319,32
319,34,0,0,89,0,0,89,319,34
319,40,0,0,27,0,0,27,319,40
319,43,63,0,0,0,0,63,319,43
319,49,31,0,12,0,0,43,319,49
319,53,25,0,58,0,0,83,319,53
319,54,260,0,0,42,0,302,319,54
319,55,357,0,12,0,0,369,319,55
319,56,0,0,0,11,0,11,319,56
319,57,25,0,0,0,0,25,319,57
319,59,17,0,0,0,0,17,319,59
319,60,102,0,0,0,0,102,319,60
319,61,17,0,0,0,0,17,319,61
319,62,33,0,0,0,0,33,319,62
319,64,105,0,31,282,0,418,319,64
319,65,159,0,0,0,0,159,319,65
319,67,12,0,0,0,0,12,319,67
319,68,134,0,606,99,0,839,319,68
319,69,17,0,0,0,0,17,319,69
319,70,241,0,381,0,0,622,319,70
319,71,72,0,0,0,0,72,319,71
319,72,139,0,0,0,0,139,319,72
319,73,128,14,80,17,0,239,319,73
319,74,25,0,0,17,0,42,319,74
319,75,0,0,16,35,0,51,319,75
319,76,124,0,0,0,0,124,319,76
319,77,0,0,0,12,0,12,319,77
319,78,28,0,18,88,0,134,319,78
319,79,50,0,42,0,0,92,319,79
319,80,181,0,0,0,0,181,319,80
319,81,304,0,192,0,0,496,319,81
319,82,64,0,68,12,0,144,319,82
319,83,41,0,93,0,0,134,319,83
319,84,58,0,0,0,0,58,319,84
319,85,47,0,0,0,0,47,319,85
319,86,17,0,0,0,0,17,319,86
319,87,269,0,0,0,0,269,319,87
319,88,0,0,136,0,0,136,319,88
319,90,12,0,0,0,0,12,319,90
319,91,10,0,0,0,0,10,319,91
319,93,232,0,0,0,0,232,319,93
319,95,241,0,0,0,0,241,319,95
319,96,67,0,0,0,0,67,319,96
319,97,91,0,82,70,0,243,319,97
319,100,209,0,0,0,0,209,319,100
319,106,0,0,0,17,0,17,319,106
319,108,68,0,0,0,0,68,319,108
319,113,14,0,0,0,0,14,319,113
319,119,0,0,513,0,0,513,319,119
319,122,389,0,364,0,0,753,319,122
319,124,0,0,732,0,0,732,319,124
319,126,0,0,100,0,0,100,319,126
319,136,87,0,0,497,0,584,319,136
319,145,0,0,65,0,0,65,319,145
319,158,1058,0,0,0,0,1058,319,158
319,169,14,0,0,0,0,14,319,169
319,171,422,0,0,0,0,422,319,171
319,172,0,0,238,0,0,238,319,172
319,177,0,0,29,0,0,29,319,177
319,178,14,0,0,0,0,14,319,178
319,195,0,0,0,263,0,263,319,195
319,205,0,0,384,0,0,384,319,205
319,268,257,0,0,0,0,257,319,268
319,269,58,0,0,0,0,58,319,269
319,270,31,0,0,0,0,31,319,270
319,272,0,0,197,0,0,197,319,272
319,274,17,0,0,0,0,17,319,274
319,275,979,0,0,0,0,979,319,275
319,278,0,0,288,0,0,288,319,278
319,280,17,0,20,0,0,37,319,280
319,281,241,0,0,0,0,241,319,281
319,282,201,0,0,0,0,201,319,282
319,284,0,0,0,353,0,353,319,284
319,287,17,0,0,0,0,17,319,287
319,288,62,0,0,0,0,62,319,288
319,292,0,0,846,0,0,846,319,292
319,299,79,0,0,0,0,79,319,299
319,300,161,0,35,426,0,622,319,300
319,301,0,0,209,0,0,209,319,301
319,302,12,0,0,0,0,12,319,302
319,303,14,0,18,0,0,32,319,303
319,304,17,0,18,0,0,35,319,304
319,305,29,0,220,0,0,249,319,305
319,307,0,0,325,0,0,325,319,307
319,308,0,0,220,0,0,220,319,308
319,309,0,0,465,0,0,465,319,309
319,315,181,0,901,0,0,1082,319,315
319,316,746,0,103,109,137,1095,319,316
319,317,273,0,15,0,0,288,319,317
319,318,218,0,112,593,0,923,319,318
319,319,726,1432,0,0,0,2158,319,319
319,320,0,1961,1531,356,0,3848,319,320
319,321,346,0,151,184,0,681,319,321
319,322,1418,0,84,458,0,1960,319,322
319,324,58,0,18,462,0,538,319,324
319,326,0,0,570,0,0,570,319,326
319,327,410,1549,48,228,0,2235,319,327
319,328,58,0,0,0,0,58,319,328
319,329,597,74,186,142,0,999,319,329
319,330,298,0,234,0,0,532,319,330
319,338,17,0,0,0,0,17,319,338
319,339,66,0,12,0,0,78,319,339
319,340,148,0,257,0,0,405,319,340
320,1,0,0,569,0,0,569,320,1
320,3,275,0,0,0,0,275,320,3
320,5,125,0,207,0,0,332,320,5
320,18,274,0,270,0,0,544,320,18
320,21,0,0,111,0,0,111,320,21
320,24,0,0,299,0,0,299,320,24
320,25,0,0,299,0,0,299,320,25
320,27,0,0,299,0,0,299,320,27
320,29,0,0,1005,0,0,1005,320,29
320,43,0,0,0,630,0,630,320,43
320,52,0,0,597,0,0,597,320,52
320,55,72,0,299,0,0,371,320,55
320,56,226,0,0,0,0,226,320,56
320,57,0,0,299,0,0,299,320,57
320,62,0,0,299,0,0,299,320,62
320,63,35,0,0,274,0,309,320,63
320,66,322,0,0,0,0,322,320,66
320,68,337,0,299,215,0,851,320,68
320,69,0,0,299,0,0,299,320,69
320,71,131,0,299,0,0,430,320,71
320,72,0,487,691,215,0,1393,320,72
320,75,0,0,123,0,0,123,320,75
320,77,0,0,299,0,0,299,320,77
320,78,0,0,123,0,0,123,320,78
320,80,113,0,541,0,0,654,320,80
320,81,250,0,811,125,0,1186,320,81
320,82,0,0,1046,0,0,1046,320,82
320,83,0,0,910,0,0,910,320,83
320,84,0,0,51,0,0,51,320,84
320,90,0,0,299,0,0,299,320,90
320,91,0,0,299,0,0,299,320,91
320,100,0,0,236,0,0,236,320,100
320,107,0,0,299,0,0,299,320,107
320,123,274,0,0,0,0,274,320,123
320,175,0,0,249,0,0,249,320,175
320,178,0,0,249,0,0,249,320,178
320,182,0,0,274,0,0,274,320,182
320,219,0,0,249,0,0,249,320,219
320,268,0,0,233,98,0,331,320,268
320,269,0,0,1303,0,0,1303,320,269
320,274,314,0,0,0,0,314,320,274
320,275,0,0,0,274,0,274,320,275
320,277,0,0,207,0,0,207,320,277
320,278,0,0,0,98,0,98,320,278
320,280,125,0,299,0,0,424,320,280
320,300,125,0,2009,0,0,2134,320,300
320,301,303,0,299,0,0,602,320,301
320,302,274,0,1786,0,0,2060,320,302
320,303,0,0,867,0,0,867,320,303
320,304,125,0,505,0,0,630,320,304
320,305,125,0,299,0,0,424,320,305
320,316,1478,523,505,0,0,2506,320,316
320,317,28,0,0,0,0,28,320,317
320,318,425,464,411,250,0,1550,320,318
320,319,0,2235,1531,356,0,4122,320,319
320,320,250,36134,1569,2055,0,40008,320,320
320,321,2306,6533,597,717,0,10153,320,321
320,322,1009,3935,657,472,0,6073,320,322
320,323,0,0,270,0,0,270,320,323
320,324,0,0,299,0,0,299,320,324
320,325,22,0,0,0,0,22,320,325
320,327,611,674,597,395,0,2277,320,327
320,328,111,0,312,274,0,697,320,328
320,329,929,0,0,0,181,1110,320,329
320,330,0,0,299,0,0,299,320,330
320,332,0,0,207,0,0,207,320,332
320,339,190,0,0,0,0,190,320,339
320,340,0,0,299,0,0,299,320,340
321,1,0,0,0,111,0,111,321,1
321,2,95,0,0,111,0,206,321,2
321,5,263,0,249,0,0,512,321,5
321,6,111,0,0,0,0,111,321,6
321,16,111,0,0,0,0,111,321,16
321,28,333,0,0,0,0,333,321,28
321,29,222,0,189,0,0,411,321,29
321,31,304,0,0,0,0,304,321,31
321,32,485,0,0,111,0,596,321,32
321,33,15,0,0,0,0,15,321,33
321,34,304,0,0,0,0,304,321,34
321,36,111,0,0,0,0,111,321,36
321,45,469,0,152,0,0,621,321,45
321,48,111,0,0,0,0,111,321,48
321,53,347,0,103,0,0,450,321,53
321,55,210,0,0,0,0,210,321,55
321,56,111,0,0,95,0,206,321,56
321,57,0,0,406,0,0,406,321,57
321,64,485,0,0,111,0,596,321,64
321,66,263,0,0,0,0,263,321,66
321,67,111,0,103,0,0,214,321,67
321,68,965,0,0,0,0,965,321,68
321,69,1382,0,0,0,0,1382,321,69
321,70,341,0,0,0,0,341,321,70
321,71,95,0,0,0,0,95,321,71
321,72,1439,0,0,0,0,1439,321,72
321,73,1880,0,275,205,161,2521,321,73
321,74,111,0,0,0,0,111,321,74
321,76,38,0,0,0,0,38,321,76
321,78,111,0,0,287,0,398,321,78
321,79,0,0,0,210,0,210,321,79
321,81,373,0,513,0,0,886,321,81
321,82,333,0,111,0,0,444,321,82
321,83,0,0,0,111,0,111,321,83
321,84,263,0,0,0,0,263,321,84
321,85,11,0,0,0,0,11,321,85
321,87,24,0,0,0,0,24,321,87
321,90,0,0,62,0,0,62,321,90
321,96,152,0,0,0,0,152,321,96
321,97,95,0,0,0,0,95,321,97
321,105,161,0,0,0,0,161,321,105
321,107,111,0,0,0,0,111,321,107
321,131,0,0,158,0,0,158,321,131
321,137,0,0,0,408,0,408,321,137
321,161,111,0,0,0,0,111,321,161
321,162,111,0,0,0,0,111,321,162
321,167,111,0,0,0,0,111,321,167
321,198,0,0,0,111,0,111,321,198
321,200,0,0,132,0,0,132,321,200
321,201,0,0,95,0,0,95,321,201
321,206,95,0,0,0,0,95,321,206
321,237,263,0,0,0,0,263,321,237
321,239,408,0,152,0,0,560,321,239
321,268,36,0,0,0,0,36,321,268
321,270,0,0,0,111,0,111,321,270
321,271,0,0,0,111,0,111,321,271
321,275,152,0,0,0,0,152,321,275
321,278,0,0,703,0,0,703,321,278
321,280,679,0,767,0,0,1446,321,280
321,281,111,0,0,0,0,111,321,281
321,282,189,0,0,0,0,189,321,282
321,286,251,0,54,0,0,305,321,286
321,287,0,0,635,242,0,877,321,287
321,289,111,0,0,0,0,111,321,289
321,290,0,0,0,231,0,231,321,290
321,292,0,0,267,0,0,267,321,292
321,296,0,0,16,0,0,16,321,296
321,300,1270,0,2808,654,0,4732,321,300
321,301,111,0,0,0,0,111,321,301
321,302,1138,0,229,0,0,1367,321,302
321,303,111,0,178,152,0,441,321,303
321,304,0,111,1585,0,0,1696,321,304
321,305,202,0,1411,0,0,1613,321,305
321,307,0,0,649,0,0,649,321,307
321,311,0,0,477,0,0,477,321,311
321,314,111,0,3754,0,0,3865,321,314
321,315,332,0,736,0,0,1068,321,315
321,316,920,0,0,0,0,920,321,316
321,317,111,0,0,0,0,111,321,317
321,318,649,0,0,0,0,649,321,318
321,319,474,0,151,184,0,809,321,319
321,320,1683,6943,597,622,0,9845,321,320
321,321,3716,17494,0,1065,322,22597,321,321
321,322,5425,371,131,2931,0,8858,321,322
321,323,1559,0,377,794,0,2730,321,323
321,324,820,0,121,0,0,941,321,324
321,326,0,0,3042,0,0,3042,321,326
321,327,860,406,108,32,0,1406,321,327
321,328,1226,0,0,210,0,1436,321,328
321,329,221,0,172,0,0,393,321,329
321,338,109,0,0,0,0,109,321,338
321,339,526,0,166,0,161,853,321,339
321,340,222,0,0,0,0,222,321,340
322,1,77,0,0,121,0,198,322,1
322,2,0,0,84,0,0,84,322,2
322,5,77,0,0,0,0,77,322,5
322,6,0,0,498,0,0,498,322,6
322,7,77,0,0,0,0,77,322,7
322,14,515,0,0,0,0,515,322,14
322,17,77,0,0,0,0,77,322,17
322,23,77,0,0,0,0,77,322,23
322,24,77,0,0,0,0,77,322,24
322,26,0,0,150,0,0,150,322,26
322,29,77,0,0,0,0,77,322,29
322,30,452,0,0,0,0,452,322,30
322,35,121,0,0,0,0,121,322,35
322,45,77,0,0,0,0,77,322,45
322,51,121,0,0,0,0,121,322,51
322,52,77,0,0,0,0,77,322,52
322,53,515,0,0,0,0,515,322,53
322,57,77,0,0,0,0,77,322,57
322,62,154,0,0,0,0,154,322,62
322,65,0,0,0,175,0,175,322,65
322,66,24,0,208,0,0,232,322,66
322,67,0,0,495,0,0,495,322,67
322,68,272,0,157,121,0,550,322,68
322,69,0,0,0,177,0,177,322,69
322,71,275,0,0,0,0,275,322,71
322,73,617,0,0,0,576,1193,322,73
322,76,38,0,0,0,0,38,322,76
322,77,77,0,0,276,0,353,322,77
322,78,77,0,0,0,0,77,322,78
322,79,77,0,0,0,0,77,322,79
322,80,154,0,0,0,0,154,322,80
322,81,595,0,0,77,0,672,322,81
322,82,154,0,691,0,0,845,322,82
322,83,0,0,432,0,0,432,322,83
322,86,0,0,0,24,0,24,322,86
322,90,0,0,0,24,0,24,322,90
322,94,77,0,0,0,0,77,322,94
322,95,465,0,0,0,0,465,322,95
322,100,77,0,0,0,0,77,322,100
322,118,77,0,0,0,0,77,322,118
322,136,77,0,0,0,0,77,322,136
322,138,77,0,0,0,0,77,322,138
322,169,0,0,121,0,0,121,322,169
322,181,154,0,0,0,0,154,322,181
322,230,0,0,612,0,0,612,322,230
322,251,157,0,0,0,0,157,322,251
322,268,0,0,0,121,0,121,322,268
322,271,117,0,0,121,0,238,322,271
322,273,77,0,0,0,0,77,322,273
322,280,77,0,155,0,0,232,322,280
322,281,0,0,417,0,0,417,322,281
322,283,0,0,492,0,0,492,322,283
322,286,87,0,0,0,0,87,322,286
322,291,0,0,248,0,0,248,322,291
322,294,0,0,802,0,0,802,322,294
322,298,77,0,0,0,0,77,322,298
322,300,546,0,107,534,0,1187,322,300
322,301,0,0,131,79,0,210,322,301
322,302,386,0,264,0,0,650,322,302
322,303,29,0,935,0,0,964,322,303
322,304,1067,1855,0,403,0,3325,322,304
322,305,232,0,2663,202,0,3097,322,305
322,306,0,0,879,0,0,879,322,306
322,310,0,0,282,0,0,282,322,310
322,312,0,0,155,0,0,155,322,312
322,314,0,0,2356,0,0,2356,322,314
322,315,0,321,479,0,269,1069,322,315
322,316,1849,0,0,54,0,1903,322,316
322,317,105,0,0,28,0,133,322,317
322,318,0,0,84,24,0,108,322,318
322,319,1331,0,18,535,0,1884,322,319
322,320,1009,1251,4011,746,0,7017,322,320
322,321,5418,491,131,2446,0,8486,322,321
322,322,7160,9971,0,2793,0,19924,322,322
322,323,669,0,0,0,0,669,322,323
322,325,512,0,0,1392,0,1904,322,325
322,326,1750,451,0,594,0,2795,322,326
322,327,766,501,0,32,0,1299,322,327
322,328,1937,789,113,516,0,3355,322,328
322,329,157,0,1047,0,0,1204,322,329
322,330,750,0,0,0,0,750,322,330
322,333,0,0,136,0,0,136,322,333
322,339,292,0,0,0,0,292,322,339
322,342,77,0,84,0,0,161,322,342
323,2,0,0,539,0,0,539,323,2
323,12,0,0,453,0,0,453,323,12
323,28,0,0,453,0,0,453,323,28
323,34,0,0,539,0,0,539,323,34
323,43,0,0,584,0,0,584,323,43
323,62,0,0,475,0,0,475,323,62
323,63,0,0,306,0,0,306,323,63
323,64,0,0,584,0,0,584,323,64
323,66,0,0,586,0,0,586,323,66
323,68,539,0,0,0,0,539,323,68
323,69,80,0,762,0,0,842,323,69
323,72,0,0,758,0,0,758,323,72
323,73,0,0,1029,0,0,1029,323,73
323,74,0,0,317,0,0,317,323,74
323,76,436,0,584,0,0,1020,323,76
323,77,0,0,539,0,0,539,323,77
323,79,693,0,0,0,0,693,323,79
323,81,539,0,0,0,0,539,323,81
323,82,1017,0,1550,0,0,2567,323,82
323,83,0,0,586,0,0,586,323,83
323,100,0,0,539,0,0,539,323,100
323,108,306,0,0,0,0,306,323,108
323,167,0,0,436,0,0,436,323,167
323,229,0,0,365,0,0,365,323,229
323,250,0,0,586,0,0,586,323,250
323,269,0,0,224,0,0,224,323,269
323,270,584,0,0,0,0,584,323,270
323,280,206,0,490,0,0,696,323,280
323,281,0,0,539,0,0,539,323,281
323,282,909,0,436,0,0,1345,323,282
323,285,0,0,586,0,0,586,323,285
323,286,206,0,0,0,0,206,323,286
323,290,0,0,0,539,0,539,323,290
323,291,0,0,270,0,0,270,323,291
323,300,2171,0,4564,0,0,6735,323,300
323,301,0,0,539,0,0,539,323,301
323,302,0,0,377,0,0,377,323,302
323,303,696,0,1273,1093,0,3062,323,303
323,304,1384,3028,948,1109,0,6469,323,304
323,305,220,0,0,0,0,220,323,305
323,307,298,0,0,0,0,298,323,307
323,309,0,0,353,0,0,353,323,309
323,312,2523,310,729,615,0,4177,323,312
323,315,0,330,403,0,0,733,323,315
323,316,0,0,239,0,0,239,323,316
323,318,0,0,112,0,0,112,323,318
323,320,0,0,270,0,0,270,323,320
323,321,1559,0,377,794,0,2730,323,321
323,322,974,0,0,0,0,974,323,322
323,323,3393,22415,0,8288,0,34096,323,323
323,324,0,0,521,515,0,1036,323,324
323,325,1140,3921,1816,906,0,7783,323,325
323,326,451,0,456,1109,0,2016,323,326
323,327,0,0,0,115,0,115,323,327
324,2,923,0,0,0,0,923,324,2
324,27,0,0,502,0,0,502,324,27
324,32,0,0,1373,0,0,1373,324,32
324,49,0,0,502,0,0,502,324,49
324,59,0,0,502,0,0,502,324,59
324,62,820,0,0,0,0,820,324,62
324,64,0,0,686,0,0,686,324,64
324,68,820,0,0,0,0,820,324,68
324,70,118,0,0,0,0,118,324,70
324,75,0,0,892,0,0,892,324,75
324,76,41,0,0,0,0,41,324,76
324,80,0,0,521,0,0,521,324,80
324,82,0,0,2763,631,0,3394,324,82
324,97,0,0,895,0,0,895,324,97
324,101,0,0,521,0,0,521,324,101
324,156,0,0,521,0,0,521,324,156
324,246,0,0,631,0,0,631,324,246
324,268,36,0,892,0,0,928,324,268
324,273,0,0,502,0,0,502,324,273
324,280,0,0,667,0,0,667,324,280
324,281,0,0,502,0,0,502,324,281
324,282,0,0,0,986,0,986,324,282
324,286,0,0,50,0,0,50,324,286
324,300,736,0,981,0,0,1717,324,300
324,301,0,0,686,0,0,686,324,301
324,302,85,0,0,0,0,85,324,302
324,303,26,0,0,0,0,26,324,303
324,304,373,0,825,915,0,2113,324,304
324,305,376,0,502,0,0,878,324,305
324,309,0,0,465,0,0,465,324,309
324,312,478,0,0,0,0,478,324,312
324,313,0,0,250,0,0,250,324,313
324,314,0,0,2911,1303,0,4214,324,314
324,315,604,3867,4914,781,0,10166,324,315
324,318,0,0,112,0,0,112,324,318
324,319,17,0,18,462,0,497,324,319
324,320,0,0,299,0,0,299,324,320
324,321,820,0,121,0,0,941,324,321
324,323,0,0,521,515,0,1036,324,323
324,324,3004,21314,8388,10331,0,43037,324,324
324,325,393,819,1024,494,0,2730,324,325
324,329,51,0,0,0,0,51,324,329
324,330,0,0,0,527,0,527,324,330
325,1,0,0,0,364,0,364,325,1
325,5,0,0,44,0,0,44,325,5
325,17,0,0,445,0,0,445,325,17
325,19,0,0,202,0,0,202,325,19
325,27,0,0,445,0,0,445,325,27
325,29,257,0,248,0,0,505,325,29
325,30,0,0,409,0,0,409,325,30
325,32,0,0,395,0,0,395,325,32
325,49,48,0,0,0,0,48,325,49
325,52,0,0,364,0,0,364,325,52
325,54,0,0,657,0,0,657,325,54
325,64,0,0,279,0,0,279,325,64
325,66,0,0,228,0,0,228,325,66
325,68,0,0,395,0,0,395,325,68
325,70,0,0,228,0,0,228,325,70
325,77,0,0,279,0,0,279,325,77
325,78,0,0,423,0,0,423,325,78
325,80,0,0,248,0,0,248,325,80
325,82,0,0,248,0,0,248,325,82
325,100,0,0,248,364,0,612,325,100
325,108,409,0,0,0,0,409,325,108
325,116,0,0,0,289,0,289,325,116
325,199,0,0,309,0,0,309,325,199
325,268,0,0,279,0,0,279,325,268
325,281,409,0,0,0,0,409,325,281
325,286,29,0,22,0,0,51,325,286
325,296,0,0,158,0,0,158,325,296
325,298,0,0,22,0,0,22,325,298
325,300,570,0,278,0,0,848,325,300
325,302,485,0,0,0,0,485,325,302
325,303,0,0,621,0,0,621,325,303
325,304,514,0,754,0,0,1268,325,304
325,305,0,0,409,990,0,1399,325,305
325,307,710,0,282,0,0,992,325,307
325,309,0,0,249,0,0,249,325,309
325,312,22,0,202,0,0,224,325,312
325,313,0,0,260,0,0,260,325,313
325,314,0,0,1576,0,0,1576,325,314
325,315,257,0,1113,0,0,1370,325,315
325,317,14,0,0,0,0,14,325,317
325,318,0,0,1006,0,0,1006,325,318
325,320,22,0,0,0,0,22,325,320
325,322,0,0,0,1028,0,1028,325,322
325,323,1707,3921,1816,906,0,8350,325,323
325,324,783,819,1226,494,0,3322,325,324
325,325,12346,24538,22,54,0,36960,325,325
325,326,3219,906,542,797,0,5464,325,326
325,327,49,0,30,0,0,79,325,327
325,328,1324,0,0,0,0,1324,325,328
325,329,1858,0,547,0,0,2405,325,329
325,330,0,0,0,228,0,228,325,330
325,332,0,0,703,0,0,703,325,332
325,341,0,0,1087,0,0,1087,325,341
326,1,0,0,498,0,0,498,326,1
326,5,0,0,462,0,0,462,326,5
326,21,0,0,598,0,0,598,326,21
326,27,0,0,78,419,0,497,326,27
326,29,0,0,0,422,0,422,326,29
326,32,0,0,78,0,0,78,326,32
326,51,0,0,498,0,0,498,326,51
326,53,0,0,598,0,0,598,326,53
326,57,313,0,419,0,0,732,326,57
326,59,422,0,0,0,0,422,326,59
326,66,116,0,0,0,0,116,326,66
326,68,0,0,2020,0,0,2020,326,68
326,71,0,0,651,0,0,651,326,71
326,73,498,0,0,0,0,498,326,73
326,76,0,0,498,0,0,498,326,76
326,78,0,0,214,0,0,214,326,78
326,79,0,0,915,0,0,915,326,79
326,80,0,0,214,0,0,214,326,80
326,82,72,0,651,0,0,723,326,82
326,89,48,0,0,0,0,48,326,89
326,99,0,0,456,0,0,456,326,99
326,144,422,0,0,0,0,422,326,144
326,151,0,0,882,0,0,882,326,151
326,215,193,0,0,0,0,193,326,215
326,269,9,0,0,0,0,9,326,269
326,274,0,0,707,0,0,707,326,274
326,278,0,0,430,0,0,430,326,278
326,285,405,0,0,0,0,405,326,285
326,286,0,0,425,0,0,425,326,286
326,294,0,0,422,0,0,422,326,294
326,300,0,0,2548,619,0,3167,326,300
326,301,0,0,742,0,0,742,326,301
326,302,419,0,918,0,0,1337,326,302
326,303,0,0,1535,0,0,1535,326,303
326,304,197,0,651,572,0,1420,326,304
326,307,0,0,327,0,0,327,326,307
326,312,0,0,459,0,0,459,326,312
326,314,595,0,0,0,0,595,326,314
326,315,0,0,579,0,0,579,326,315
326,319,422,0,570,0,0,992,326,319
326,321,920,0,2583,0,0,3503,326,321
326,322,1180,451,0,594,0,2225,326,322
326,323,451,0,456,1109,0,2016,326,323
326,325,3907,422,542,1107,0,5978,326,325
326,326,4313,11086,0,82,0,15481,326,326
326,327,844,0,0,0,0,844,326,327
326,328,2991,0,0,120,0,3111,326,328
326,329,745,0,0,0,0,745,326,329
326,335,875,0,0,0,0,875,326,335
326,339,498,0,1272,0,0,1770,326,339
326,340,600,0,0,37,0,637,326,340
327,1,27,0,306,0,0,333,327,1
327,3,0,0,307,0,0,307,327,3
327,4,0,0,73,0,0,73,327,4
327,5,97,0,22,0,0,119,327,5
327,9,27,0,0,0,0,27,327,9
327,22,67,0,0,0,0,67,327,22
327,23,104,0,127,22,0,253,327,23
327,24,27,0,0,0,0,27,327,24
327,26,0,0,41,0,0,41,327,26
327,27,92,0,0,0,0,92,327,27
327,28,27,0,0,0,0,27,327,28
327,29,49,0,182,0,0,231,327,29
327,30,38,0,0,0,0,38,327,30
327,31,27,0,91,0,0,118,327,31
327,32,55,0,0,0,0,55,327,32
327,42,0,0,23,0,0,23,327,42
327,54,37,0,0,0,0,37,327,54
327,55,0,0,35,0,0,35,327,55
327,56,22,0,35,0,0,57,327,56
327,57,72,0,30,28,0,130,327,57
327,58,27,0,30,0,0,57,327,58
327,61,0,0,314,0,0,314,327,61
327,63,27,0,0,0,0,27,327,63
327,64,233,0,0,0,0,233,327,64
327,65,0,0,0,27,0,27,327,65
327,66,55,0,0,0,0,55,327,66
327,68,427,0,30,87,0,544,327,68
327,69,182,0,0,0,0,182,327,69
327,70,238,0,0,103,0,341,327,70
327,71,27,0,0,0,0,27,327,71
327,72,164,0,76,356,0,596,327,72
327,73,284,0,41,0,0,325,327,73
327,74,164,0,0,0,0,164,327,74
327,75,56,0,30,0,0,86,327,75
327,76,127,0,0,38,0,165,327,76
327,77,82,0,0,0,0,82,327,77
327,78,0,0,0,27,0,27,327,78
327,79,231,0,0,27,0,258,327,79
327,80,0,0,27,27,0,54,327,80
327,81,92,0,30,27,0,149,327,81
327,82,134,0,149,120,0,403,327,82
327,83,65,0,0,0,0,65,327,83
327,84,27,0,0,0,0,27,327,84
327,85,11,0,0,0,0,11,327,85
327,88,247,0,0,0,0,247,327,88
327,92,0,0,27,0,0,27,327,92
327,96,0,0,276,27,0,303,327,96
327,97,51,0,0,0,0,51,327,97
327,102,22,0,0,0,0,22,327,102
327,113,0,0,48,0,0,48,327,113
327,132,120,0,0,0,0,120,327,132
327,135,0,0,27,0,0,27,327,135
327,162,0,0,30,0,0,30,327,162
327,190,27,0,0,0,0,27,327,190
327,239,316,0,0,0,0,316,327,239
327,243,38,0,0,0,0,38,327,243
327,254,199,0,0,0,0,199,327,254
327,268,55,0,0,113,0,168,327,268
327,269,0,0,24,27,0,51,327,269
327,270,54,0,0,0,0,54,327,270
327,272,27,0,0,0,0,27,327,272
327,274,27,0,0,0,0,27,327,274
327,300,196,0,59,0,0,255,327,300
327,301,27,0,318,0,0,345,327,301
327,302,27,0,41,0,0,68,327,302
327,303,142,0,0,248,0,390,327,303
327,304,36,0,0,0,0,36,327,304
327,316,99,254,25,72,0,450,327,316
327,317,121,0,0,0,0,121,327,317
327,318,239,0,311,27,0,577,327,318
327,319,410,1593,0,228,0,2231,327,319
327,320,1584,549,597,356,0,3086,327,320
327,321,860,406,108,32,0,1406,327,321
327,322,726,451,136,0,0,1313,327,322
327,323,131,0,0,38,0,169,327,323
327,325,22,0,30,0,0,52,327,325
327,326,844,0,0,120,0,964,327,326
327,327,198,2304,552,0,0,3054,327,327
327,328,505,755,0,179,0,1439,327,328
327,329,819,1635,208,169,0,2831,327,329
327,330,77,0,133,0,0,210,327,330
327,331,837,0,224,0,0,1061,327,331
327,332,411,0,0,0,0,411,327,332
327,334,55,0,0,0,0,55,327,334
327,337,0,0,41,0,0,41,327,337
327,338,55,0,0,0,0,55,327,338
327,339,196,0,179,0,0,375,327,339
327,340,268,0,0,0,0,268,327,340
327,341,0,0,31,356,0,387,327,341
327,342,27,0,0,0,0,27,327,342
328,1,0,0,79,0,0,79,328,1
328,22,0,0,0,122,0,122,328,22
328,24,122,0,0,0,0,122,328,24
328,26,0,0,0,203,0,203,328,26
328,33,0,0,272,0,0,272,328,33
328,40,27,0,0,0,0,27,328,40
328,49,0,0,267,0,0,267,328,49
328,53,319,0,0,0,0,319,328,53
328,58,122,0,0,0,0,122,328,58
328,61,0,0,122,0,0,122,328,61
328,62,0,0,0,326,0,326,328,62
328,68,571,0,132,0,0,703,328,68
328,69,51,0,0,0,0,51,328,69
328,72,243,0,0,0,0,243,328,72
328,73,595,0,291,197,0,1083,328,73
328,76,0,0,179,0,0,179,328,76
328,77,267,0,432,0,0,699,328,77
328,78,0,0,215,0,0,215,328,78
328,79,316,0,457,0,0,773,328,79
328,80,0,0,400,197,0,597,328,80
328,81,197,0,0,0,0,197,328,81
328,82,0,0,442,267,0,709,328,82
328,83,197,0,0,0,0,197,328,83
328,86,0,0,19,0,0,19,328,86
328,87,56,0,0,0,0,56,328,87
328,96,0,0,135,0,0,135,328,96
328,97,90,0,0,56,0,146,328,97
328,100,197,0,0,0,0,197,328,100
328,102,49,0,0,0,0,49,328,102
328,104,21,0,0,0,0,21,328,104
328,105,0,0,215,0,0,215,328,105
328,108,0,0,215,0,0,215,328,108
328,126,0,0,394,0,0,394,328,126
328,141,531,0,0,0,0,531,328,141
328,211,0,0,32,0,0,32,328,211
328,227,0,0,562,0,0,562,328,227
328,247,0,0,973,0,0,973,328,247
328,254,395,0,0,0,0,395,328,254
328,268,0,0,0,122,0,122,328,268
328,286,197,0,0,0,0,197,328,286
328,294,0,0,873,0,0,873,328,294
328,298,0,0,657,0,0,657,328,298
328,300,165,0,153,0,0,318,328,300
328,303,0,0,0,764,0,764,328,303
328,304,55,0,993,0,0,1048,328,304
328,309,0,0,342,0,0,342,328,309
328,314,0,0,122,0,0,122,328,314
328,316,547,0,0,94,0,641,328,316
328,317,226,0,0,0,0,226,328,317
328,318,0,0,543,0,0,543,328,318
328,319,58,0,0,0,0,58,328,319
328,320,125,0,312,274,0,711,328,320
328,321,1620,0,0,0,0,1620,328,321
328,322,1456,839,351,351,0,2997,328,322
328,323,306,0,0,0,0,306,328,323
328,325,1324,0,0,0,0,1324,328,325
328,326,1041,0,0,0,0,1041,328,326
328,327,679,449,0,337,0,1465,328,327
328,328,2298,5142,0,0,0,7440,328,328
328,329,2059,1251,153,1382,0,4845,328,329
328,330,1511,0,0,811,0,2322,328,330
328,331,0,0,179,0,0,179,328,331
328,339,267,27,0,129,0,423,328,339
328,342,660,0,0,556,0,1216,328,342
329,1,170,0,377,0,0,547,329,1
329,2,51,0,0,0,0,51,329,2
329,4,0,0,55,0,0,55,329,4
329,5,0,0,825,0,0,825,329,5
329,7,0,0,51,27,0,78,329,7
329,12,18,0,0,0,0,18,329,12
329,16,0,0,55,0,0,55,329,16
329,19,0,0,53,0,0,53,329,19
329,21,0,0,0,83,0,83,329,21
329,24,0,0,472,0,0,472,329,24
329,26,329,0,0,0,0,329,329,26
329,27,0,0,0,51,0,51,329,27
329,28,102,0,50,0,0,152,329,28
329,29,51,0,55,0,0,106,329,29
329,31,0,0,457,0,0,457,329,31
329,32,36,0,0,50,0,86,329,32
329,34,0,0,0,11,0,11,329,34
329,35,51,0,0,0,0,51,329,35
329,36,0,0,20,0,0,20,329,36
329,37,18,0,0,0,0,18,329,37
329,42,0,0,443,0,0,443,329,42
329,43,0,0,55,0,0,55,329,43
329,44,101,0,0,0,0,101,329,44
329,49,17,0,51,0,0,68,329,49
329,54,37,0,0,0,0,37,329,54
329,56,152,0,0,0,0,152,329,56
329,57,51,0,127,0,0,178,329,57
329,58,0,0,0,51,0,51,329,58
329,61,443,0,0,0,0,443,329,61
329,62,75,0,0,0,0,75,329,62
329,63,0,0,0,51,0,51,329,63
329,65,0,0,0,101,0,101,329,65
329,67,165,0,443,0,0,608,329,67
329,68,152,0,51,0,0,203,329,68
329,70,120,0,0,51,0,171,329,70
329,71,378,0,0,0,0,378,329,71
329,72,102,0,0,0,0,102,329,72
329,73,378,0,607,0,0,985,329,73
329,74,120,0,0,0,0,120,329,74
329,75,0,0,0,69,0,69,329,75
329,76,89,0,425,0,0,514,329,76
329,77,102,0,0,526,0,628,329,77
329,78,132,0,0,0,0,132,329,78
329,79,138,0,20,0,0,158,329,79
329,80,51,0,55,0,0,106,329,80
329,81,213,0,158,51,0,422,329,81
329,82,666,0,2260,0,0,2926,329,82
329,83,171,0,130,50,0,351,329,83
329,84,0,0,106,0,0,106,329,84
329,93,51,0,55,0,0,106,329,93
329,94,0,0,117,0,0,117,329,94
329,96,51,0,0,0,0,51,329,96
329,97,18,0,0,0,0,18,329,97
329,99,51,0,0,0,0,51,329,99
329,100,102,0,0,0,0,102,329,100
329,101,0,0,55,0,0,55,329,101
329,103,443,0,0,0,0,443,329,103
329,104,21,0,0,0,0,21,329,104
329,117,0,0,1284,0,0,1284,329,117
329,121,51,0,0,0,0,51,329,121
329,124,0,0,552,0,0,552,329,124
329,129,51,0,18,0,0,69,329,129
329,130,51,0,0,0,0,51,329,130
329,131,0,0,18,0,0,18,329,131
329,138,135,0,0,0,0,135,329,138
329,153,0,0,152,0,0,152,329,153
329,166,0,0,660,0,0,660,329,166
329,167,51,0,0,0,0,51,329,167
329,168,0,0,47,0,0,47,329,168
329,169,202,0,0,50,0,252,329,169
329,170,164,0,0,0,0,164,329,170
329,229,0,0,365,0,0,365,329,229
329,236,41,0,0,0,0,41,329,236
329,239,50,0,0,0,0,50,329,239
329,269,235,0,259,0,0,494,329,269
329,270,54,0,0,0,0,54,329,270
329,272,38,0,0,0,0,38,329,272
329,277,51,0,0,0,0,51,329,277
329,286,0,0,240,0,0,240,329,286
329,294,0,0,1145,0,0,1145,329,294
329,300,18,0,0,0,0,18,329,300
329,301,350,0,0,0,0,350,329,301
329,302,51,0,148,0,0,199,329,302
329,305,0,0,220,0,0,220,329,305
329,307,0,0,773,0,0,773,329,307
329,315,0,0,588,0,0,588,329,315
329,316,4183,133,122,478,809,5725,329,316
329,317,371,0,8,7,0,386,329,317
329,318,1911,0,0,0,0,1911,329,318
329,319,505,74,215,166,0,960,329,319
329,320,125,0,0,0,181,306,329,320
329,321,580,0,0,158,0,738,329,321
329,322,157,0,1057,0,0,1214,329,322
329,324,51,0,0,0,0,51,329,324
329,325,51,0,547,0,0,598,329,325
329,326,745,0,0,0,0,745,329,326
329,327,1572,1933,113,0,0,3618,329,327
329,328,1862,1251,367,1382,0,4862,329,328
329,329,10130,12853,1938,1219,0,26140,329,329
329,330,1135,0,0,228,0,1363,329,330
329,331,0,0,765,0,0,765,329,331
329,332,327,0,0,0,0,327,329,332
329,333,136,0,0,0,0,136,329,333
329,335,498,0,0,0,0,498,329,335
329,336,166,0,0,0,0,166,329,336
329,337,0,0,143,0,0,143,329,337
329,339,705,0,356,0,0,1061,329,339
329,340,0,0,121,51,0,172,329,340
329,341,328,0,0,1066,0,1394,329,341
329,342,373,551,0,93,0,1017,329,342
330,2,0,0,430,0,0,430,330,2
330,5,0,0,960,0,0,960,330,5
330,6,0,0,267,0,0,267,330,6
330,14,328,0,0,0,0,328,330,14
330,24,0,0,714,0,0,714,330,24
330,29,102,0,25,0,0,127,330,29
330,31,0,0,17,0,0,17,330,31
330,32,102,0,267,0,0,369,330,32
330,34,39,0,42,0,0,81,330,34
330,49,0,0,425,0,0,425,330,49
330,62,0,0,462,0,0,462,330,62
330,69,0,0,234,0,0,234,330,69
330,70,0,0,111,0,0,111,330,70
330,72,882,0,1522,0,0,2404,330,72
330,73,215,0,234,0,0,449,330,73
330,74,882,0,0,0,0,882,330,74
330,77,0,0,1314,0,0,1314,330,77
330,79,0,0,234,0,0,234,330,79
330,80,349,0,473,0,0,822,330,80
330,81,102,0,0,0,0,102,330,81
330,82,0,0,30,0,0,30,330,82
330,93,0,0,377,0,0,377,330,93
330,95,658,0,0,0,0,658,330,95
330,99,267,0,0,0,0,267,330,99
330,100,215,0,290,0,0,505,330,100
330,118,25,0,0,0,0,25,330,118
330,137,0,0,221,0,0,221,330,137
330,171,0,0,704,0,0,704,330,171
330,275,0,0,290,0,0,290,330,275
330,276,601,0,0,0,0,601,330,276
330,282,0,0,0,882,0,882,330,282
330,300,164,0,948,0,0,1112,330,300
330,312,0,0,215,0,0,215,330,312
330,316,421,0,78,0,0,499,330,316
330,319,298,0,234,0,0,532,330,319
330,320,0,0,299,0,0,299,330,320
330,322,750,0,0,0,0,750,330,322
330,324,0,0,0,527,0,527,330,324
330,325,0,0,0,228,0,228,330,325
330,327,77,0,133,0,0,210,330,327
330,328,925,0,0,811,0,1736,330,328
330,329,1299,435,0,0,0,1734,330,329
330,330,5795,7463,0,1427,0,14685,330,330
330,331,1490,4533,0,934,0,6957,330,331
330,332,143,0,0,0,0,143,330,332
330,333,0,0,270,0,0,270,330,333
330,334,1996,0,0,228,0,2224,330,334
330,335,0,450,234,228,0,912,330,335
330,339,758,0,234,0,0,992,330,339
330,340,0,0,146,0,0,146,330,340
330,341,646,0,0,0,0,646,330,341
330,342,4640,1058,1172,330,0,7200,330,342
331,2,0,0,503,0,0,503,331,2
331,4,0,0,368,0,0,368,331,4
331,5,298,0,0,0,0,298,331,5
331,6,0,0,0,210,0,210,331,6
331,19,0,0,0,298,0,298,331,19
331,29,0,0,210,0,0,210,331,29
331,30,0,0,211,0,0,211,331,30
331,32,0,0,503,0,0,503,331,32
331,54,0,0,0,503,0,503,331,54
331,56,0,0,503,0,0,503,331,56
331,60,0,0,229,0,0,229,331,60
331,64,0,0,224,0,0,224,331,64
331,65,216,0,0,0,0,216,331,65
331,70,0,0,326,0,0,326,331,70
331,72,0,0,306,0,0,306,331,72
331,74,0,0,268,0,0,268,331,74
331,75,0,0,547,0,0,547,331,75
331,77,0,0,547,0,0,547,331,77
331,79,0,0,444,0,0,444,331,79
331,80,201,0,49,0,0,250,331,80
331,81,114,0,306,0,0,420,331,81
331,82,828,0,298,0,0,1126,331,82
331,83,407,0,0,0,0,407,331,83
331,84,114,0,0,0,0,114,331,84
331,88,0,0,515,0,0,515,331,88
331,93,0,0,281,0,0,281,331,93
331,100,227,0,0,0,0,227,331,100
331,108,107,0,0,0,0,107,331,108
331,122,0,0,0,389,0,389,331,122
331,168,0,0,206,0,0,206,331,168
331,216,0,0,473,0,0,473,331,216
331,310,0,0,0,669,0,669,331,310
331,316,0,0,325,120,0,445,331,316
331,317,210,0,0,0,0,210,331,317
331,327,27,0,224,0,0,251,331,327
331,328,0,0,179,0,0,179,331,328
331,329,0,0,292,0,0,292,331,329
331,330,1490,4533,473,934,0,7430,331,330
331,331,5845,9732,2940,4598,0,23115,331,331
331,332,3000,2349,553,1077,617,7596,331,332
331,333,141,0,908,0,0,1049,331,333
331,334,506,0,706,0,0,1212,331,334
331,335,1539,414,325,0,0,2278,331,335
331,336,0,0,1245,0,0,1245,331,336
331,339,0,0,325,0,0,325,331,339
331,340,597,0,0,0,0,597,331,340
331,341,114,0,343,682,0,1139,331,341
331,342,178,373,0,0,0,551,331,342
332,2,86,0,0,0,0,86,332,2
332,4,0,0,257,0,0,257,332,4
332,5,0,0,632,0,0,632,332,5
332,6,0,0,331,0,0,331,332,6
332,12,0,0,33,0,0,33,332,12
332,27,646,0,646,0,0,1292,332,27
332,28,38,0,0,0,0,38,332,28
332,29,646,0,0,0,0,646,332,29
332,31,0,0,669,0,0,669,332,31
332,32,0,0,441,0,0,441,332,32
332,41,172,0,0,0,0,172,332,41
332,44,0,0,426,0,0,426,332,44
332,61,0,0,451,0,0,451,332,61
332,73,0,0,494,0,0,494,332,73
332,76,27,0,0,0,0,27,332,76
332,77,0,0,904,0,0,904,332,77
332,80,86,0,89,0,0,175,332,80
332,82,937,0,763,0,0,1700,332,82
332,83,0,0,245,0,0,245,332,83
332,91,0,0,1275,0,0,1275,332,91
332,93,0,0,441,0,0,441,332,93
332,100,0,0,1078,0,0,1078,332,100
332,106,237,0,38,0,0,275,332,106
332,109,804,0,0,0,0,804,332,109
332,158,0,0,646,0,0,646,332,158
332,195,0,0,116,0,0,116,332,195
332,199,0,0,257,0,0,257,332,199
332,275,218,0,0,0,0,218,332,275
332,300,86,0,0,0,0,86,332,300
332,304,86,0,0,646,0,732,332,304
332,305,0,0,291,0,0,291,332,305
332,319,0,0,0,426,0,426,332,319
332,325,0,0,703,0,0,703,332,325
332,327,1193,0,0,0,0,1193,332,327
332,329,327,0,0,0,0,327,332,329
332,330,143,0,0,0,0,143,332,330
332,331,1062,2349,553,1077,617,5658,332,331
332,332,2837,32580,0,5078,0,40495,332,332
332,333,0,615,0,1134,0,1749,332,333
332,335,0,0,608,0,0,608,332,335
332,336,0,0,1993,0,0,1993,332,336
332,338,0,0,463,0,0,463,332,338
332,339,324,0,837,0,0,1161,332,339
332,340,327,0,0,0,0,327,332,340
332,341,33,0,36,0,0,69,332,341
332,342,0,0,943,0,0,943,332,342
333,2,383,0,0,0,0,383,333,2
333,5,0,0,186,0,0,186,333,5
333,16,0,0,135,0,0,135,333,16
333,17,0,0,24,0,0,24,333,17
333,18,0,0,202,0,0,202,333,18
333,21,165,0,0,0,0,165,333,21
333,24,0,0,89,0,0,89,333,24
333,26,248,0,0,0,0,248,333,26
333,30,64,0,0,186,0,250,333,30
333,32,0,0,282,0,0,282,333,32
333,36,0,0,101,291,0,392,333,36
333,43,48,0,293,0,0,341,333,43
333,47,0,0,107,0,0,107,333,47
333,57,0,0,97,0,0,97,333,57
333,62,0,0,97,0,0,97,333,62
333,63,0,0,147,0,0,147,333,63
333,65,0,0,110,0,0,110,333,65
333,68,0,0,366,186,0,552,333,68
333,71,0,0,0,193,0,193,333,71
333,77,0,0,536,0,0,536,333,77
333,79,48,0,89,0,0,137,333,79
333,81,173,0,0,0,0,173,333,81
333,82,0,0,697,0,0,697,333,82
333,91,0,0,147,0,0,147,333,91
333,96,0,0,97,0,0,97,333,96
333,108,0,0,97,0,0,97,333,108
333,116,0,0,584,0,0,584,333,116
333,132,0,0,101,0,0,101,333,132
333,133,517,0,101,0,0,618,333,133
333,161,0,0,0,135,0,135,333,161
333,167,0,0,115,0,0,115,333,167
333,274,248,0,48,0,0,296,333,274
333,278,0,0,147,0,0,147,333,278
333,294,0,0,1145,0,0,1145,333,294
333,300,48,0,270,0,0,318,333,300
333,322,0,0,136,0,0,136,333,322
333,329,136,0,0,0,0,136,333,329
333,330,0,0,987,0,0,987,333,330
333,331,141,0,908,0,0,1049,333,331
333,332,0,615,0,1134,0,1749,333,332
333,333,1207,6447,220,544,0,8418,333,333
333,334,0,0,317,0,0,317,333,334
333,335,566,0,0,0,0,566,333,335
333,336,0,0,445,0,0,445,333,336
333,339,433,0,115,0,0,548,333,339
333,340,83,0,0,0,0,83,333,340
333,341,379,0,419,0,0,798,333,341
333,342,156,0,207,310,0,673,333,342
334,2,0,0,320,0,0,320,334,2
334,5,0,0,879,0,0,879,334,5
334,18,291,0,0,0,0,291,334,18
334,27,0,0,0,341,0,341,334,27
334,28,0,0,536,0,0,536,334,28
334,36,363,0,879,0,0,1242,334,36
334,43,0,0,287,0,0,287,334,43
334,57,0,0,88,0,0,88,334,57
334,59,0,0,291,0,0,291,334,59
334,68,502,0,0,0,0,502,334,68
334,73,2025,0,263,0,0,2288,334,73
334,74,0,0,460,0,0,460,334,74
334,79,0,0,312,242,0,554,334,79
334,80,0,0,361,0,0,361,334,80
334,81,166,0,0,0,0,166,334,81
334,82,0,0,0,313,0,313,334,82
334,83,0,0,118,0,0,118,334,83
334,87,0,0,0,33,0,33,334,87
334,90,62,0,0,0,0,62,334,90
334,91,0,0,741,0,0,741,334,91
334,92,192,0,0,0,0,192,334,92
334,93,0,0,534,0,0,534,334,93
334,94,35,0,0,0,0,35,334,94
334,97,23,0,0,0,0,23,334,97
334,98,7,0,0,0,0,7,334,98
334,100,502,0,0,0,0,502,334,100
334,102,287,0,0,0,0,287,334,102
334,105,0,0,394,0,0,394,334,105
334,106,0,0,312,0,24,336,334,106
334,109,1238,0,0,0,0,1238,334,109
334,111,851,0,0,0,0,851,334,111
334,113,0,0,98,0,0,98,334,113
334,116,291,0,0,0,0,291,334,116
334,124,0,0,0,354,0,354,334,124
334,127,0,0,312,0,0,312,334,127
334,168,101,0,0,0,0,101,334,168
334,241,0,0,0,708,0,708,334,241
334,270,54,0,0,0,0,54,334,270
334,274,0,0,196,0,0,196,334,274
334,283,0,0,86,0,0,86,334,283
334,285,104,0,0,0,0,104,334,285
334,291,61,0,0,0,0,61,334,291
334,314,0,0,88,0,0,88,334,314
334,315,0,0,218,0,0,218,334,315
334,316,0,0,0,110,0,110,334,316
334,317,55,0,16,0,0,71,334,317
334,327,55,0,0,0,0,55,334,327
334,330,1996,0,0,228,0,2224,334,330
334,331,198,0,0,0,0,198,334,331
334,333,0,0,317,0,0,317,334,333
334,334,6130,11274,810,3360,0,21574,334,334
334,335,1497,1090,568,625,0,3780,334,335
334,336,320,2273,533,1488,0,4614,334,336
334,337,422,943,0,0,0,1365,334,337
334,338,425,0,1569,698,0,2692,334,338
334,339,777,1599,113,108,0,2597,334,339
334,340,1163,0,0,565,0,1728,334,340
334,341,181,0,0,127,0,308,334,341
334,342,1189,708,317,1032,0,3246,334,342
335,2,0,0,0,418,0,418,335,2
335,3,67,0,0,0,0,67,335,3
335,5,418,0,0,0,0,418,335,5
335,6,157,0,0,0,0,157,335,6
335,12,0,0,170,0,0,170,335,12
335,28,0,0,280,0,0,280,335,28
335,30,64,0,0,0,0,64,335,30
335,31,0,0,66,0,0,66,335,31
335,32,0,0,418,0,0,418,335,32
335,41,0,0,121,0,0,121,335,41
335,50,35,0,0,0,0,35,335,50
335,52,0,0,418,0,0,418,335,52
335,55,0,0,305,0,0,305,335,55
335,64,195,0,0,0,0,195,335,64
335,66,280,0,0,0,0,280,335,66
335,71,0,0,195,0,0,195,335,71
335,72,0,0,455,0,0,455,335,72
335,78,0,0,308,0,0,308,335,78
335,79,0,0,0,66,0,66,335,79
335,80,44,0,0,0,0,44,335,80
335,82,35,0,0,0,0,35,335,82
335,96,67,0,0,0,0,67,335,96
335,97,0,0,305,0,0,305,335,97
335,99,0,0,73,0,0,73,335,99
335,100,0,0,757,0,0,757,335,100
335,104,0,0,0,662,0,662,335,104
335,105,715,0,305,0,0,1020,335,105
335,107,46,0,0,0,97,143,335,107
335,108,46,0,0,0,0,46,335,108
335,129,0,0,283,0,0,283,335,129
335,141,125,0,578,0,0,703,335,141
335,209,0,0,507,0,0,507,335,209
335,274,0,0,283,0,0,283,335,274
335,281,157,0,0,0,0,157,335,281
335,303,0,0,348,0,0,348,335,303
335,316,283,0,0,0,0,283,335,316
335,317,0,0,323,0,0,323,335,317
335,326,875,0,0,0,0,875,335,326
335,329,498,0,0,0,0,498,335,329
335,330,715,450,234,228,0,1627,335,330
335,331,1539,414,325,0,0,2278,335,331
335,332,0,0,608,0,0,608,335,332
335,333,283,0,0,0,0,283,335,333
335,334,1795,1285,356,328,0,3764,335,334
335,335,5057,20263,1647,3320,0,30287,335,335
335,336,194,1117,267,329,0,1907,335,336
335,337,0,0,73,0,0,73,335,337
335,338,945,0,701,0,0,1646,335,338
335,339,283,0,1473,583,411,2750,335,339
335,340,283,0,73,0,0,356,335,340
335,341,91,0,789,151,0,1031,335,341
335,342,2372,331,308,384,0,3395,335,342
336,2,320,0,0,0,0,320,336,2
336,5,0,0,0,349,0,349,336,5
336,15,0,0,53,0,0,53,336,15
336,26,320,0,0,0,0,320,336,26
336,27,0,0,939,0,0,939,336,27
336,29,0,0,354,0,0,354,336,29
336,31,0,0,324,0,0,324,336,31
336,43,0,0,298,0,0,298,336,43
336,52,0,0,306,0,0,306,336,52
336,54,0,0,194,0,0,194,336,54
336,57,683,0,0,0,0,683,336,57
336,68,524,0,548,0,0,1072,336,68
336,73,0,0,505,0,0,505,336,73
336,77,0,0,380,0,0,380,336,77
336,78,0,0,194,0,0,194,336,78
336,80,0,0,604,0,0,604,336,80
336,82,486,0,0,0,0,486,336,82
336,87,33,0,0,0,0,33,336,87
336,91,0,0,648,0,0,648,336,91
336,92,0,0,0,166,0,166,336,92
336,93,0,0,181,0,0,181,336,93
336,94,0,0,548,0,0,548,336,94
336,96,0,0,548,0,0,548,336,96
336,100,0,0,708,0,0,708,336,100
336,102,49,0,181,38,0,268,336,102
336,106,179,0,435,0,0,614,336,106
336,107,0,0,511,0,0,511,336,107
336,115,0,0,505,0,0,505,336,115
336,165,0,0,320,0,0,320,336,165
336,166,0,0,181,0,0,181,336,166
336,183,0,0,0,184,0,184,336,183
336,268,504,0,0,0,0,504,336,268
336,274,0,0,211,0,0,211,336,274
336,285,0,0,533,0,0,533,336,285
336,307,0,0,0,300,0,300,336,307
336,308,0,0,220,0,0,220,336,308
336,311,0,0,181,0,0,181,336,311
336,329,166,0,0,0,0,166,336,329
336,331,114,0,1245,0,0,1359,336,331
336,332,0,0,1993,0,0,1993,336,332
336,333,0,0,445,0,0,445,336,333
336,334,424,1991,840,1488,0,4743,336,334
336,335,194,1117,267,329,0,1907,336,335
336,336,5063,9298,0,3396,0,17757,336,336
336,337,820,132,664,0,191,1807,336,337
336,338,1075,0,0,266,0,1341,336,338
336,339,499,0,1170,0,0,1669,336,339
336,340,126,0,168,0,0,294,336,340
336,341,0,0,0,359,0,359,336,341
337,24,125,0,0,0,0,125,337,24
337,26,132,0,0,0,0,132,337,26
337,28,0,0,132,0,0,132,337,28
337,29,0,0,257,0,0,257,337,29
337,35,132,0,0,0,0,132,337,35
337,36,131,0,0,0,0,131,337,36
337,43,0,0,45,0,0,45,337,43
337,54,508,0,0,0,0,508,337,54
337,60,132,0,0,0,0,132,337,60
337,62,0,0,132,0,0,132,337,62
337,64,132,0,0,0,0,132,337,64
337,66,0,0,557,0,0,557,337,66
337,68,0,0,379,0,0,379,337,68
337,70,132,0,182,0,0,314,337,70
337,73,132,0,594,0,0,726,337,73
337,74,452,0,203,0,0,655,337,74
337,78,0,0,143,0,0,143,337,78
337,80,49,0,492,0,0,541,337,80
337,82,132,0,635,0,0,767,337,82
337,83,452,0,0,0,0,452,337,83
337,91,10,0,0,0,0,10,337,91
337,93,0,0,143,0,0,143,337,93
337,96,53,0,0,0,0,53,337,96
337,97,35,0,621,0,0,656,337,97
337,100,132,0,621,0,0,753,337,100
337,104,9,0,0,0,0,9,337,104
337,105,0,0,953,0,0,953,337,105
337,106,181,0,0,0,0,181,337,106
337,107,263,0,0,0,0,263,337,107
337,108,0,0,161,0,0,161,337,108
337,125,0,0,457,0,0,457,337,125
337,226,521,0,0,0,0,521,337,226
337,229,0,0,694,0,0,694,337,229
337,241,0,0,53,0,0,53,337,241
337,268,0,0,57,0,0,57,337,268
337,273,81,0,0,0,0,81,337,273
337,290,0,0,162,0,0,162,337,290
337,291,0,0,154,0,0,154,337,291
337,317,0,0,15,0,0,15,337,317
337,327,0,0,41,0,0,41,337,327
337,329,0,0,143,0,0,143,337,329
337,334,291,943,0,0,0,1234,337,334
337,335,0,0,73,0,0,73,337,335
337,336,631,132,664,0,191,1618,337,336
337,337,4571,2726,272,5245,0,12814,337,337
337,338,3066,5383,378,263,0,9090,337,338
337,339,1483,0,983,0,0,2466,337,339
337,342,395,0,0,437,0,832,337,342
338,5,0,0,528,0,0,528,338,5
338,15,0,0,109,0,0,109,338,15
338,16,109,0,0,0,0,109,338,16
338,22,89,0,0,0,0,89,338,22
338,24,0,0,109,0,0,109,338,24
338,27,0,0,773,0,0,773,338,27
338,28,418,0,0,0,0,418,338,28
338,32,0,0,218,0,0,218,338,32
338,33,0,0,0,132,0,132,338,33
338,35,0,0,109,0,0,109,338,35
338,37,18,0,93,0,0,111,338,37
338,44,0,0,295,0,0,295,338,44
338,54,0,0,14,0,0,14,338,54
338,55,0,0,214,0,0,214,338,55
338,72,0,0,268,0,0,268,338,72
338,73,0,0,0,109,0,109,338,73
338,75,0,0,701,0,0,701,338,75
338,78,0,0,0,102,0,102,338,78
338,79,109,0,394,0,0,503,338,79
338,80,44,0,0,0,0,44,338,80
338,82,109,0,237,0,0,346,338,82
338,84,0,0,226,0,0,226,338,84
338,87,0,0,337,0,0,337,338,87
338,90,62,0,0,0,0,62,338,90
338,92,295,0,0,0,0,295,338,92
338,97,58,0,0,0,0,58,338,97
338,99,0,0,118,0,0,118,338,99
338,100,810,0,226,109,0,1145,338,100
338,101,0,0,356,87,0,443,338,101
338,102,0,0,249,0,0,249,338,102
338,103,0,0,15,0,0,15,338,103
338,105,512,0,593,0,0,1105,338,105
338,106,0,35,389,33,301,758,338,106
338,107,1123,0,0,218,0,1341,338,107
338,108,85,0,0,0,0,85,338,108
338,109,0,0,1533,0,0,1533,338,109
338,113,207,0,0,0,0,207,338,113
338,115,207,0,0,0,0,207,338,115
338,116,0,0,384,0,0,384,338,116
338,118,18,0,0,0,0,18,338,118
338,119,1342,0,0,0,0,1342,338,119
338,121,436,0,0,0,0,436,338,121
338,123,0,0,399,0,0,399,338,123
338,126,0,0,478,0,0,478,338,126
338,127,0,0,348,0,0,348,338,127
338,131,0,0,0,0,934,934,338,131
338,137,0,0,333,0,0,333,338,137
338,138,0,0,124,0,0,124,338,138
338,140,0,0,190,0,0,190,338,140
338,152,0,0,498,0,0,498,338,152
338,161,295,0,0,0,0,295,338,161
338,165,295,0,0,0,0,295,338,165
338,171,0,0,109,0,0,109,338,171
338,183,0,0,961,0,0,961,338,183
338,218,0,0,639,0,0,639,338,218
338,230,207,0,0,0,0,207,338,230
338,237,26,0,0,0,0,26,338,237
338,257,433,0,0,0,0,433,338,257
338,261,0,0,0,268,0,268,338,261
338,272,38,0,0,0,0,38,338,272
338,275,122,0,0,0,0,122,338,275
338,288,0,0,134,0,0,134,338,288
338,300,0,0,134,0,0,134,338,300
338,301,377,0,0,0,0,377,338,301
338,305,207,0,0,0,0,207,338,305
338,312,0,0,653,0,0,653,338,312
338,315,0,0,200,0,0,200,338,315
338,317,69,0,0,0,0,69,338,317
338,319,17,0,0,0,0,17,338,319
338,321,0,0,134,0,0,134,338,321
338,327,154,0,0,0,0,154,338,327
338,332,0,0,463,0,0,463,338,332
338,334,0,0,1569,698,0,2267,338,334
338,335,527,0,701,0,0,1228,338,335
338,336,849,207,0,179,0,1235,338,336
338,337,2541,5383,664,0,0,8588,338,337
338,338,1222,15931,937,0,1868,19958,338,338
338,339,109,0,0,0,0,109,338,339
338,342,0,109,321,0,0,430,338,342
339,1,0,0,145,0,0,145,339,1
339,2,0,0,287,0,0,287,339,2
339,5,0,0,243,0,0,243,339,5
339,7,0,0,384,0,0,384,339,7
339,9,0,0,92,0,0,92,339,9
339,14,35,0,0,0,0,35,339,14
339,19,0,0,156,0,226,382,339,19
339,21,111,0,149,0,0,260,339,21
339,22,0,0,204,0,0,204,339,22
339,23,0,0,29,0,0,29,339,23
339,25,0,0,81,0,0,81,339,25
339,27,106,0,302,0,0,408,339,27
339,28,0,0,259,0,0,259,339,28
339,29,63,0,321,0,0,384,339,29
339,30,111,0,297,0,0,408,339,30
339,31,0,0,494,0,22,516,339,31
339,32,65,0,149,0,0,214,339,32
339,33,37,0,11,0,0,48,339,33
339,34,64,0,0,0,0,64,339,34
339,35,0,0,527,0,0,527,339,35
339,36,34,0,738,0,0,772,339,36
339,37,65,0,15,0,0,80,339,37
339,38,0,0,29,0,0,29,339,38
339,40,18,0,0,0,0,18,339,40
339,41,37,0,0,0,0,37,339,41
339,43,0,0,45,0,0,45,339,43
339,46,0,0,205,0,0,205,339,46
339,47,0,0,183,0,0,183,339,47
339,49,0,0,80,0,0,80,339,49
339,51,0,0,93,0,0,93,339,51
339,52,42,0,42,0,0,84,339,52
339,53,0,0,53,0,0,53,339,53
339,54,14,0,27,0,0,41,339,54
339,55,0,0,152,0,0,152,339,55
339,56,0,0,198,0,0,198,339,56
339,57,177,0,63,0,0,240,339,57
339,58,127,0,22,0,0,149,339,58
339,60,354,0,111,0,0,465,339,60
339,61,0,0,190,0,0,190,339,61
339,62,123,0,0,0,0,123,339,62
339,63,0,0,13,0,0,13,339,63
339,64,120,0,0,0,0,120,339,64
339,65,116,0,0,0,0,116,339,65
339,66,116,0,106,0,0,222,339,66
339,67,55,0,0,0,0,55,339,67
339,68,37,0,118,74,176,405,339,68
339,69,132,0,0,0,0,132,339,69
339,71,499,0,0,0,0,499,339,71
339,72,31,0,0,0,0,31,339,72
339,73,321,0,223,0,0,544,339,73
339,74,0,0,87,0,0,87,339,74
339,75,91,0,0,0,0,91,339,75
339,76,0,0,74,154,0,228,339,76
339,77,72,0,182,0,0,254,339,77
339,78,0,0,206,0,0,206,339,78
339,79,0,0,69,0,0,69,339,79
339,80,269,0,604,106,38,1017,339,80
339,81,56,0,30,0,0,86,339,81
339,82,31,0,868,0,476,1375,339,82
339,83,635,0,381,0,120,1136,339,83
339,84,141,0,51,0,0,192,339,84
339,85,0,0,48,0,0,48,339,85
339,86,0,0,85,0,0,85,339,86
339,87,67,0,193,167,0,427,339,87
339,88,101,0,616,0,0,717,339,88
339,89,0,0,135,0,0,135,339,89
339,90,62,0,0,0,0,62,339,90
339,92,0,0,5,0,0,5,339,92
339,93,260,0,67,0,0,327,339,93
339,95,102,0,111,150,0,363,339,95
339,96,394,0,140,0,0,534,339,96
339,97,191,0,326,813,109,1439,339,97
339,99,58,0,0,0,0,58,339,99
339,100,0,0,347,0,0,347,339,100
339,101,130,0,321,0,0,451,339,101
339,102,161,0,0,0,0,161,339,102
339,103,21,0,0,0,0,21,339,103
339,104,21,0,29,0,0,50,339,104
339,105,0,0,202,0,0,202,339,105
339,107,188,0,128,0,0,316,339,107
339,109,0,0,416,0,0,416,339,109
339,113,105,0,0,0,0,105,339,113
339,115,0,0,820,0,0,820,339,115
339,122,0,0,519,0,0,519,339,122
339,123,0,0,237,0,0,237,339,123
339,126,261,0,587,0,0,848,339,126
339,127,0,0,295,0,0,295,339,127
339,128,0,0,24,0,0,24,339,128
339,133,0,0,229,0,0,229,339,133
339,134,0,0,666,0,0,666,339,134
339,137,0,0,333,0,0,333,339,137
339,139,0,0,215,0,0,215,339,139
339,147,0,0,151,0,0,151,339,147
339,156,35,0,0,0,0,35,339,156
339,157,154,0,228,0,0,382,339,157
339,162,0,0,611,0,0,611,339,162
339,166,330,0,0,0,0,330,339,166
339,169,0,0,160,0,0,160,339,169
339,176,0,0,582,0,0,582,339,176
339,181,0,0,888,0,0,888,339,181
339,193,0,0,207,0,0,207,339,193
339,199,0,0,1057,0,0,1057,339,199
339,200,0,0,302,0,0,302,339,200
339,209,0,0,212,0,0,212,339,209
339,213,0,0,143,0,0,143,339,213
339,215,0,0,121,0,0,121,339,215
339,226,0,0,521,0,0,521,339,226
339,236,41,0,0,0,0,41,339,236
339,237,0,0,47,0,0,47,339,237
339,239,0,0,350,0,0,350,339,239
339,243,570,0,0,0,0,570,339,243
339,254,0,0,290,0,0,290,339,254
339,256,0,0,434,0,0,434,339,256
339,257,0,0,433,0,0,433,339,257
339,260,225,0,0,0,0,225,339,260
339,268,79,0,36,0,0,115,339,268
339,269,445,0,0,0,0,445,339,269
339,275,0,0,377,0,0,377,339,275
339,279,0,0,369,0,0,369,339,279
339,280,265,0,0,0,0,265,339,280
339,281,0,0,275,0,0,275,339,281
339,283,0,0,130,0,0,130,339,283
339,288,0,0,95,575,0,670,339,288
339,298,0,0,250,0,0,250,339,298
339,300,152,0,388,0,0,540,339,300
339,301,79,0,176,0,0,255,339,301
339,302,76,0,0,0,0,76,339,302
339,303,0,0,38,0,0,38,339,303
339,305,376,0,0,0,0,376,339,305
339,309,0,0,0,162,0,162,339,309
339,315,0,0,664,0,0,664,339,315
339,316,125,0,147,166,0,438,339,316
339,317,58,0,46,0,20,124,339,317
339,318,0,0,75,0,0,75,339,318
339,319,103,0,12,0,0,115,339,319
339,320,77,0,0,0,0,77,339,320
339,321,374,0,166,0,161,701,339,321
339,322,292,0,0,0,0,292,339,322
339,326,498,0,1272,0,0,1770,339,326
339,327,169,0,179,0,0,348,339,327
339,328,267,27,0,129,0,423,339,328
339,329,555,0,356,0,0,911,339,329
339,330,162,0,707,0,0,869,339,330
339,331,0,0,325,0,0,325,339,331
339,332,172,0,616,0,0,788,339,332
339,333,482,0,115,0,0,597,339,333
339,334,833,1599,113,108,0,2653,339,334
339,335,283,0,1168,583,411,2445,339,335
339,336,499,0,1170,0,0,1669,339,336
339,337,1335,0,501,296,0,2132,339,337
339,338,286,0,305,0,0,591,339,338
339,339,442,3352,32,0,0,3826,339,339
339,340,1064,227,371,108,207,1977,339,340
339,341,736,540,0,0,204,1480,339,341
339,342,1964,875,1939,0,0,4778,339,342
340,1,0,0,519,0,0,519,340,1
340,2,37,0,131,0,0,168,340,2
340,3,0,0,127,0,0,127,340,3
340,5,0,0,425,0,0,425,340,5
340,6,0,0,270,0,0,270,340,6
340,9,0,0,73,0,0,73,340,9
340,18,13,0,0,0,0,13,340,18
340,22,0,0,37,0,0,37,340,22
340,23,37,0,0,0,0,37,340,23
340,24,0,0,29,0,0,29,340,24
340,27,0,0,37,0,0,37,340,27
340,28,0,0,37,0,0,37,340,28
340,29,0,0,50,0,0,50,340,29
340,30,136,0,129,0,0,265,340,30
340,31,77,0,391,0,0,468,340,31
340,32,0,0,119,0,0,119,340,32
340,36,118,0,0,0,0,118,340,36
340,43,98,0,63,0,0,161,340,43
340,49,0,0,74,0,0,74,340,49
340,51,37,0,0,0,0,37,340,51
340,56,0,0,74,0,0,74,340,56
340,57,0,0,21,0,0,21,340,57
340,63,37,0,13,0,0,50,340,63
340,64,73,0,0,0,0,73,340,64
340,65,137,0,0,0,31,168,340,65
340,66,26,0,0,135,0,161,340,66
340,68,552,0,37,0,0,589,340,68
340,69,0,0,0,58,0,58,340,69
340,70,0,0,91,0,0,91,340,70
340,73,37,0,136,0,0,173,340,73
340,75,13,0,0,0,0,13,340,75
340,76,184,0,0,0,0,184,340,76
340,77,0,0,101,0,0,101,340,77
340,78,37,0,44,0,0,81,340,78
340,79,151,0,28,0,0,179,340,79
340,80,13,0,178,13,0,204,340,80
340,81,63,0,117,129,53,362,340,81
340,82,58,37,485,26,0,606,340,82
340,83,279,0,63,21,0,363,340,83
340,84,21,0,0,0,0,21,340,84
340,87,33,0,0,0,0,33,340,87
340,88,138,0,0,220,0,358,340,88
340,89,0,0,21,0,0,21,340,89
340,90,0,0,0,44,0,44,340,90
340,94,77,0,0,0,0,77,340,94
340,95,194,0,0,37,0,231,340,95
340,96,235,0,117,0,0,352,340,96
340,97,260,0,29,0,0,289,340,97
340,99,0,0,37,0,0,37,340,99
340,100,6,0,87,0,0,93,340,100
340,101,13,0,0,0,53,66,340,101
340,102,0,0,0,37,0,37,340,102
340,103,10,0,0,33,0,43,340,103
340,105,0,0,0,37,0,37,340,105
340,106,37,0,0,0,0,37,340,106
340,107,387,0,0,0,0,387,340,107
340,113,0,0,117,0,0,117,340,113
340,127,21,0,0,0,0,21,340,127
340,135,0,0,37,0,0,37,340,135
340,139,373,0,0,0,0,373,340,139
340,147,0,0,119,0,0,119,340,147
340,154,0,0,37,0,0,37,340,154
340,157,0,0,0,154,0,154,340,157
340,166,0,0,519,0,0,519,340,166
340,167,13,0,0,0,0,13,340,167
340,196,0,0,338,0,0,338,340,196
340,217,0,0,170,0,0,170,340,217
340,229,0,0,365,0,0,365,340,229
340,236,67,0,0,0,0,67,340,236
340,255,0,0,464,0,0,464,340,255
340,268,27,0,0,0,0,27,340,268
340,270,108,0,0,0,0,108,340,270
340,281,159,0,0,0,0,159,340,281
340,282,13,0,0,0,0,13,340,282
340,295,0,0,108,0,0,108,340,295
340,300,13,0,345,0,0,358,340,300
340,302,0,0,287,26,0,313,340,302
340,303,26,0,91,0,0,117,340,303
340,305,0,0,669,0,0,669,340,305
340,307,0,0,259,0,0,259,340,307
340,314,0,0,573,0,0,573,340,314
340,316,85,56,0,0,0,141,340,316
340,317,85,80,15,0,0,180,340,317
340,318,13,0,26,0,0,39,340,318
340,319,111,0,228,0,0,339,340,319
340,320,0,0,299,0,0,299,340,320
340,321,222,0,0,0,0,222,340,321
340,326,600,0,0,0,0,600,340,326
340,327,268,0,0,0,0,268,340,327
340,329,0,0,121,69,0,190,340,329
340,330,0,0,146,0,0,146,340,330
340,331,807,0,0,0,0,807,340,331
340,332,734,0,0,0,0,734,340,332
340,333,184,0,0,0,0,184,340,333
340,334,1190,0,0,565,0,1755,340,334
340,335,283,0,0,0,0,283,340,335
340,336,208,0,168,0,0,376,340,336
340,337,132,0,0,0,0,132,340,337
340,339,899,126,372,108,207,1712,340,339
340,340,1039,2196,71,162,312,3780,340,340
340,341,108,170,0,0,0,278,340,341
340,342,1170,696,73,0,0,1939,340,342
341,2,0,0,298,0,0,298,341,2
341,5,0,0,110,0,0,110,341,5
341,6,0,0,139,0,0,139,341,6
341,20,0,0,230,0,0,230,341,20
341,24,0,0,136,0,0,136,341,24
341,26,0,0,128,0,0,128,341,26
341,28,264,0,0,0,0,264,341,28
341,29,0,0,149,0,0,149,341,29
341,30,37,0,0,0,0,37,341,30
341,32,0,0,77,0,0,77,341,32
341,35,77,0,125,0,0,202,341,35
341,36,0,0,140,0,0,140,341,36
341,49,0,0,0,74,0,74,341,49
341,51,0,0,56,0,0,56,341,51
341,53,0,0,452,0,0,452,341,53
341,68,77,0,136,37,0,250,341,68
341,70,0,0,154,0,0,154,341,70
341,71,193,0,0,0,0,193,341,71
341,73,77,0,0,0,0,77,341,73
341,74,91,0,0,0,0,91,341,74
341,76,115,0,0,0,0,115,341,76
341,77,0,0,139,0,0,139,341,77
341,79,118,0,136,0,0,254,341,79
341,80,88,0,0,0,0,88,341,80
341,82,286,0,313,0,0,599,341,82
341,83,251,0,136,0,0,387,341,83
341,96,0,0,0,77,0,77,341,96
341,97,0,0,0,56,0,56,341,97
341,100,0,0,0,112,0,112,341,100
341,103,18,0,0,0,0,18,341,103
341,106,0,0,15,0,0,15,341,106
341,126,77,0,0,0,0,77,341,126
341,131,0,0,140,0,0,140,341,131
341,163,125,0,0,277,0,402,341,163
341,168,0,0,204,0,0,204,341,168
341,178,37,0,0,0,0,37,341,178
341,205,0,0,140,0,0,140,341,205
341,209,466,0,0,0,0,466,341,209
341,276,33,0,0,0,0,33,341,276
341,279,0,0,0,862,0,862,341,279
341,292,0,0,0,509,0,509,341,292
341,300,86,0,173,0,0,259,341,300
341,301,140,0,0,0,0,140,341,301
341,303,26,0,0,0,0,26,341,303
341,304,77,0,0,0,0,77,341,304
341,316,253,932,0,398,0,1583,341,316
341,317,146,0,0,29,0,175,341,317
341,325,999,0,0,0,0,999,341,325
341,327,0,0,31,356,0,387,341,327
341,329,328,0,0,773,0,1101,341,329
341,330,646,0,0,0,0,646,341,330
341,331,0,0,343,682,0,1025,341,331
341,332,33,0,36,0,0,69,341,332
341,333,402,0,419,0,0,821,341,333
341,334,0,0,0,127,0,127,341,334
341,335,786,0,789,0,0,1575,341,335
341,336,0,0,0,359,0,359,341,336
341,337,114,0,0,0,0,114,341,337
341,339,409,253,0,0,204,866,341,339
341,340,269,110,0,0,0,379,341,340
341,341,1679,4080,0,0,0,5759,341,341
341,342,1978,1712,193,0,47,3930,341,342
342,1,0,0,373,0,0,373,342,1
342,2,373,0,0,0,0,373,342,2
342,7,0,0,558,0,0,558,342,7
342,25,0,0,373,0,0,373,342,25
342,28,0,0,299,0,0,299,342,28
342,29,0,0,129,0,0,129,342,29
342,30,0,0,558,0,0,558,342,30
342,32,0,0,322,0,0,322,342,32
342,35,0,0,808,0,0,808,342,35
342,54,0,0,0,558,0,558,342,54
342,55,0,0,287,0,0,287,342,55
342,70,746,0,0,0,0,746,342,70
342,73,0,0,1359,0,0,1359,342,73
342,74,0,0,296,0,0,296,342,74
342,77,280,0,373,0,0,653,342,77
342,80,452,0,0,0,0,452,342,80
342,81,43,0,0,0,0,43,342,81
342,82,540,0,811,33,0,1384,342,82
342,83,132,0,178,0,0,310,342,83
342,84,51,0,175,0,0,226,342,84
342,90,0,0,129,0,0,129,342,90
342,100,0,0,140,0,0,140,342,100
342,101,166,0,0,0,0,166,342,101
342,103,215,0,0,0,0,215,342,103
342,105,167,0,0,0,0,167,342,105
342,110,373,0,0,0,0,373,342,110
342,113,167,0,0,0,0,167,342,113
342,117,1198,0,0,0,0,1198,342,117
342,131,198,0,0,0,0,198,342,131
342,138,0,0,167,0,0,167,342,138
342,165,0,0,373,0,0,373,342,165
342,168,98,0,0,0,0,98,342,168
342,174,0,0,357,0,0,357,342,174
342,202,0,0,444,0,0,444,342,202
342,234,0,0,264,0,0,264,342,234
342,236,41,0,0,0,0,41,342,236
342,237,0,0,26,0,0,26,342,237
342,254,0,0,443,0,0,443,342,254
342,260,0,0,232,0,0,232,342,260
342,271,373,0,0,0,0,373,342,271
342,287,473,0,0,0,0,473,342,287
342,300,0,0,529,0,0,529,342,300
342,316,373,0,0,110,0,483,342,316
342,317,21,0,0,0,0,21,342,317
342,321,0,0,0,287,0,287,342,321
342,322,77,0,84,0,0,161,342,322
342,327,27,0,0,0,0,27,342,327
342,328,660,0,0,556,0,1216,342,328
342,329,373,551,0,321,0,1245,342,329
342,330,4586,500,766,102,0,5954,342,330
342,331,178,373,0,0,0,551,342,331
342,332,0,0,943,0,0,943,342,332
342,333,132,0,814,310,0,1256,342,333
342,334,1090,708,629,1032,0,3459,342,334
342,335,3087,331,380,384,0,4182,342,335
342,337,198,0,0,437,0,635,342,337
342,338,0,109,321,0,0,430,342,338
342,339,1814,1721,1332,167,0,5034,342,339
342,340,1067,696,0,0,0,1763,342,340
342,341,1534,1550,193,0,47,3324,342,341
342,342,4381,9689,313,0,0,14383,342,342
