geo_code1,geo_code2,car,foot,public,other,bike,all
1,1,128,25384,0,0,0,25512
1,2,86,4676,167,0,0,4929
1,3,0,3429,485,0,0,3914
1,4,192,1151,233,98,0,1674
1,5,39,3225,301,67,86,3718
1,6,152,2629,280,0,0,3061
1,7,0,19,0,234,0,253
1,8,0,0,90,0,0,90
1,9,0,0,101,0,0,101
1,10,0,0,161,0,0,161
1,12,43,0,0,0,0,43
1,13,0,0,12,0,0,12
1,14,0,30,18,0,0,48
1,16,111,924,624,122,0,1781
1,17,0,0,150,0,0,150
1,18,299,0,460,0,0,759
1,19,403,22,273,0,0,698
1,20,22,254,739,83,0,1098
1,21,59,0,373,0,0,432
1,22,0,0,433,103,0,536
1,23,869,0,1016,393,0,2278
1,24,0,1380,897,37,0,2314
1,25,0,240,0,0,0,240
1,26,0,115,331,0,0,446
1,27,0,0,636,81,0,717
1,28,0,60,798,26,0,884
1,29,0,0,138,33,0,171
1,30,227,43,271,0,0,541
1,31,0,128,605,0,0,733
1,32,21,0,383,0,0,404
1,34,23,0,192,0,0,215
1,35,0,0,1489,0,0,1489
1,36,64,0,1163,0,0,1227
1,37,0,0,667,0,0,667
1,38,0,0,29,0,0,29
1,39,0,0,181,0,0,181
1,40,64,0,69,0,0,133
1,41,0,0,657,0,0,657
1,43,160,0,624,0,0,784
1,44,0,0,244,0,0,244
1,45,0,0,442,0,0,442
1,47,0,0,383,0,0,383
1,48,0,0,445,0,0,445
1,49,0,0,206,0,0,206
1,50,0,0,24,0,0,24
1,51,193,0,440,0,0,633
1,52,61,0,485,0,0,546
1,53,0,0,19,0,0,19
1,54,0,0,149,0,0,149
1,56,0,0,224,0,0,224
1,57,0,0,350,0,0,350
1,58,0,0,546,0,0,546
1,59,0,0,267,0,0,267
1,60,0,0,664,0,0,664
1,61,415,0,586,0,0,1001
1,62,49,0,56,0,0,105
1,63,0,0,63,0,0,63
1,64,0,0,95,0,0,95
1,65,116,0,244,0,0,360
1,66,0,0,103,0,0,103
1,67,161,0,60,0,0,221
1,68,0,0,396,0,0,396
1,74,0,0,93,0,0,93
1,75,0,0,258,0,0,258
1,76,38,0,148,72,0,258
1,77,0,0,43,0,0,43
1,78,203,0,222,102,0,527
1,79,0,0,386,0,0,386
1,80,0,0,442,0,0,442
1,81,0,0,37,0,0,37
1,82,31,0,83,0,0,114
1,83,69,0,589,0,0,658
1,84,51,0,43,51,0,145
1,85,0,0,12,0,0,12
1,87,67,0,33,0,0,100
1,88,0,0,389,404,0,793
1,89,0,0,72,0,0,72
1,90,0,0,128,0,0,128
1,92,0,0,4,0,0,4
1,93,0,0,879,0,0,879
1,96,0,0,134,0,0,134
1,97,0,0,116,0,0,116
1,100,150,0,0,0,0,150
1,101,0,0,321,0,0,321
1,102,0,0,217,0,0,217
1,103,0,0,11,0,0,11
1,104,21,0,0,0,0,21
1,105,150,0,184,0,0,334
1,106,0,0,0,60,0,60
1,107,0,0,108,0,0,108
1,108,0,0,14,0,0,14
1,236,33,0,414,0,59,506
1,237,26,0,70,0,0,96
1,238,0,0,309,0,0,309
1,239,0,0,345,0,0,345
1,240,0,0,434,206,0,640
1,241,53,0,0,0,0,53
1,250,0,0,123,0,0,123
1,251,0,0,200,0,0,200
1,252,105,0,380,0,0,485
1,254,0,0,1181,0,0,1181
2,1,86,5061,79,0,0,5226
2,2,0,12436,0,0,0,12436
2,3,0,1805,0,0,331,2136
2,4,0,474,93,0,0,567
2,5,612,775,193,0,0,1580
2,6,0,2109,1085,257,0,3451
2,7,0,1976,342,0,0,2318
2,9,92,66,92,0,0,250
2,11,0,0,12,0,0,12
2,12,0,0,347,0,0,347
2,13,0,111,15,0,0,126
2,14,16,0,476,0,0,492
2,15,0,0,351,0,0,351
2,16,0,408,193,0,0,601
2,17,0,863,127,143,0,1133
2,18,128,0,299,0,0,427
2,19,0,0,28,0,0,28
2,20,0,138,425,0,212,775
2,22,0,178,67,0,0,245
2,23,0,63,141,0,41,245
2,24,0,175,517,0,0,692
2,25,0,74,325,0,0,399
2,26,0,0,139,0,0,139
2,27,60,0,169,60,0,289
2,30,64,58,0,64,0,186
2,31,128,0,612,49,0,789
2,32,0,0,190,0,0,190
2,33,15,0,17,0,0,32
2,34,0,0,42,77,0,119
2,35,0,0,0,40,0,40
2,36,0,0,131,0,0,131
2,37,0,0,93,0,0,93
2,38,0,0,0,35,0,35
2,39,0,0,85,0,0,85
2,41,1364,0,90,0,0,1454
2,42,0,24,30,0,0,54
2,43,63,0,174,63,0,300
2,44,455,0,165,0,0,620
2,45,240,0,1300,0,0,1540
2,48,247,0,269,0,0,516
2,49,0,0,197,0,0,197
2,50,0,0,98,74,0,172
2,51,104,0,93,0,0,197
2,53,0,0,58,0,0,58
2,54,0,0,268,0,0,268
2,55,0,0,14,0,0,14
2,56,0,0,381,0,0,381
2,57,0,0,171,0,0,171
2,58,100,0,615,0,0,715
2,59,0,0,1213,0,0,1213
2,60,0,0,386,0,0,386
2,62,26,0,0,0,0,26
2,64,274,0,104,0,0,378
2,65,0,0,104,0,0,104
2,66,58,0,0,0,0,58
2,67,0,0,88,0,0,88
2,68,0,0,281,0,0,281
2,69,80,0,0,0,0,80
2,70,84,0,160,0,0,244
2,74,0,0,489,0,0,489
2,75,46,0,126,0,0,172
2,77,0,0,188,0,0,188
2,78,102,0,52,0,0,154
2,79,105,0,57,0,0,162
2,80,26,0,88,0,64,178
2,81,0,0,92,0,0,92
2,82,0,0,421,0,0,421
2,83,0,0,69,0,0,69
2,84,0,0,270,0,0,270
2,85,0,0,11,0,0,11
2,86,0,0,64,0,0,64
2,88,0,0,413,0,0,413
2,90,0,0,0,0,89,89
2,93,100,0,44,0,0,144
2,95,37,0,75,0,0,112
2,96,66,0,0,0,0,66
2,97,70,0,0,0,0,70
2,99,0,0,208,0,0,208
2,100,0,0,150,0,0,150
2,101,0,0,166,0,0,166
2,103,0,0,20,0,0,20
2,105,0,0,78,0,0,78
2,106,0,0,60,0,0,60
2,107,0,0,99,0,0,99
2,236,0,0,15,0,0,15
2,237,26,0,0,0,0,26
2,239,107,0,116,0,0,223
2,241,0,0,126,0,0,126
2,250,254,0,396,0,0,650
3,1,0,3665,485,0,0,4150
3,2,0,1805,0,0,331,2136
3,3,0,12004,0,0,0,12004
3,4,0,198,0,0,0,198
3,5,156,0,156,39,0,351
3,6,0,156,0,0,0,156
3,7,0,0,78,0,0,78
3,8,0,0,156,0,0,156
3,12,0,0,170,0,0,170
3,15,0,320,393,0,0,713
3,16,0,0,569,68,0,637
3,17,0,106,0,0,0,106
3,18,184,556,170,0,0,910
3,20,0,307,465,312,0,1084
3,21,904,0,250,0,0,1154
3,23,0,88,145,0,0,233
3,24,0,4433,0,0,0,4433
3,25,0,0,225,60,0,285
3,26,0,127,515,90,0,732
3,27,355,0,46,0,0,401
3,28,38,0,38,0,0,76
3,29,0,0,236,0,0,236
3,30,405,0,0,0,0,405
3,31,87,0,30,0,0,117
3,32,0,0,466,0,0,466
3,33,31,0,0,0,0,31
3,34,39,0,0,0,0,39
3,35,135,0,0,0,0,135
3,36,0,0,663,0,0,663
3,38,0,0,35,0,0,35
3,43,126,0,238,509,0,873
3,49,0,0,439,244,0,683
3,50,0,0,507,0,0,507
3,52,0,0,61,0,0,61
3,53,0,0,138,0,0,138
3,54,0,0,37,0,0,37
3,56,0,0,32,0,0,32
3,57,434,0,199,90,0,723
3,58,0,0,200,0,0,200
3,59,0,0,481,0,0,481
3,61,724,0,0,0,0,724
3,62,0,0,27,0,0,27
3,64,0,0,352,0,0,352
3,66,0,0,118,0,0,118
3,67,0,0,171,80,0,251
3,68,0,0,95,0,0,95
3,69,0,0,253,80,0,333
3,74,0,0,656,0,0,656
3,76,309,0,38,0,0,347
3,78,0,0,0,176,0,176
3,79,116,0,82,0,0,198
3,81,111,0,115,0,0,226
3,82,0,0,436,0,0,436
3,83,0,0,443,0,0,443
3,84,51,0,47,45,0,143
3,85,0,0,24,47,0,71
3,87,33,0,240,0,0,273
3,90,0,0,123,0,0,123
3,92,0,0,867,0,0,867
3,93,0,0,0,312,0,312
3,94,0,0,31,0,0,31
3,96,0,0,27,0,0,27
3,103,0,0,32,0,0,32
3,237,0,0,26,0,0,26
3,239,0,0,610,0,0,610
3,240,0,0,109,0,0,109
3,241,0,0,26,0,0,26
3,250,0,0,118,0,0,118
3,251,0,0,645,0,0,645
3,254,0,0,351,0,0,351
4,1,0,949,0,98,0,1047
4,2,0,327,101,214,0,642
4,3,0,198,0,0,0,198
4,4,372,11811,0,0,0,12183
4,5,0,2190,0,455,287,2932
4,8,159,159,90,0,0,408
4,15,0,0,214,0,0,214
4,16,0,0,178,0,0,178
4,17,0,0,64,0,0,64
4,18,198,0,0,0,0,198
4,20,913,0,0,0,0,913
4,21,0,0,206,0,0,206
4,22,0,0,73,0,0,73
4,24,276,445,0,0,0,721
4,25,0,3850,0,0,0,3850
4,26,0,1347,0,0,94,1441
4,27,619,970,0,913,0,2502
4,28,0,0,102,0,0,102
4,29,127,300,0,0,0,427
4,30,64,0,0,58,660,782
4,31,2147,2767,487,0,0,5401
4,32,21,562,272,0,0,855
4,33,0,0,8,0,0,8
4,34,0,77,42,0,43,162
4,35,162,744,1565,0,0,2471
4,36,0,131,466,0,0,597
4,40,0,0,18,0,0,18
4,43,0,0,742,0,0,742
4,45,0,0,246,0,0,246
4,48,247,0,0,0,0,247
4,53,643,0,0,0,0,643
4,55,0,0,72,0,0,72
4,56,0,0,0,453,0,453
4,57,0,0,248,447,0,695
4,58,0,0,455,0,0,455
4,60,214,0,0,0,0,214
4,61,0,0,204,0,0,204
4,64,0,0,193,0,0,193
4,66,0,0,101,0,0,101
4,67,0,0,583,0,0,583
4,68,0,0,215,0,0,215
4,69,0,0,233,0,0,233
4,74,0,0,191,947,0,1138
4,75,70,0,38,0,0,108
4,76,0,0,495,0,0,495
4,77,0,0,241,140,0,381
4,78,88,0,11,0,0,99
4,79,239,122,1305,0,0,1666
4,80,44,0,44,0,0,88
4,81,150,0,0,0,0,150
4,82,0,0,72,0,0,72
4,84,0,0,55,0,0,55
4,85,11,0,0,0,0,11
4,86,0,0,18,20,0,38
4,87,0,0,36,0,0,36
4,88,0,101,0,0,0,101
4,89,0,0,198,168,0,366
4,92,0,0,1,0,0,1
4,93,0,0,561,0,0,561
4,94,35,0,35,0,0,70
4,96,0,0,77,0,0,77
4,99,272,0,0,214,0,486
4,100,0,0,742,0,0,742
4,101,130,0,0,0,0,130
4,102,30,0,0,0,0,30
4,237,0,0,26,0,0,26
4,238,0,0,178,0,0,178
4,252,0,0,51,0,0,51
5,1,77,2131,354,67,0,2629
5,2,270,973,193,303,0,1739
5,3,156,156,156,0,0,468
5,4,0,2770,73,455,287,3585
5,5,0,35101,0,0,86,35187
5,6,67,5356,0,0,0,5423
5,7,0,0,210,0,0,210
5,8,0,0,88,0,121,209
5,9,0,92,208,0,29,329
5,12,0,0,191,0,0,191
5,13,0,0,59,360,0,419
5,14,0,0,197,37,0,234
5,15,0,0,59,0,0,59
5,16,0,0,68,0,0,68
5,17,0,0,26,0,0,26
5,18,0,0,691,145,0,836
5,19,296,0,285,365,0,946
5,20,0,0,276,0,0,276
5,21,0,0,467,0,0,467
5,22,178,0,125,67,0,370
5,23,0,0,29,0,0,29
5,24,0,0,928,0,0,928
5,25,0,135,162,0,0,297
5,27,106,60,1096,31,86,1379
5,28,0,102,1039,0,0,1141
5,29,0,333,265,0,0,598
5,30,0,281,263,301,0,845
5,31,348,1253,518,0,0,2119
5,32,0,93,856,0,0,949
5,33,23,0,15,0,0,38
5,34,587,0,39,39,0,665
5,35,0,2734,1820,0,234,4788
5,36,139,326,1224,95,34,1818
5,37,0,0,20,0,0,20
5,40,0,0,18,0,0,18
5,41,0,0,55,0,0,55
5,42,0,0,0,360,0,360
5,43,126,0,1629,0,0,1755
5,44,42,0,0,0,0,42
5,45,240,0,483,166,0,889
5,49,0,0,547,0,0,547
5,50,74,0,0,0,0,74
5,51,0,0,456,104,0,560
5,52,0,0,61,0,0,61
5,53,0,0,576,267,0,843
5,54,37,0,37,0,0,74
5,55,0,0,72,0,0,72
5,56,1357,0,148,0,0,1505
5,57,155,0,521,0,0,676
5,58,0,0,100,0,0,100
5,59,0,0,0,452,0,452
5,60,0,0,370,69,0,439
5,61,72,0,1789,0,0,1861
5,62,81,0,29,27,0,137
5,63,62,0,176,0,0,238
5,64,120,0,0,0,0,120
5,66,116,0,0,0,0,116
5,67,18,0,53,88,0,159
5,68,640,0,97,0,0,737
5,69,80,0,248,0,0,328
5,70,0,0,22,0,0,22
5,75,112,0,538,0,0,650
5,76,0,0,142,0,0,142
5,77,0,0,531,0,0,531
5,78,0,0,455,0,0,455
5,79,0,0,325,101,0,426
5,80,88,0,502,161,0,751
5,81,56,0,56,0,0,112
5,82,199,0,128,162,0,489
5,83,224,0,213,49,0,486
5,84,45,0,1451,0,0,1496
5,85,0,0,52,11,0,63
5,86,0,0,48,18,0,66
5,87,0,0,91,0,0,91
5,88,666,0,909,291,200,2066
5,90,80,0,234,0,0,314
5,92,0,0,4,0,0,4
5,93,0,0,232,0,0,232
5,94,305,0,77,0,0,382
5,98,7,0,0,0,0,7
5,99,0,0,209,0,0,209
5,100,0,0,274,21,0,295
5,101,0,0,691,0,0,691
5,102,114,0,313,49,0,476
5,103,0,0,38,0,0,38
5,104,0,0,21,0,0,21
5,105,128,0,0,0,0,128
5,107,0,0,176,0,0,176
5,236,0,0,51,0,0,51
5,237,0,0,47,0,0,47
5,240,235,0,0,512,0,747
5,250,0,0,108,0,0,108
5,251,0,0,200,0,0,200
5,252,0,0,126,0,0,126
6,1,152,2084,305,0,0,2541
6,2,0,2051,1475,126,0,3652
6,3,0,156,0,0,0,156
6,4,0,26,0,0,0,26
6,5,204,3914,0,0,0,4118
6,6,240,17024,0,0,0,17264
6,7,0,2118,0,190,340,2648
6,9,0,69,40,0,162,271
6,10,0,0,581,0,0,581
6,11,0,0,24,0,0,24
6,12,257,72,354,159,0,842
6,13,0,0,40,0,0,40
6,15,0,0,53,0,0,53
6,17,0,369,198,0,0,567
6,19,0,0,276,0,0,276
6,21,0,0,83,0,0,83
6,22,0,495,73,96,0,664
6,23,0,0,92,0,0,92
6,24,0,169,350,0,0,519
6,25,0,162,0,0,0,162
6,26,0,0,1085,71,0,1156
6,27,0,36,97,0,0,133
6,28,0,0,251,0,0,251
6,29,80,0,0,257,0,337
6,30,0,111,0,0,187,298
6,31,0,215,345,94,0,654
6,32,0,0,488,0,0,488
6,34,0,0,42,0,0,42
6,35,0,5117,683,0,0,5800
6,36,0,0,163,0,649,812
6,37,0,0,704,0,0,704
6,41,0,0,378,0,0,378
6,42,0,0,511,0,0,511
6,43,63,0,1198,69,0,1330
6,47,0,0,107,0,0,107
6,50,0,0,74,0,0,74
6,51,0,0,104,0,0,104
6,53,0,0,58,0,0,58
6,54,0,0,14,0,0,14
6,55,0,0,168,0,0,168
6,56,0,0,529,0,0,529
6,57,0,0,424,0,0,424
6,59,0,0,257,0,0,257
6,61,204,0,619,0,0,823
6,63,23,0,0,0,0,23
6,64,120,0,0,120,0,240
6,66,58,0,0,0,0,58
6,67,80,0,0,0,0,80
6,68,0,0,121,0,0,121
6,69,0,0,79,0,0,79
6,70,0,0,91,0,0,91
6,74,0,0,55,0,0,55
6,75,0,0,61,0,0,61
6,76,0,0,321,0,0,321
6,77,0,0,435,0,0,435
6,78,102,0,111,102,148,463
6,79,0,23,85,0,0,108
6,80,0,0,44,223,0,267
6,82,0,0,257,0,0,257
6,83,0,0,363,0,0,363
6,84,40,0,102,45,0,187
6,86,9,0,0,0,0,9
6,87,0,0,36,0,0,36
6,88,0,0,0,440,0,440
6,89,0,0,231,0,0,231
6,90,62,0,76,0,0,138
6,92,3,0,1,0,0,4
6,93,0,0,1486,0,0,1486
6,94,0,0,38,0,0,38
6,100,0,0,249,0,0,249
6,103,0,0,6,0,0,6
6,104,21,0,11,0,0,32
6,105,222,0,0,0,0,222
6,236,0,0,28,0,0,28
6,238,0,0,294,0,0,294
6,240,308,0,0,0,0,308
6,254,0,0,280,0,0,280
7,1,0,19,0,234,0,253
7,2,882,1693,177,0,0,2752
7,3,0,0,78,0,0,78
7,5,37,0,311,0,0,348
7,6,0,2020,0,190,340,2550
7,7,265,18102,0,0,58,18425
7,8,159,3449,0,0,94,3702
7,9,0,1600,29,26,58,1713
7,10,155,43,0,0,0,198
7,11,0,67,36,0,0,103
7,12,234,636,198,235,0,1303
7,13,0,269,314,144,24,751
7,15,0,179,0,0,0,179
7,16,235,397,0,0,0,632
7,17,0,98,46,106,0,250
7,18,182,0,0,0,0,182
7,20,76,0,0,0,0,76
7,23,0,0,322,0,0,322
7,24,0,0,60,0,0,60
7,25,0,0,174,0,0,174
7,27,469,0,60,0,0,529
7,28,0,0,26,0,0,26
7,29,80,0,0,0,0,80
7,31,0,0,221,0,0,221
7,32,0,0,234,0,0,234
7,34,0,0,0,62,0,62
7,35,0,1806,139,0,0,1945
7,36,114,131,0,448,0,693
7,37,80,83,97,0,0,260
7,38,71,35,32,0,0,138
7,40,9,0,0,0,0,9
7,41,11,0,0,0,0,11
7,42,0,0,81,0,0,81
7,43,167,0,500,45,0,712
7,44,0,0,534,0,0,534
7,48,0,0,305,0,0,305
7,49,0,0,100,0,0,100
7,56,0,0,440,0,0,440
7,57,155,0,0,0,0,155
7,59,234,0,1158,0,0,1392
7,60,0,0,102,0,0,102
7,61,0,0,210,0,0,210
7,62,26,0,29,0,0,55
7,64,0,0,120,0,0,120
7,66,0,0,0,58,0,58
7,67,55,0,0,0,0,55
7,68,150,0,100,746,0,996
7,69,0,0,75,0,0,75
7,74,0,0,83,0,0,83
7,75,0,0,161,0,0,161
7,76,0,0,42,0,0,42
7,78,111,0,0,0,0,111
7,79,84,0,42,0,0,126
7,81,98,0,0,78,0,176
7,83,0,0,304,0,0,304
7,84,297,0,0,0,0,297
7,85,11,0,0,144,0,155
7,86,18,0,0,18,0,36
7,88,420,0,163,0,0,583
7,89,0,0,392,0,0,392
7,92,0,0,0,189,0,189
7,93,40,0,0,0,0,40
7,94,0,0,83,0,0,83
7,95,75,0,204,0,0,279
7,99,0,0,129,0,0,129
7,100,0,0,554,0,0,554
7,106,0,0,0,16,0,16
7,107,99,0,0,0,0,99
7,239,45,0,0,0,0,45
7,250,26,0,0,0,0,26
7,251,200,0,0,0,0,200
8,1,0,0,90,0,0,90
8,2,0,83,0,0,0,83
8,3,0,0,156,0,0,156
8,4,159,159,90,0,0,408
8,5,0,0,195,0,121,316
8,7,159,3574,0,0,0,3733
8,8,395,12602,271,0,0,13268
8,9,147,644,0,0,0,791
8,10,0,8,48,0,0,56
8,13,83,0,0,166,0,249
8,14,302,0,0,0,0,302
8,15,0,0,90,0,0,90
8,17,0,20,90,0,0,110
8,19,0,0,111,0,0,111
8,20,83,0,320,0,0,403
8,23,0,0,0,83,0,83
8,24,0,0,125,0,0,125
8,27,0,0,38,0,0,38
8,30,0,0,0,160,0,160
8,31,0,0,280,348,0,628
8,35,0,1356,252,0,0,1608
8,36,111,0,211,0,0,322
8,37,0,993,0,0,391,1384
8,38,0,0,0,35,0,35
8,39,0,0,52,0,0,52
8,43,0,0,83,0,0,83
8,45,166,0,0,0,0,166
8,64,0,0,167,0,0,167
8,65,224,0,0,0,0,224
8,66,262,0,0,0,0,262
8,70,0,0,111,0,0,111
8,76,64,0,0,0,0,64
8,79,82,0,111,0,0,193
8,81,43,0,155,0,0,198
8,84,24,0,120,0,0,144
8,85,0,0,12,0,0,12
8,87,98,0,0,0,0,98
8,88,0,0,71,0,0,71
8,91,24,228,80,0,0,332
8,93,0,0,232,0,0,232
8,94,0,0,38,0,0,38
8,100,21,0,0,0,0,21
8,102,49,0,0,0,0,49
8,107,0,0,90,0,0,90
9,2,92,40,100,0,0,232
9,5,0,92,208,0,29,329
9,6,0,36,40,0,162,238
9,7,0,1440,29,41,58,1568
9,8,167,598,0,0,0,765
9,9,77,3264,29,123,58,3551
9,10,26,1553,0,191,0,1770
9,11,23,0,0,0,0,23
9,12,61,578,0,0,0,639
9,13,0,71,0,0,0,71
9,14,0,0,40,0,0,40
9,17,0,30,0,0,0,30
9,19,353,0,0,0,0,353
9,20,57,0,0,0,0,57
9,21,0,0,111,0,0,111
9,23,0,0,26,0,0,26
9,24,0,0,20,295,0,315
9,26,201,0,0,0,0,201
9,27,0,0,60,0,0,60
9,28,0,0,26,0,0,26
9,31,0,0,79,0,0,79
9,34,0,0,134,0,0,134
9,35,0,0,88,0,0,88
9,36,0,0,109,0,0,109
9,37,18,92,441,0,0,551
9,42,0,0,0,37,0,37
9,43,0,71,20,53,0,144
9,44,56,0,0,0,0,56
9,45,0,0,754,0,0,754
9,50,32,0,74,0,0,106
9,51,0,0,80,0,0,80
9,54,37,0,0,0,0,37
9,55,0,0,168,0,0,168
9,56,92,0,107,0,0,199
9,57,0,0,30,0,0,30
9,59,0,0,1213,0,0,1213
9,60,0,0,327,0,0,327
9,65,0,0,92,0,0,92
9,68,0,0,29,0,0,29
9,77,0,0,92,0,0,92
9,80,0,0,40,0,0,40
9,81,0,0,26,0,0,26
9,82,26,0,0,0,0,26
9,84,0,0,45,0,0,45
9,86,0,0,20,0,0,20
9,87,0,0,33,0,0,33
9,88,62,0,138,0,0,200
9,89,62,0,0,0,0,62
9,93,0,0,92,0,0,92
9,94,0,0,92,0,0,92
9,99,0,0,58,0,0,58
10,1,0,0,161,0,0,161
10,6,0,0,469,0,0,469
10,7,147,43,141,0,0,331
10,8,26,8,36,0,0,70
10,9,0,1458,104,95,0,1657
10,10,131,1075,0,0,277,1483
10,11,156,66,0,0,0,222
10,12,17,1269,218,0,39,1543
10,13,0,130,0,14,0,144
10,14,8,34,0,0,12,54
10,17,0,0,20,0,0,20
10,19,0,0,0,396,0,396
10,22,67,0,0,0,0,67
10,27,147,0,0,0,0,147
10,29,0,0,32,0,0,32
10,30,0,0,12,0,0,12
10,31,0,0,21,0,0,21
10,32,0,0,18,0,0,18
10,34,0,0,11,0,0,11
10,35,0,11,0,0,0,11
10,38,0,18,0,84,0,102
10,39,0,0,51,0,7,58
10,42,11,0,0,5,0,16
10,43,0,0,63,0,0,63
10,47,21,0,0,0,0,21
10,49,0,0,8,0,0,8
10,50,35,0,0,0,0,35
10,51,0,0,104,0,0,104
10,53,0,0,11,0,0,11
10,54,0,0,111,0,0,111
10,63,0,0,8,0,0,8
10,68,0,0,12,0,0,12
10,76,0,0,11,0,0,11
10,85,0,0,0,24,0,24
10,90,0,0,0,189,0,189
10,93,0,0,58,0,0,58
10,240,204,0,0,0,0,204
10,241,0,0,58,0,0,58
11,6,0,0,22,0,0,22
11,7,0,67,36,0,0,103
11,9,23,0,0,0,0,23
11,10,167,66,0,0,0,233
11,11,708,393,0,0,0,1101
11,12,352,479,24,462,0,1317
11,13,0,25,24,0,0,49
11,14,0,135,12,0,0,147
11,15,19,0,0,0,0,19
11,16,36,0,0,0,0,36
11,17,0,47,29,0,83,159
11,19,0,0,24,0,0,24
11,24,0,0,61,0,0,61
11,28,0,0,71,0,0,71
11,30,0,0,0,19,0,19
11,37,0,0,49,23,0,72
11,38,22,460,0,69,0,551
11,39,91,11,0,0,0,102
11,42,79,11,10,27,0,127
11,45,46,0,0,0,0,46
11,48,23,0,0,0,0,23
11,50,0,0,62,0,0,62
11,54,0,0,24,0,0,24
11,55,0,0,45,0,0,45
11,61,0,0,22,0,0,22
11,68,0,0,24,0,0,24
11,70,11,0,0,0,0,11
11,77,33,0,0,0,0,33
11,79,0,0,19,0,0,19
11,80,22,0,0,0,0,22
11,81,0,0,63,0,0,63
11,100,0,0,14,0,0,14
11,108,22,0,0,0,0,22
11,237,22,0,0,0,0,22
11,250,649,0,0,0,0,649
11,254,208,0,0,0,0,208
12,1,43,0,0,0,0,43
12,2,0,68,54,0,0,122
12,3,0,0,170,0,0,170
12,5,0,0,191,303,0,494
12,6,0,329,340,0,0,669
12,7,234,636,198,235,0,1303
12,9,144,674,0,0,0,818
12,10,17,1163,281,0,39,1500
12,11,355,492,12,473,55,1387
12,12,508,8195,0,37,531,9271
12,13,0,1161,14,0,14,1189
12,14,36,1184,0,67,0,1287
12,15,93,68,0,0,0,161
12,16,0,0,272,0,0,272
12,17,0,184,24,21,0,229
12,23,63,0,0,0,0,63
12,24,0,0,57,0,0,57
12,26,0,0,74,0,0,74
12,29,0,0,0,0,88,88
12,32,0,0,100,0,0,100
12,37,0,0,70,0,441,511
12,38,112,212,70,0,0,394
12,40,0,0,20,0,0,20
12,41,202,0,0,0,0,202
12,42,446,803,0,0,0,1249
12,44,0,0,61,0,0,61
12,63,0,0,19,6,0,25
12,64,156,0,0,0,0,156
12,70,156,0,0,0,0,156
12,74,124,0,0,0,0,124
12,77,0,0,68,0,0,68
12,82,182,0,0,0,0,182
12,89,118,0,0,0,0,118
12,93,0,0,152,0,0,152
12,238,135,0,0,0,0,135
12,241,53,0,0,0,0,53
12,250,0,0,108,0,0,108
13,1,0,0,12,0,0,12
13,2,0,94,31,144,0,269
13,5,0,0,450,0,0,450
13,6,0,0,40,0,0,40
13,7,0,269,314,0,24,607
13,8,83,0,0,166,0,249
13,9,0,71,0,0,0,71
13,10,0,130,0,14,0,144
13,11,0,25,24,0,0,49
13,12,0,1179,0,13,14,1206
13,13,0,1437,0,0,0,1437
13,14,0,214,0,34,0,248
13,15,0,267,0,0,0,267
13,17,0,299,0,0,0,299
13,20,0,0,42,0,0,42
13,24,0,0,288,0,0,288
13,26,0,0,0,227,0,227
13,37,0,0,18,0,0,18
13,41,17,24,18,0,0,59
13,42,0,102,0,42,0,144
13,45,0,0,11,0,0,11
13,80,0,0,44,0,0,44
13,87,0,0,33,0,0,33
13,254,0,0,0,33,0,33
14,1,0,30,18,0,0,48
14,2,0,0,686,0,0,686
14,5,0,0,197,0,0,197
14,7,333,0,0,0,0,333
14,8,385,0,0,0,0,385
14,9,83,0,40,37,0,160
14,10,0,34,0,0,12,46
14,11,0,170,12,0,0,182
14,12,36,1113,0,103,0,1252
14,13,0,214,0,34,0,248
14,14,75,9654,0,0,0,9729
14,15,0,1699,0,0,0,1699
14,16,0,251,159,126,0,536
14,17,0,426,0,66,70,562
14,18,0,124,135,0,0,259
14,20,0,0,76,0,0,76
14,24,181,0,0,0,0,181
14,29,37,0,0,0,0,37
14,30,0,0,37,0,0,37
14,31,30,0,0,15,0,45
14,32,0,0,32,0,0,32
14,35,0,0,29,0,0,29
14,37,18,0,0,0,0,18
14,38,0,35,0,0,0,35
14,41,180,59,137,0,0,376
14,42,268,1685,72,0,0,2025
14,43,315,0,45,63,0,423
14,44,0,0,0,75,0,75
14,49,0,0,31,0,0,31
14,50,0,0,62,0,0,62
14,56,296,0,0,0,0,296
14,57,0,0,37,0,0,37
14,74,196,0,0,0,0,196
14,77,0,0,105,0,0,105
14,79,0,0,47,37,0,84
14,80,180,0,0,0,0,180
14,81,111,0,0,0,0,111
14,82,0,0,61,0,0,61
14,97,35,0,0,0,0,35
14,99,131,0,0,0,0,131
14,102,36,0,0,0,0,36
14,237,0,0,28,0,0,28
14,240,0,0,228,0,0,228
14,254,0,0,41,0,0,41
15,2,0,53,294,0,0,347
15,3,0,156,223,0,0,379
15,4,0,0,233,0,0,233
15,5,0,0,59,0,0,59
15,6,0,0,53,0,0,53
15,7,0,179,0,0,0,179
15,8,0,0,90,0,0,90
15,11,19,0,0,0,0,19
15,12,93,68,0,0,0,161
15,13,0,277,0,0,0,277
15,14,0,1699,0,0,0,1699
15,15,358,3235,0,0,0,3593
15,16,150,494,0,138,0,782
15,17,20,456,0,0,0,476
15,23,0,0,24,0,0,24
15,24,0,0,91,0,0,91
15,27,0,0,63,0,0,63
15,28,0,0,24,0,0,24
15,29,0,0,111,0,0,111
15,32,157,0,0,0,0,157
15,36,0,0,79,0,0,79
15,38,0,18,0,0,0,18
15,39,0,0,85,0,0,85
15,41,403,1110,321,439,99,2372
15,42,98,569,0,56,154,877
15,43,281,233,45,138,0,697
15,44,68,0,499,86,0,653
15,45,240,24,0,0,0,264
15,47,106,0,0,0,0,106
15,49,0,0,24,0,0,24
15,65,116,0,0,0,0,116
15,74,53,0,24,0,0,77
15,77,0,0,127,0,0,127
15,82,0,0,70,0,0,70
15,93,0,0,53,0,0,53
15,236,0,0,263,0,0,263
15,238,0,0,135,0,0,135
15,241,53,0,0,0,0,53
15,254,0,0,863,0,0,863
16,1,111,1043,770,55,0,1979
16,2,0,294,243,0,0,537
16,3,0,0,544,68,0,612
16,4,0,0,193,0,0,193
16,5,0,0,576,0,0,576
16,7,235,397,0,0,0,632
16,11,36,0,0,0,0,36
16,12,0,68,272,0,0,340
16,14,84,187,228,42,0,541
16,15,91,441,0,138,0,670
16,16,129,7328,0,612,562,8631
16,17,230,2242,0,40,0,2512
16,18,247,1210,135,78,0,1670
16,21,0,0,0,111,0,111
16,22,0,0,67,0,0,67
16,24,83,32,228,0,0,343
16,26,0,227,0,0,0,227
16,28,0,38,155,0,0,193
16,29,0,0,504,0,0,504
16,31,0,0,68,126,0,194
16,35,291,0,2057,0,0,2348
16,37,0,0,130,0,0,130
16,39,0,0,51,0,0,51
16,40,18,9,10,63,0,100
16,41,0,0,68,0,98,166
16,42,0,0,0,68,118,186
16,43,403,129,0,0,0,532
16,44,149,250,131,63,0,593
16,45,0,126,300,129,0,555
16,54,0,0,74,0,0,74
16,56,0,0,148,0,0,148
16,57,0,0,126,0,0,126
16,61,309,0,0,0,0,309
16,75,0,0,56,0,0,56
16,79,0,0,275,0,0,275
16,80,44,0,219,0,0,263
16,82,0,0,171,0,0,171
16,87,266,0,142,0,0,408
16,92,0,0,4,0,0,4
16,93,0,0,40,0,0,40
16,98,0,0,23,0,0,23
16,107,0,0,129,0,0,129
16,241,173,0,0,0,0,173
16,250,254,0,0,0,0,254
17,1,0,0,58,0,0,58
17,2,0,779,127,143,0,1049
17,3,0,106,0,0,0,106
17,5,0,0,26,0,0,26
17,6,0,369,203,0,0,572
17,7,0,98,46,106,0,250
17,8,0,20,90,0,0,110
17,9,0,30,21,0,0,51
17,10,0,0,20,0,0,20
17,11,0,24,29,0,28,81
17,12,0,208,24,21,55,308
17,13,0,299,0,0,0,299
17,14,50,362,0,79,70,561
17,15,78,456,0,0,0,534
17,16,209,2451,0,40,0,2700
17,17,58,5346,0,0,0,5404
17,18,48,58,0,0,0,106
17,19,128,0,0,0,0,128
17,20,192,0,0,0,0,192
17,22,0,0,49,0,0,49
17,24,0,0,15,60,0,75
17,27,0,0,60,0,0,60
17,28,0,0,24,0,0,24
17,31,0,0,24,0,0,24
17,32,21,0,0,0,0,21
17,34,23,0,0,0,0,23
17,36,0,0,89,0,0,89
17,39,0,0,122,0,0,122
17,40,0,0,0,24,0,24
17,41,0,0,141,0,0,141
17,42,0,48,0,0,107,155
17,43,156,0,0,0,0,156
17,44,0,0,330,0,0,330
17,45,24,0,553,226,0,803
17,49,0,0,74,0,0,74
17,50,148,0,0,0,0,148
17,51,0,0,104,0,0,104
17,53,0,0,20,0,0,20
17,54,0,0,0,0,35,35
17,56,0,0,107,0,0,107
17,60,0,0,20,0,0,20
17,62,0,0,26,0,0,26
17,64,95,0,0,0,0,95
17,66,0,0,0,101,0,101
17,69,20,0,0,0,0,20
17,78,0,0,102,0,0,102
17,79,0,0,44,49,0,93
17,81,0,0,13,0,0,13
17,87,0,0,0,220,0,220
17,92,0,0,21,0,0,21
17,93,0,0,61,0,0,61
17,94,13,0,0,0,0,13
17,100,58,0,26,0,0,84
17,101,0,0,328,0,0,328
17,104,21,0,0,0,0,21
17,240,0,0,0,24,0,24
17,250,0,0,35,0,0,35
17,252,0,0,58,0,0,58
18,1,299,0,460,0,0,759
18,2,128,0,325,0,0,453
18,3,184,556,170,0,0,910
18,4,198,0,0,0,0,198
18,5,0,0,691,186,0,877
18,6,0,0,276,0,0,276
18,7,182,0,0,0,0,182
18,9,0,0,111,0,0,111
18,14,0,124,135,0,0,259
18,16,0,1205,0,0,0,1205
18,17,48,58,0,78,0,184
18,18,2757,12173,0,0,0,14930
18,19,2232,929,87,0,0,3248
18,20,233,1067,0,0,0,1300
18,21,119,59,102,83,0,363
18,22,0,2615,0,125,0,2740
18,23,0,0,409,0,0,409
18,28,38,0,0,0,0,38
18,29,124,0,0,0,0,124
18,31,198,0,0,0,0,198
18,32,0,0,310,0,0,310
18,34,23,0,0,0,0,23
18,35,0,0,129,852,0,981
18,38,35,0,0,0,0,35
18,39,249,0,122,0,0,371
18,40,27,0,135,0,0,162
18,41,121,0,0,0,0,121
18,42,66,0,20,0,0,86
18,43,0,595,462,0,433,1490
18,44,0,0,326,743,0,1069
18,45,379,263,0,80,0,722
18,47,125,0,0,372,0,497
18,48,615,0,254,247,0,1116
18,49,0,0,325,80,0,405
18,50,301,62,38,0,0,401
18,51,104,0,0,0,0,104
18,52,184,0,0,0,0,184
18,56,169,0,0,167,0,336
18,58,100,0,0,0,0,100
18,68,124,0,0,0,0,124
18,69,0,0,87,0,0,87
18,79,124,0,248,0,0,372
18,80,0,0,135,0,0,135
18,82,0,0,366,0,0,366
18,99,0,0,0,96,0,96
18,100,0,0,229,0,0,229
18,104,21,0,0,0,0,21
18,106,0,0,88,0,0,88
18,236,0,0,246,96,0,342
18,237,466,0,426,0,0,892
18,239,373,0,136,0,0,509
18,240,889,0,295,0,0,1184
18,241,111,0,417,0,77,605
18,254,0,0,102,0,0,102
19,1,379,22,413,0,0,814
19,2,0,0,220,0,0,220
19,5,296,0,285,365,0,946
19,8,0,0,111,0,0,111
19,10,0,0,0,396,0,396
19,11,0,0,24,0,0,24
19,17,128,0,0,0,0,128
19,18,2107,1009,0,0,0,3116
19,19,3669,6632,170,451,0,10922
19,20,242,805,548,57,0,1652
19,21,854,648,128,332,0,1962
19,22,67,122,518,0,0,707
19,23,128,0,15,0,0,143
19,24,156,0,0,0,0,156
19,27,124,0,0,60,0,184
19,29,0,0,145,0,0,145
19,31,0,0,170,178,0,348
19,32,0,0,339,0,0,339
19,35,0,0,647,0,0,647
19,43,37,0,0,70,0,107
19,45,0,0,0,236,0,236
19,47,0,0,117,0,0,117
19,49,274,256,128,0,0,658
19,50,785,339,180,0,0,1304
19,51,0,434,0,0,0,434
19,52,756,0,170,80,0,1006
19,53,0,0,170,79,0,249
19,54,183,0,0,0,0,183
19,55,161,0,0,712,0,873
19,56,38,226,170,128,0,562
19,57,0,0,197,0,0,197
19,58,674,0,0,100,0,774
19,59,146,0,0,0,0,146
19,61,0,0,552,0,0,552
19,67,0,0,91,0,0,91
19,69,201,0,0,35,0,236
19,74,0,0,0,254,0,254
19,75,0,0,38,0,0,38
19,78,230,0,0,0,0,230
19,79,63,0,0,0,0,63
19,80,0,0,140,49,0,189
19,82,0,0,0,156,0,156
19,85,24,0,0,0,0,24
19,86,0,0,80,0,0,80
19,87,0,0,26,0,0,26
19,88,138,0,0,0,0,138
19,92,4,0,0,0,0,4
19,93,0,0,156,0,0,156
19,104,0,0,146,0,0,146
19,237,136,0,0,0,0,136
19,238,178,0,0,0,0,178
19,239,1620,0,67,198,0,1885
19,240,2462,743,140,336,0,3681
19,241,256,0,58,0,0,314
19,252,210,0,0,0,0,210
20,1,468,0,911,83,0,1462
20,2,0,138,216,0,212,566
20,3,0,307,1317,312,0,1936
20,5,254,0,254,0,0,508
20,7,76,0,0,0,0,76
20,8,0,0,320,0,0,320
20,9,57,0,0,0,0,57
20,14,0,0,82,0,0,82
20,18,233,1067,0,0,0,1300
20,19,242,1008,548,311,0,2109
20,20,468,9188,0,0,0,9656
20,21,1708,612,404,58,0,2782
20,22,266,824,234,0,0,1324
20,23,233,0,191,0,0,424
20,24,0,252,424,519,0,1195
20,26,0,0,276,0,0,276
20,27,1139,0,0,0,0,1139
20,28,57,0,82,0,0,139
20,29,0,0,133,0,0,133
20,30,0,0,276,0,0,276
20,31,76,0,174,0,0,250
20,32,0,215,509,0,0,724
20,35,0,254,0,0,0,254
20,40,0,0,120,0,0,120
20,41,0,0,62,0,0,62
20,42,0,0,209,0,0,209
20,43,63,0,0,0,0,63
20,45,0,0,180,0,0,180
20,47,724,0,0,0,0,724
20,49,1123,50,785,151,0,2109
20,50,468,0,0,192,0,660
20,52,0,0,60,0,0,60
20,53,0,0,254,0,0,254
20,56,154,254,60,0,0,468
20,57,254,0,1037,0,0,1291
20,59,0,0,76,76,0,152
20,60,323,0,0,0,0,323
20,62,0,0,0,254,0,254
20,69,0,0,319,0,0,319
20,74,0,0,267,39,0,306
20,78,555,0,0,254,0,809
20,81,511,0,0,0,0,511
20,82,0,0,306,0,0,306
20,83,0,0,254,0,0,254
20,88,138,0,0,0,0,138
20,93,0,0,0,254,0,254
20,237,0,0,509,0,0,509
20,239,254,0,0,0,0,254
20,240,0,0,16,0,0,16
21,1,59,0,263,0,0,322
21,3,904,0,250,0,0,1154
21,4,0,0,206,0,0,206
21,5,0,0,467,0,0,467
21,6,0,0,83,0,0,83
21,16,0,0,0,111,0,111
21,18,119,153,120,83,0,475
21,19,39,846,946,198,0,2029
21,20,2097,612,180,137,0,3026
21,21,1122,5140,0,686,0,6948
21,22,165,1483,73,178,0,1899
21,23,215,152,0,329,0,696
21,24,155,134,467,0,0,756
21,27,0,0,0,83,0,83
21,28,38,0,0,0,0,38
21,29,83,0,740,241,0,1064
21,31,30,0,329,0,0,359
21,32,110,0,90,0,0,200
21,34,119,0,0,0,0,119
21,35,0,0,90,0,160,250
21,36,0,0,466,0,0,466
21,37,0,0,83,0,0,83
21,45,0,0,0,321,0,321
21,49,972,227,258,76,0,1533
21,51,656,72,0,0,0,728
21,52,527,439,0,0,0,966
21,53,0,0,261,0,0,261
21,54,26,0,0,0,0,26
21,55,1150,221,0,379,0,1750
21,56,420,121,0,0,0,541
21,57,119,0,120,0,0,239
21,58,100,0,0,0,0,100
21,59,551,0,0,274,0,825
21,60,0,0,83,0,0,83
21,61,486,0,83,0,0,569
21,62,110,0,0,0,0,110
21,64,128,0,0,0,0,128
21,65,1072,0,0,0,0,1072
21,66,48,0,0,0,0,48
21,69,0,0,72,0,0,72
21,74,0,0,78,83,0,161
21,75,0,0,42,0,0,42
21,76,83,0,0,0,0,83
21,77,0,0,0,143,0,143
21,78,0,0,0,83,0,83
21,79,41,0,0,0,0,41
21,83,0,0,321,0,0,321
21,84,0,0,111,0,0,111
21,86,0,0,70,0,0,70
21,88,138,0,0,0,0,138
21,91,0,0,313,0,0,313
21,93,83,0,0,0,0,83
21,97,0,0,349,0,0,349
21,108,0,0,83,0,0,83
21,236,178,0,0,0,0,178
21,237,0,0,90,0,0,90
21,238,41,0,336,151,0,528
21,239,493,0,466,0,0,959
21,240,1132,0,447,0,0,1579
21,241,0,0,0,106,0,106
21,250,0,0,108,0,0,108
21,251,151,0,217,0,0,368
21,254,83,0,0,0,0,83
22,1,0,0,339,103,0,442
22,2,0,0,194,0,0,194
22,4,0,31,73,0,0,104
22,5,178,0,228,67,0,473
22,6,0,495,0,0,0,495
22,7,0,0,178,0,0,178
22,10,67,0,0,0,0,67
22,16,0,0,67,0,0,67
22,17,0,0,49,0,0,49
22,18,249,2615,96,125,0,3085
22,19,67,0,518,122,0,707
22,20,184,1292,215,0,0,1691
22,21,165,1372,73,178,0,1788
22,22,424,792,0,0,0,1216
22,23,273,1904,185,0,0,2362
22,24,124,1187,150,0,0,1461
22,26,0,167,0,0,94,261
22,27,774,424,120,0,0,1318
22,28,0,0,97,0,0,97
22,29,0,0,103,0,0,103
22,30,87,0,96,0,0,183
22,31,0,0,364,0,0,364
22,32,0,0,367,0,0,367
22,34,39,0,0,0,0,39
22,35,0,0,73,0,0,73
22,36,109,0,131,0,0,240
22,40,0,0,18,0,0,18
22,43,96,0,0,0,0,96
22,47,0,0,107,0,0,107
22,48,0,0,36,0,0,36
22,49,0,885,0,0,107,992
22,50,0,0,38,0,0,38
22,51,455,0,104,0,0,559
22,52,61,0,76,0,0,137
22,53,0,0,303,0,0,303
22,54,0,0,36,0,0,36
22,55,0,0,36,0,0,36
22,56,690,119,0,123,0,932
22,57,583,197,0,0,0,780
22,58,256,0,0,0,0,256
22,59,0,267,614,0,0,881
22,60,69,0,0,0,0,69
22,61,0,67,96,0,0,163
22,65,116,0,0,0,0,116
22,74,0,0,98,0,0,98
22,75,67,0,0,0,0,67
22,76,38,0,0,0,0,38
22,77,0,0,94,0,0,94
22,78,0,0,160,0,0,160
22,80,0,0,209,0,0,209
22,81,29,0,0,0,0,29
22,82,0,0,36,0,0,36
22,83,0,0,69,0,0,69
22,84,0,0,104,67,0,171
22,88,0,0,150,0,0,150
22,93,0,0,111,0,0,111
22,99,0,0,67,0,0,67
22,100,0,0,162,0,0,162
22,102,134,0,0,0,0,134
22,239,589,0,0,0,0,589
22,251,0,0,279,0,0,279
22,254,0,0,640,0,0,640
23,1,894,56,86,0,0,1036
23,2,0,63,1047,0,41,1151
23,3,0,88,145,0,0,233
23,4,0,0,152,0,0,152
23,5,0,0,0,29,0,29
23,6,0,0,0,96,0,96
23,8,0,0,0,83,0,83
23,9,0,0,26,0,0,26
23,12,63,0,0,0,0,63
23,15,0,0,24,0,0,24
23,16,309,0,0,0,0,309
23,18,0,0,231,0,0,231
23,19,128,0,0,0,0,128
23,20,233,0,109,0,0,342
23,21,215,222,69,127,0,633
23,22,273,1987,185,0,0,2445
23,23,0,4311,0,83,0,4394
23,24,0,1609,29,0,0,1638
23,26,0,428,0,0,81,509
23,27,0,570,0,65,0,635
23,28,0,29,186,0,0,215
23,29,63,60,193,0,0,316
23,31,200,0,99,0,0,299
23,32,0,0,63,0,0,63
23,33,0,0,56,0,0,56
23,35,0,0,123,0,0,123
23,36,0,0,131,0,0,131
23,40,0,0,189,0,0,189
23,41,0,0,43,121,0,164
23,43,63,0,69,0,0,132
23,44,0,0,127,0,0,127
23,45,240,0,180,0,0,420
23,49,155,1409,32,0,0,1596
23,53,0,0,112,0,0,112
23,54,0,0,225,0,0,225
23,56,63,569,199,0,0,831
23,57,0,475,0,155,0,630
23,58,127,0,0,0,0,127
23,59,607,0,173,393,0,1173
23,61,98,0,415,0,0,513
23,63,56,0,0,0,0,56
23,64,346,0,224,120,0,690
23,65,116,0,0,0,0,116
23,66,58,0,0,0,0,58
23,68,178,0,61,0,0,239
23,69,63,0,0,0,0,63
23,70,127,0,29,0,0,156
23,74,0,0,154,0,0,154
23,75,56,0,428,0,0,484
23,76,557,0,56,0,111,724
23,77,140,0,275,0,0,415
23,78,0,0,102,0,0,102
23,79,0,0,23,0,0,23
23,80,82,0,57,0,0,139
23,81,37,0,84,0,0,121
23,83,0,0,191,0,0,191
23,84,0,0,51,0,0,51
23,85,0,0,32,0,0,32
23,87,0,0,33,0,0,33
23,88,170,0,350,0,0,520
23,91,0,0,738,0,0,738
23,93,40,0,29,0,0,69
23,96,0,0,56,0,0,56
23,97,0,0,56,0,0,56
23,98,0,0,7,0,0,7
23,99,138,0,0,0,0,138
23,100,0,0,29,0,0,29
23,236,112,0,0,0,0,112
23,237,0,0,47,0,0,47
23,239,0,0,560,0,0,560
23,240,204,0,319,0,0,523
23,241,0,0,100,0,0,100
23,250,99,0,315,0,0,414
24,1,0,713,555,0,0,1268
24,2,0,92,1061,0,0,1153
24,3,0,4250,0,0,0,4250
24,4,255,492,0,0,0,747
24,5,0,0,276,0,0,276
24,6,0,169,366,0,0,535
24,7,0,0,60,0,0,60
24,8,0,0,125,0,0,125
24,9,0,0,20,0,0,20
24,11,0,0,61,0,0,61
24,12,0,0,83,0,0,83
24,14,425,0,15,0,0,440
24,15,0,0,167,0,0,167
24,16,83,32,94,0,0,209
24,17,0,0,15,60,0,75
24,19,156,0,0,0,0,156
24,20,0,770,582,254,0,1606
24,21,155,134,0,0,0,289
24,22,339,906,157,67,0,1469
24,23,0,1483,29,0,0,1512
24,24,1023,8245,0,500,0,9768
24,26,156,956,0,66,0,1178
24,27,181,192,66,243,0,682
24,28,121,0,49,0,0,170
24,29,297,0,138,0,0,435
24,30,0,0,64,47,0,111
24,31,0,0,0,88,0,88
24,32,164,0,207,0,0,371
24,33,0,0,6,0,0,6
24,34,0,0,0,39,0,39
24,35,0,0,181,0,0,181
24,36,0,0,181,0,0,181
24,38,0,0,29,0,0,29
24,39,78,0,47,0,0,125
24,41,0,0,317,0,0,317
24,42,0,0,66,0,0,66
24,43,0,0,174,0,0,174
24,45,61,0,222,0,0,283
24,49,0,0,396,0,0,396
24,50,0,0,163,0,0,163
24,51,0,0,274,0,0,274
24,52,179,0,1011,0,0,1190
24,54,14,0,146,367,0,527
24,55,0,0,123,72,0,195
24,56,61,0,60,0,0,121
24,57,183,0,0,88,0,271
24,58,0,0,97,0,0,97
24,59,0,0,1302,0,0,1302
24,60,0,0,643,0,0,643
24,61,181,0,637,0,0,818
24,62,0,0,189,71,76,336
24,64,215,0,272,0,0,487
24,65,132,0,0,0,0,132
24,67,0,0,55,0,0,55
24,68,0,0,150,0,263,413
24,69,80,0,150,0,0,230
24,70,0,0,0,110,0,110
24,74,39,0,0,0,0,39
24,75,0,0,56,0,0,56
24,76,77,0,84,18,0,179
24,77,38,0,38,0,0,76
24,78,0,0,72,0,0,72
24,79,231,0,72,0,0,303
24,80,0,0,0,44,0,44
24,81,46,0,0,0,0,46
24,82,181,0,72,0,0,253
24,83,0,0,146,0,0,146
24,84,51,0,0,0,0,51
24,85,24,0,0,0,0,24
24,86,0,0,28,0,0,28
24,87,0,0,53,0,0,53
24,88,138,0,0,0,0,138
24,90,0,0,1028,0,0,1028
24,93,0,0,187,0,0,187
24,97,0,0,96,23,0,119
24,99,0,0,429,0,0,429
24,101,0,0,130,0,0,130
24,105,0,0,107,50,0,157
24,236,0,0,311,0,0,311
24,239,0,0,110,0,0,110
24,240,286,0,317,0,0,603
24,241,0,0,110,0,0,110
24,250,108,0,0,0,0,108
24,251,0,0,0,66,0,66
24,252,126,0,254,0,0,380
24,254,150,0,245,0,0,395
25,1,0,240,0,0,0,240
25,2,0,74,325,0,0,399
25,3,0,0,245,0,0,245
25,4,0,3115,0,735,0,3850
25,5,0,135,564,0,0,699
25,6,162,0,0,0,0,162
25,7,0,0,174,0,0,174
25,23,0,0,160,0,0,160
25,25,0,4986,0,0,0,4986
25,26,421,1692,0,0,0,2113
25,27,631,2005,174,0,0,2810
25,28,0,871,0,358,0,1229
25,29,0,1444,0,0,0,1444
25,31,0,2775,0,128,0,2903
25,32,0,21,98,0,0,119
25,36,202,0,0,0,285,487
25,43,0,0,82,0,0,82
25,49,0,48,74,32,0,154
25,51,104,0,0,0,0,104
25,54,0,0,14,0,0,14
25,57,149,160,904,0,0,1213
25,58,0,0,379,0,0,379
25,60,0,0,201,0,0,201
25,62,0,0,0,26,0,26
25,65,24,0,176,0,0,200
25,67,0,0,176,0,0,176
25,68,0,0,132,208,0,340
25,69,0,0,174,0,0,174
25,70,84,0,0,0,0,84
25,74,336,0,0,0,0,336
25,75,0,0,76,0,0,76
25,76,162,0,24,0,0,186
25,77,0,0,218,0,0,218
25,78,0,97,807,72,0,976
25,79,1043,197,176,0,0,1416
25,83,0,0,0,162,0,162
25,84,0,0,81,0,0,81
25,85,73,0,0,0,0,73
25,88,138,0,201,0,0,339
25,93,0,0,160,0,0,160
25,94,670,0,201,0,0,871
25,96,0,0,379,0,0,379
25,106,349,0,0,0,0,349
26,1,0,115,395,0,0,510
26,3,0,127,220,90,0,437
26,4,0,1347,0,0,94,1441
26,6,0,0,1237,71,0,1308
26,9,201,0,0,0,0,201
26,12,0,0,74,0,0,74
26,14,0,0,139,0,0,139
26,16,0,227,0,0,0,227
26,20,0,0,276,0,0,276
26,22,0,167,0,0,94,261
26,23,0,428,190,0,81,699
26,24,156,1347,0,66,0,1569
26,25,421,1552,0,0,0,1973
26,26,2025,7442,0,920,0,10387
26,27,1591,2445,295,0,0,4331
26,28,0,430,247,102,0,779
26,29,0,77,247,165,0,489
26,31,128,0,0,0,0,128
26,32,21,93,0,0,0,114
26,34,30,0,0,39,0,69
26,36,466,0,0,0,0,466
26,38,0,0,38,0,0,38
26,40,0,0,175,0,0,175
26,43,0,0,63,0,0,63
26,47,0,0,113,0,0,113
26,49,0,513,266,0,0,779
26,50,0,0,41,0,0,41
26,53,0,0,201,0,0,201
26,54,37,0,752,0,0,789
26,55,0,0,102,0,0,102
26,56,0,0,161,0,0,161
26,57,60,264,101,0,0,425
26,58,0,0,127,0,0,127
26,60,0,0,129,0,0,129
26,62,27,0,0,0,0,27
26,64,309,0,0,0,0,309
26,66,0,0,215,0,0,215
26,68,140,0,97,121,0,358
26,70,0,0,91,0,0,91
26,74,0,27,152,0,0,179
26,75,126,0,227,0,0,353
26,76,587,0,0,0,0,587
26,77,214,0,0,0,0,214
26,78,0,0,366,0,0,366
26,79,41,408,432,0,0,881
26,87,201,0,30,0,0,231
26,92,0,0,5,0,0,5
26,94,0,0,0,127,0,127
26,101,0,0,455,0,0,455
26,103,18,0,0,0,0,18
26,238,227,0,0,0,0,227
26,240,127,0,0,0,0,127
26,251,113,0,0,0,0,113
27,1,0,0,566,60,86,712
27,2,0,0,380,60,0,440
27,3,355,0,902,0,0,1257
27,4,365,883,204,717,0,2169
27,5,106,546,282,0,0,934
27,6,0,36,97,0,0,133
27,7,469,0,60,0,0,529
27,8,0,0,38,0,0,38
27,9,0,0,60,0,0,60
27,10,147,0,0,0,0,147
27,15,0,0,63,0,0,63
27,17,0,0,66,0,0,66
27,19,124,0,0,0,0,124
27,20,859,0,0,0,0,859
27,21,0,0,0,83,0,83
27,22,339,455,120,0,0,914
27,23,116,554,61,65,0,796
27,24,181,199,66,243,0,689
27,25,306,2082,174,0,0,2562
27,26,1591,2187,136,0,0,3914
27,27,238,12841,135,0,0,13214
27,28,240,1826,0,138,0,2204
27,29,183,941,246,0,0,1370
27,30,58,0,0,213,0,271
27,31,155,177,563,49,0,944
27,32,245,270,1370,100,0,1985
27,33,38,0,0,0,0,38
27,34,60,0,30,0,0,90
27,35,60,0,292,0,0,352
27,36,519,30,285,0,0,834
27,37,0,0,18,0,0,18
27,40,0,0,60,0,0,60
27,41,26,0,0,0,0,26
27,43,0,0,311,0,0,311
27,45,374,0,447,0,0,821
27,49,74,351,206,0,0,631
27,50,281,0,32,0,0,313
27,52,162,0,0,152,0,314
27,53,93,0,319,45,0,457
27,54,41,0,281,46,0,368
27,55,60,0,392,0,0,452
27,56,519,0,0,612,0,1131
27,57,1342,2915,133,183,256,4829
27,59,165,0,0,46,0,211
27,60,102,0,0,0,0,102
27,61,222,91,93,277,0,683
27,62,395,145,0,0,0,540
27,63,52,0,12,6,0,70
27,64,184,0,65,0,0,249
27,65,271,0,0,0,0,271
27,66,0,0,63,0,0,63
27,67,0,0,88,0,0,88
27,68,121,0,539,0,0,660
27,69,60,0,0,0,0,60
27,70,84,0,0,84,0,168
27,74,353,1063,26,192,0,1634
27,75,184,1002,0,0,0,1186
27,76,85,0,286,0,0,371
27,77,259,0,765,230,0,1254
27,78,393,78,293,102,256,1122
27,79,23,1086,481,83,0,1673
27,80,162,0,441,44,0,647
27,81,0,0,176,46,0,222
27,82,177,0,33,31,0,241
27,83,0,0,429,0,0,429
27,84,0,0,51,0,0,51
27,85,11,0,592,91,0,694
27,86,9,0,41,0,0,50
27,87,0,0,338,0,0,338
27,88,46,0,110,0,0,156
27,89,0,0,236,0,0,236
27,90,0,0,60,378,0,438
27,91,31,0,0,0,0,31
27,92,0,0,31,0,0,31
27,93,339,0,263,0,0,602
27,94,177,0,0,0,0,177
27,95,75,0,0,75,0,150
27,97,162,0,65,0,0,227
27,98,0,0,58,0,0,58
27,102,36,0,236,0,0,272
27,104,138,0,9,0,0,147
27,105,50,0,0,0,0,50
27,107,99,0,773,0,0,872
27,236,41,0,0,0,0,41
27,237,47,0,76,0,0,123
27,238,135,0,151,0,0,286
27,239,0,0,240,0,0,240
27,240,60,0,59,204,0,323
27,241,0,0,189,0,0,189
27,254,0,0,600,0,0,600
28,1,0,60,572,26,0,658
28,3,38,0,41,0,0,79
28,4,0,214,102,0,0,316
28,5,0,102,38,0,0,140
28,6,0,0,195,0,0,195
28,7,0,0,26,0,0,26
28,9,0,0,26,0,0,26
28,11,0,0,71,0,0,71
28,15,0,0,24,0,0,24
28,16,0,0,155,38,0,193
28,17,0,0,24,0,0,24
28,18,38,0,92,0,0,130
28,20,57,0,0,76,0,133
28,21,38,0,0,0,0,38
28,22,0,0,97,0,0,97
28,23,0,29,543,0,0,572
28,24,60,60,592,0,0,712
28,25,0,871,0,358,0,1229
28,26,0,657,0,102,0,759
28,27,53,2194,0,138,0,2385
28,28,205,5610,0,0,0,5815
28,29,0,1520,0,0,0,1520
28,30,0,35,47,167,0,249
28,31,128,221,107,0,0,456
28,32,38,232,60,96,0,426
28,33,0,0,30,0,0,30
28,34,23,0,0,0,0,23
28,35,310,0,0,0,0,310
28,36,102,0,178,38,144,462
28,41,0,0,63,0,0,63
28,43,0,0,91,0,0,91
28,45,0,0,306,0,0,306
28,49,177,48,213,0,0,438
28,51,0,0,87,0,126,213
28,52,0,0,857,0,0,857
28,53,0,0,94,0,0,94
28,54,26,0,172,0,0,198
28,55,0,0,110,196,0,306
28,56,64,0,148,0,0,212
28,57,26,1496,210,697,0,2429
28,59,102,0,393,0,0,495
28,60,102,0,26,54,0,182
28,62,0,0,41,0,0,41
28,63,0,11,0,0,0,11
28,64,175,0,41,120,0,336
28,65,561,0,0,0,0,561
28,66,0,0,155,0,0,155
28,67,80,0,0,80,0,160
28,68,76,0,493,182,0,751
28,69,80,0,24,152,0,256
28,74,111,2336,37,0,0,2484
28,75,320,776,0,93,0,1189
28,76,38,0,152,0,0,190
28,77,60,0,368,0,0,428
28,78,250,125,110,102,0,587
28,79,123,184,193,42,33,575
28,80,88,0,0,0,0,88
28,81,0,0,283,66,0,349
28,82,0,0,124,0,0,124
28,83,0,0,340,587,0,927
28,84,147,0,225,51,0,423
28,86,0,0,45,0,0,45
28,87,0,0,127,0,0,127
28,88,0,0,158,0,0,158
28,90,189,0,62,0,0,251
28,91,101,0,28,51,0,180
28,95,60,0,38,0,0,98
28,97,38,0,69,0,0,107
28,98,0,0,0,7,0,7
28,99,119,0,0,0,0,119
28,100,0,0,28,0,0,28
28,101,0,0,544,130,0,674
28,102,125,0,0,0,0,125
28,103,35,0,11,0,0,46
28,108,0,0,23,0,0,23
28,236,41,0,0,0,0,41
28,237,0,0,0,233,0,233
28,250,649,0,325,0,0,974
28,254,0,0,496,0,0,496
29,1,0,0,1093,0,0,1093
29,2,0,0,78,0,0,78
29,3,0,0,80,0,0,80
29,4,105,300,0,0,0,405
29,5,0,0,265,0,0,265
29,6,80,0,0,257,0,337
29,7,80,0,354,0,0,434
29,9,0,0,26,0,0,26
29,12,0,0,0,0,88,88
29,14,37,0,0,0,0,37
29,15,0,0,111,0,0,111
29,16,0,0,504,0,0,504
29,18,124,0,0,0,0,124
29,19,0,0,145,0,0,145
29,20,0,0,133,0,0,133
29,21,83,0,740,241,0,1064
29,22,0,0,139,0,0,139
29,23,63,0,263,0,0,326
29,24,282,0,252,0,0,534
29,25,357,1087,0,0,0,1444
29,26,0,323,247,165,0,735
29,27,80,774,106,0,0,960
29,28,0,1497,0,0,0,1497
29,29,15,8571,0,63,0,8649
29,30,252,64,64,0,0,380
29,31,173,1404,443,612,0,2632
29,32,58,2702,15,0,0,2775
29,33,7,0,21,23,0,51
29,34,39,0,65,34,0,138
29,35,45,0,0,0,0,45
29,36,131,0,143,0,0,274
29,40,0,0,18,0,0,18
29,41,0,0,399,0,0,399
29,43,63,0,262,0,0,325
29,44,0,0,152,0,0,152
29,45,0,0,240,0,0,240
29,49,0,0,88,0,0,88
29,50,55,0,0,0,0,55
29,51,0,0,93,0,0,93
29,52,0,0,185,0,0,185
29,53,0,0,577,58,0,635
29,54,0,0,87,14,0,101
29,55,100,0,312,0,0,412
29,56,83,0,408,0,0,491
29,57,539,0,286,0,0,825
29,58,100,0,100,0,0,200
29,59,0,0,660,0,0,660
29,60,240,0,190,0,0,430
29,61,0,0,412,0,0,412
29,62,0,0,29,26,0,55
29,63,23,0,0,11,0,34
29,64,297,0,0,0,0,297
29,65,116,0,0,0,0,116
29,66,143,0,0,0,0,143
29,67,55,0,0,0,0,55
29,68,427,0,518,114,0,1059
29,70,0,0,188,63,0,251
29,74,350,1170,55,46,0,1621
29,75,644,124,23,58,0,849
29,76,105,38,34,70,0,247
29,77,126,237,239,0,0,602
29,78,324,187,0,309,0,820
29,79,454,3424,72,26,75,4051
29,80,405,0,143,0,0,548
29,81,198,0,194,63,0,455
29,82,0,0,56,0,0,56
29,83,112,0,398,0,0,510
29,84,152,0,51,51,0,254
29,85,24,63,24,0,0,111
29,86,9,0,18,0,0,27
29,87,0,0,33,57,49,139
29,88,0,0,260,578,0,838
29,89,0,0,0,48,0,48
29,90,0,0,0,502,0,502
29,92,0,0,63,0,0,63
29,93,40,40,143,0,0,223
29,94,0,0,68,0,0,68
29,96,67,0,27,0,0,94
29,97,58,0,47,0,0,105
29,98,0,0,22,0,0,22
29,99,58,0,0,0,0,58
29,100,181,0,163,0,0,344
29,101,0,0,295,0,0,295
29,104,64,0,52,0,0,116
29,105,50,0,0,0,0,50
29,107,198,0,0,0,0,198
29,108,237,0,0,0,0,237
29,236,0,0,633,0,0,633
29,237,15,0,72,0,0,87
29,238,80,0,0,0,0,80
29,239,0,0,148,0,0,148
29,240,0,0,100,0,0,100
29,250,11,0,0,0,0,11
30,1,193,43,341,55,0,632
30,2,64,58,0,103,0,225
30,3,405,0,0,0,0,405
30,4,187,58,0,129,660,1034
30,5,0,346,192,301,0,839
30,6,0,111,0,0,187,298
30,8,64,11,0,84,0,159
30,9,0,0,51,0,0,51
30,14,0,0,37,0,0,37
30,20,0,0,276,0,0,276
30,22,87,0,96,0,0,183
30,24,0,0,70,47,0,117
30,27,285,0,0,166,0,451
30,28,0,0,111,102,0,213
30,29,127,64,64,47,0,302
30,30,398,7559,0,0,136,8093
30,31,655,3496,0,80,0,4231
30,32,228,956,140,127,0,1451
30,33,46,147,8,283,0,484
30,34,1013,1851,0,99,0,2963
30,35,64,3138,0,0,0,3202
30,36,1125,1771,70,146,0,3112
30,37,219,0,0,0,0,219
30,38,0,64,70,0,0,134
30,43,47,0,0,0,0,47
30,51,0,0,94,0,0,94
30,54,0,0,44,26,0,70
30,55,117,0,0,72,0,189
30,56,272,0,0,0,0,272
30,57,181,0,119,64,0,364
30,58,0,0,100,0,0,100
30,59,0,0,58,0,0,58
30,62,91,0,27,0,0,118
30,63,483,0,0,0,0,483
30,64,274,0,201,64,0,539
30,65,39,0,126,0,0,165
30,66,129,0,0,0,0,129
30,67,43,0,0,0,0,43
30,68,129,0,346,254,0,729
30,69,64,80,64,0,0,208
30,70,0,0,0,71,0,71
30,74,0,44,192,0,0,236
30,75,290,0,0,0,0,290
30,76,296,0,0,0,0,296
30,77,64,0,51,509,0,624
30,78,904,0,95,102,0,1101
30,79,64,0,58,146,0,268
30,80,0,0,58,44,0,102
30,81,120,0,0,0,0,120
30,82,402,0,164,64,0,630
30,83,510,0,64,0,0,574
30,84,126,0,55,0,0,181
30,85,138,0,19,0,0,157
30,86,9,18,70,20,0,117
30,87,33,0,184,0,0,217
30,88,539,0,389,358,0,1286
30,89,0,0,119,0,0,119
30,90,0,0,0,199,0,199
30,92,26,0,0,5,0,31
30,93,64,0,99,0,0,163
30,94,13,0,47,0,0,60
30,95,0,0,281,0,0,281
30,96,58,0,55,0,0,113
30,98,0,0,0,53,0,53
30,100,0,0,70,0,0,70
30,101,0,0,357,328,0,685
30,102,0,0,61,0,0,61
30,103,6,0,0,0,0,6
30,105,0,0,70,0,0,70
30,107,198,0,0,0,0,198
30,239,47,0,0,0,0,47
30,240,0,0,55,0,0,55
30,254,109,0,0,0,0,109
31,1,0,0,966,0,0,966
31,2,128,0,716,49,0,893
31,3,87,0,184,0,0,271
31,4,993,3014,1104,0,0,5111
31,5,591,1274,140,0,0,2005
31,6,0,143,65,351,0,559
31,7,0,0,221,0,0,221
31,8,0,0,280,348,0,628
31,9,0,0,26,0,0,26
31,10,0,0,21,0,0,21
31,11,0,0,0,19,0,19
31,14,30,0,0,15,0,45
31,16,0,0,194,0,0,194
31,17,0,0,24,0,0,24
31,18,198,0,0,0,0,198
31,19,0,0,170,0,0,170
31,20,76,0,174,0,0,250
31,21,78,0,329,0,0,407
31,22,0,0,96,0,0,96
31,23,200,0,94,0,0,294
31,24,30,0,0,88,0,118
31,25,564,2493,0,543,0,3600
31,26,128,0,0,0,0,128
31,27,323,0,574,21,0,918
31,28,128,221,93,0,0,442
31,29,173,1985,797,267,0,3222
31,30,784,3384,0,107,0,4275
31,31,181,13678,0,289,0,14148
31,32,409,695,902,22,0,2028
31,33,15,0,24,0,22,61
31,34,147,479,32,206,0,864
31,35,831,125,0,0,0,956
31,36,1042,978,134,428,0,2582
31,37,366,0,125,0,0,491
31,40,87,0,9,0,0,96
31,41,1036,0,142,170,0,1348
31,43,63,0,361,0,0,424
31,44,0,0,81,0,0,81
31,48,0,0,149,0,0,149
31,49,158,0,206,0,0,364
31,50,0,0,62,0,0,62
31,51,197,0,0,0,0,197
31,52,0,0,174,0,0,174
31,53,128,0,88,0,0,216
31,54,0,0,14,0,0,14
31,55,381,0,268,0,0,649
31,56,0,0,1083,0,0,1083
31,57,564,0,98,0,0,662
31,58,0,0,100,0,0,100
31,59,0,0,972,0,0,972
31,60,0,0,284,0,0,284
31,61,0,0,415,0,0,415
31,63,23,0,32,0,0,55
31,64,654,0,294,128,0,1076
31,65,0,0,241,116,0,357
31,66,0,0,416,0,0,416
31,67,80,0,140,0,0,220
31,68,250,0,1250,150,0,1650
31,69,0,0,0,0,186,186
31,70,84,0,0,0,0,84
31,74,39,55,885,30,0,1009
31,75,71,0,250,98,0,419
31,76,348,0,106,0,0,454
31,77,0,0,319,0,0,319
31,78,137,183,129,102,0,551
31,79,86,311,1341,101,0,1839
31,80,0,0,567,0,0,567
31,81,0,0,424,214,0,638
31,82,27,0,337,49,0,413
31,83,530,0,418,172,0,1120
31,84,51,0,51,102,0,204
31,85,52,0,67,0,0,119
31,86,0,0,19,66,0,85
31,87,160,0,24,0,0,184
31,88,515,0,0,0,0,515
31,89,0,0,109,0,0,109
31,90,62,0,79,0,0,141
31,92,0,0,70,0,0,70
31,93,4,0,369,301,0,674
31,94,0,0,99,0,0,99
31,95,102,0,302,0,0,404
31,96,30,0,0,0,0,30
31,97,35,0,0,0,0,35
31,98,0,0,365,0,0,365
31,100,0,0,478,229,0,707
31,102,518,0,220,0,0,738
31,104,21,0,118,0,0,139
31,105,0,0,23,0,0,23
31,106,0,0,28,0,0,28
31,107,302,0,362,0,0,664
31,236,41,0,47,0,0,88
31,238,78,0,293,0,0,371
31,240,0,0,100,0,0,100
31,250,288,0,0,0,0,288
31,251,200,0,0,0,0,200
31,254,0,0,712,0,0,712
32,1,21,55,49,0,0,125
32,3,0,0,466,0,0,466
32,4,43,498,357,0,0,898
32,5,0,172,753,0,0,925
32,6,0,0,488,0,0,488
32,7,0,0,234,0,0,234
32,10,0,0,18,0,0,18
32,12,0,0,100,0,0,100
32,14,0,0,32,0,0,32
32,15,157,0,0,0,0,157
32,17,21,0,20,0,0,41
32,18,0,192,101,0,0,293
32,19,0,0,339,0,0,339
32,20,76,0,0,0,0,76
32,21,110,0,599,0,0,709
32,22,0,0,668,0,0,668
32,23,0,0,63,0,0,63
32,24,120,0,79,39,0,238
32,25,0,21,98,0,0,119
32,26,21,93,0,0,0,114
32,27,186,301,146,79,0,712
32,28,64,474,60,96,0,694
32,29,101,2400,25,11,49,2586
32,30,64,956,140,127,0,1287
32,31,229,1188,607,43,0,2067
32,32,231,16139,0,0,0,16370
32,33,46,705,0,0,0,751
32,34,183,248,120,77,0,628
32,35,0,0,516,0,0,516
32,36,255,22,624,0,0,901
32,42,0,0,81,0,0,81
32,43,180,0,715,0,0,895
32,44,43,0,127,0,0,170
32,47,0,0,290,0,0,290
32,49,0,0,48,0,0,48
32,50,21,0,0,0,0,21
32,52,0,0,387,0,0,387
32,53,339,0,21,0,0,360
32,55,240,0,164,0,0,404
32,56,0,0,348,0,0,348
32,57,0,213,137,0,0,350
32,59,0,0,647,0,0,647
32,60,0,0,21,327,0,348
32,61,0,0,342,21,0,363
32,62,308,77,0,26,0,411
32,63,23,0,47,0,0,70
32,64,60,0,0,0,0,60
32,65,785,0,0,0,0,785
32,66,58,0,0,0,0,58
32,67,0,0,91,0,0,91
32,68,143,0,253,160,0,556
32,69,210,0,250,0,0,460
32,70,84,0,331,0,21,436
32,74,35,983,58,87,0,1163
32,75,168,56,96,187,0,507
32,76,36,0,680,0,21,737
32,77,58,376,576,80,0,1090
32,78,262,879,289,160,0,1590
32,79,287,5370,145,0,0,5802
32,80,180,0,180,0,0,360
32,81,218,0,206,0,0,424
32,82,21,0,122,21,0,164
32,83,167,69,1827,49,0,2112
32,84,344,0,101,230,0,675
32,85,118,21,139,122,0,400
32,86,163,0,39,36,0,238
32,87,131,0,633,0,0,764
32,88,737,0,463,0,0,1200
32,89,0,0,48,168,0,216
32,90,0,0,79,0,0,79
32,91,10,0,0,0,0,10
32,92,93,0,4,0,0,97
32,93,0,0,75,27,0,102
32,94,332,0,223,0,0,555
32,95,0,0,204,0,0,204
32,96,0,0,89,0,0,89
32,97,304,0,35,0,0,339
32,100,35,0,503,0,0,538
32,104,21,0,0,0,0,21
32,106,43,0,56,0,0,99
32,107,99,0,108,0,0,207
32,108,0,0,25,0,0,25
32,236,129,0,207,0,0,336
32,237,47,0,83,0,0,130
32,238,0,0,381,0,0,381
32,239,0,0,374,0,0,374
32,240,0,93,15,0,0,108
32,250,0,0,0,123,0,123
32,254,0,0,582,0,0,582
33,2,15,0,15,0,0,30
33,3,31,0,0,0,0,31
33,4,0,0,8,0,0,8
33,5,7,0,0,15,0,22
33,23,0,0,56,0,0,56
33,24,0,0,0,6,0,6
33,27,38,0,0,0,0,38
33,28,0,0,8,0,0,8
33,29,15,0,21,38,0,74
33,30,31,62,25,219,0,337
33,31,15,6,24,0,0,45
33,32,46,689,0,15,31,781
33,33,32,98,0,0,0,130
33,34,0,22,0,53,0,75
33,35,0,0,0,129,0,129
33,37,18,0,15,0,0,33
33,43,0,0,22,0,0,22
33,49,0,0,27,0,0,27
33,50,15,0,0,0,0,15
33,55,22,0,0,0,0,22
33,56,0,0,0,6,0,6
33,57,0,0,15,0,0,15
33,58,15,0,0,0,0,15
33,61,15,0,0,0,0,15
33,65,37,0,0,0,0,37
33,68,14,0,6,0,0,20
33,74,7,0,0,0,0,7
33,76,38,0,0,0,0,38
33,77,13,15,42,57,0,127
33,79,45,202,25,16,0,288
33,80,15,6,48,0,0,69
33,81,31,0,0,0,0,31
33,82,15,0,15,6,0,36
33,83,77,0,0,0,0,77
33,84,31,51,72,7,0,161
33,85,70,112,0,0,0,182
33,86,0,47,44,0,0,91
33,87,0,0,0,132,0,132
33,88,112,0,0,0,0,112
33,91,0,0,24,0,0,24
33,93,58,0,8,0,0,66
33,94,7,0,0,0,0,7
33,95,16,0,0,15,0,31
33,96,37,0,0,0,0,37
33,100,0,0,8,0,0,8
33,102,35,128,0,0,0,163
34,1,23,0,166,0,0,189
34,2,0,0,39,39,0,78
34,3,39,0,0,0,0,39
34,4,0,77,42,0,43,162
34,5,373,0,39,39,0,451
34,6,0,0,67,0,0,67
34,7,0,0,0,62,0,62
34,9,0,0,134,0,0,134
34,17,23,0,0,0,0,23
34,18,23,0,0,0,0,23
34,21,119,0,0,0,0,119
34,24,0,0,63,39,0,102
34,26,30,0,0,39,0,69
34,27,60,0,30,0,0,90
34,28,23,0,0,0,0,23
34,29,39,0,32,47,0,118
34,30,413,1579,0,179,0,2171
34,31,217,410,32,206,0,865
34,32,139,841,120,107,0,1207
34,33,0,22,0,53,0,75
34,34,226,2993,0,39,0,3258
34,35,221,297,0,0,0,518
34,36,1411,631,0,23,0,2065
34,37,92,0,0,39,0,131
34,38,35,0,32,0,0,67
34,43,23,0,0,0,0,23
34,45,0,0,156,0,0,156
34,48,121,0,0,0,0,121
34,52,0,0,42,0,0,42
34,54,0,0,59,50,0,109
34,56,86,0,61,0,0,147
34,57,0,0,0,77,0,77
34,61,0,0,30,0,0,30
34,62,0,0,32,0,56,88
34,63,0,0,0,11,0,11
34,64,240,0,42,0,0,282
34,66,23,0,0,0,0,23
34,68,39,0,72,30,0,141
34,69,39,0,38,0,0,77
34,70,0,0,0,17,0,17
34,74,175,0,0,0,0,175
34,75,95,0,0,0,0,95
34,76,39,0,42,0,0,81
34,77,0,0,135,0,0,135
34,78,174,0,61,0,0,235
34,79,181,0,0,0,0,181
34,80,178,0,178,0,0,356
34,81,146,0,351,47,0,544
34,82,47,0,100,53,0,200
34,83,227,0,64,77,0,368
34,84,464,149,32,191,0,836
34,85,390,73,0,88,0,551
34,86,136,0,0,0,0,136
34,87,61,0,92,0,0,153
34,88,277,0,0,0,0,277
34,89,224,0,79,0,0,303
34,90,123,0,0,67,0,190
34,93,117,23,0,39,0,179
34,95,112,0,0,39,0,151
34,96,133,0,0,0,0,133
34,97,98,0,0,35,0,133
34,99,58,0,0,0,0,58
34,100,39,0,25,0,56,120
34,102,0,0,42,0,0,42
34,103,0,0,11,0,0,11
34,105,39,0,0,0,0,39
34,106,0,0,18,0,0,18
34,107,118,0,128,0,0,246
34,251,39,0,0,39,0,78
35,1,0,0,1824,0,0,1824
35,2,0,0,0,40,0,40
35,4,612,744,1565,0,0,2921
35,5,0,2874,2060,0,234,5168
35,6,0,5280,592,0,0,5872
35,7,47,1355,0,0,0,1402
35,8,587,2276,154,0,0,3017
35,9,0,71,43,0,0,114
35,10,0,11,0,0,0,11
35,14,0,0,29,0,0,29
35,16,291,129,2057,0,0,2477
35,18,0,254,0,852,0,1106
35,21,0,0,210,0,160,370
35,22,0,0,268,0,0,268
35,23,0,0,442,0,0,442
35,24,0,0,181,0,0,181
35,26,227,0,0,0,0,227
35,27,60,0,899,0,0,959
35,28,310,0,91,0,0,401
35,30,64,3172,0,0,0,3236
35,31,691,527,0,0,0,1218
35,32,0,0,516,0,0,516
35,34,221,78,0,0,0,299
35,35,42,21131,0,527,0,21700
35,36,2613,5305,1857,801,0,10576
35,37,0,0,173,0,0,173
35,40,18,0,18,18,0,54
35,43,0,0,21,0,0,21
35,44,0,0,665,0,0,665
35,49,0,0,478,0,0,478
35,50,0,0,157,0,0,157
35,54,0,0,527,0,0,527
35,57,120,0,75,0,0,195
35,61,0,0,0,23,0,23
35,62,3204,0,292,0,0,3496
35,63,0,0,376,0,0,376
35,65,231,0,116,0,0,347
35,67,0,0,268,0,0,268
35,68,162,0,0,0,0,162
35,69,73,0,87,0,0,160
35,76,28,0,0,0,0,28
35,77,135,0,473,0,0,608
35,78,102,0,0,0,0,102
35,79,41,0,0,0,0,41
35,80,0,0,553,44,0,597
35,81,56,0,0,291,0,347
35,82,55,0,0,0,0,55
35,83,0,0,53,0,0,53
35,84,147,0,292,51,0,490
35,85,24,0,107,0,0,131
35,87,33,0,142,0,0,175
35,89,48,0,124,0,0,172
35,91,0,0,62,0,0,62
35,92,4,493,0,0,0,497
35,93,0,0,291,40,0,331
35,94,0,0,29,0,0,29
35,95,102,0,0,0,0,102
35,97,0,0,64,0,0,64
35,101,0,0,181,0,0,181
35,102,0,0,69,0,0,69
35,104,0,0,27,0,0,27
35,105,0,0,242,0,0,242
35,106,0,0,65,0,0,65
35,240,206,0,0,0,0,206
36,1,0,0,752,0,0,752
36,2,0,0,226,0,0,226
36,3,0,0,156,0,0,156
36,4,0,0,466,0,0,466
36,5,622,448,1115,95,34,2314
36,6,0,0,587,0,649,1236
36,7,95,131,0,448,0,674
36,8,262,0,120,0,0,382
36,9,0,0,109,0,0,109
36,14,131,0,0,0,0,131
36,15,0,0,79,0,0,79
36,17,0,0,89,0,0,89
36,21,0,0,466,0,0,466
36,22,109,0,131,0,0,240
36,23,33,0,154,0,0,187
36,24,0,0,788,0,0,788
36,25,333,0,0,0,285,618
36,26,466,0,0,0,0,466
36,27,162,0,834,0,0,996
36,28,102,0,0,38,89,229
36,29,262,0,118,0,0,380
36,30,1768,1627,51,95,0,3541
36,31,972,320,920,730,0,2942
36,32,337,22,143,0,0,502
36,34,1694,620,0,23,0,2337
36,35,3188,6136,1857,456,0,11637
36,36,1381,15503,974,812,83,18753
36,37,491,0,0,12,0,503
36,38,0,0,35,0,0,35
36,39,0,0,78,131,0,209
36,40,0,0,121,0,0,121
36,43,0,0,281,0,0,281
36,44,131,0,0,0,0,131
36,54,131,0,310,0,0,441
36,55,0,0,125,0,0,125
36,56,381,0,186,0,0,567
36,57,131,0,338,0,0,469
36,58,0,0,100,0,0,100
36,59,0,0,527,0,0,527
36,61,1270,0,204,0,0,1474
36,62,131,0,0,0,0,131
36,68,252,0,0,131,0,383
36,69,412,0,448,0,0,860
36,74,284,0,143,0,0,427
36,75,0,0,61,0,0,61
36,76,466,0,252,0,0,718
36,77,0,0,0,232,0,232
36,78,102,0,160,88,0,350
36,79,0,0,420,0,0,420
36,80,492,0,195,131,0,818
36,81,131,0,0,0,0,131
36,82,131,0,559,0,0,690
36,83,423,0,300,805,0,1528
36,84,752,479,835,121,0,2187
36,85,57,476,24,11,0,568
36,86,71,0,0,45,0,116
36,87,89,0,0,24,49,162
36,88,492,0,150,131,0,773
36,89,0,0,31,48,0,79
36,90,0,0,487,0,0,487
36,91,191,0,0,0,0,191
36,92,30,95,417,0,0,542
36,93,1369,1400,3545,77,0,6391
36,94,464,445,389,0,0,1298
36,95,95,0,0,0,0,95
36,97,166,0,0,0,0,166
36,100,48,0,0,0,0,48
36,101,62,0,0,0,0,62
36,102,9,0,0,0,0,9
36,104,9,0,100,0,0,109
36,105,0,0,0,50,0,50
36,106,131,0,0,0,0,131
36,237,0,0,72,0,0,72
36,240,0,0,196,0,0,196
36,250,0,0,102,0,0,102
36,251,466,0,0,0,0,466
37,1,0,0,257,0,0,257
37,2,0,0,93,0,0,93
37,5,18,0,90,0,0,108
37,6,0,0,704,0,0,704
37,7,98,83,97,0,94,372
37,8,0,993,151,0,232,1376
37,9,18,92,441,0,0,551
37,11,0,0,49,23,0,72
37,12,0,0,70,0,441,511
37,13,0,0,18,0,0,18
37,14,18,0,0,0,0,18
37,16,0,0,130,0,0,130
37,18,212,0,0,0,0,212
37,21,0,0,83,0,0,83
37,24,0,0,447,0,0,447
37,27,0,0,18,0,0,18
37,29,0,0,55,0,0,55
37,30,238,0,0,82,0,320
37,31,18,0,125,0,0,143
37,33,32,0,0,0,0,32
37,34,130,0,0,0,0,130
37,36,461,18,0,12,0,491
37,37,36,3053,0,0,0,3089
37,43,0,0,63,0,0,63
37,49,0,0,85,0,0,85
37,54,36,0,0,0,0,36
37,55,0,0,186,0,0,186
37,57,497,0,0,0,225,722
37,62,65,0,15,0,0,80
37,64,120,0,0,0,0,120
37,67,80,0,0,0,0,80
37,68,0,0,72,0,0,72
37,74,0,0,37,0,0,37
37,76,0,0,41,0,0,41
37,77,348,0,0,0,45,393
37,78,19,0,102,0,0,121
37,80,0,0,0,18,0,18
37,82,0,0,31,0,0,31
37,83,0,0,0,37,0,37
37,84,69,0,0,0,0,69
37,85,11,0,0,24,0,35
37,88,138,0,222,0,0,360
37,90,72,0,83,0,0,155
37,91,71,0,62,0,0,133
37,92,52,574,0,0,0,626
37,93,85,149,0,0,0,234
37,94,151,83,0,0,0,234
37,95,0,0,81,0,0,81
37,99,0,0,70,0,0,70
37,100,379,0,166,0,0,545
37,103,0,0,11,0,0,11
37,104,0,0,117,0,0,117
37,106,0,0,0,0,50,50
37,108,53,0,0,0,0,53
37,254,600,0,0,61,0,661
38,1,0,0,29,0,0,29
38,2,0,0,0,35,0,35
38,3,0,0,35,0,0,35
38,5,35,0,0,0,0,35
38,7,71,35,32,0,0,138
38,8,0,0,0,35,0,35
38,10,0,18,0,84,0,102
38,11,22,442,0,69,0,533
38,12,112,212,122,0,0,446
38,13,0,18,0,0,0,18
38,14,0,35,0,0,0,35
38,15,0,18,0,0,0,18
38,18,35,0,0,0,0,35
38,26,0,0,38,0,0,38
38,30,35,64,64,0,0,163
38,34,65,0,0,0,0,65
38,36,0,0,35,0,0,35
38,38,0,1074,0,84,0,1158
38,39,78,374,77,52,0,581
38,41,0,29,38,0,0,67
38,42,141,544,102,113,0,900
38,43,0,0,82,0,0,82
38,44,0,0,0,42,0,42
38,45,0,0,38,0,0,38
38,54,0,0,38,0,0,38
38,57,0,0,62,0,0,62
38,62,18,0,0,0,0,18
38,63,0,0,32,0,0,32
38,68,35,0,0,0,0,35
38,79,88,0,0,0,0,88
38,81,0,0,35,0,0,35
38,236,112,0,0,0,0,112
38,250,0,0,0,18,0,18
39,1,0,0,181,0,0,181
39,2,0,0,310,0,0,310
39,8,0,0,52,0,0,52
39,10,0,0,51,0,7,58
39,11,91,11,0,0,0,102
39,15,0,0,85,0,0,85
39,16,0,0,51,0,0,51
39,17,0,0,122,0,0,122
39,18,249,0,122,0,0,371
39,24,78,0,47,0,0,125
39,29,0,0,78,0,0,78
39,31,87,0,0,0,0,87
39,36,0,0,78,131,0,209
39,38,78,444,0,52,0,574
39,39,0,1686,171,0,0,1857
39,40,18,0,20,0,0,38
39,41,254,1466,0,286,0,2006
39,42,0,153,81,309,0,543
39,43,209,0,131,420,0,760
39,44,223,0,0,0,0,223
39,45,332,0,0,0,0,332
39,47,0,0,112,0,0,112
39,48,446,0,0,0,0,446
39,49,175,0,0,0,0,175
39,54,0,0,285,0,0,285
39,65,111,0,135,0,0,246
39,69,73,0,0,0,0,73
39,75,0,0,0,78,0,78
39,77,78,0,0,0,0,78
39,84,0,0,152,0,0,152
39,93,40,0,0,0,0,40
39,99,78,0,0,0,0,78
39,100,150,0,0,0,0,150
40,1,64,0,69,0,0,133
40,2,0,0,156,0,0,156
40,4,0,0,18,0,0,18
40,5,0,0,18,0,0,18
40,7,9,0,0,0,0,9
40,11,649,0,0,0,0,649
40,12,0,0,20,0,0,20
40,15,0,0,120,0,0,120
40,16,18,9,10,63,0,100
40,17,0,0,0,24,0,24
40,18,27,0,124,0,0,151
40,20,0,0,130,0,0,130
40,22,0,0,18,0,0,18
40,23,0,0,37,0,0,37
40,26,0,0,175,0,0,175
40,29,0,0,138,0,0,138
40,31,0,0,9,0,0,9
40,35,18,0,0,18,0,36
40,36,0,0,121,0,0,121
40,39,106,0,20,0,0,126
40,40,586,8457,0,141,54,9238
40,41,684,1187,163,350,0,2384
40,42,0,0,23,0,0,23
40,43,586,949,0,275,0,1810
40,44,536,0,0,0,0,536
40,45,263,0,70,0,0,333
40,47,107,0,0,0,0,107
40,48,37,174,21,77,0,309
40,49,0,0,18,0,0,18
40,53,0,0,9,0,0,9
40,57,0,0,46,0,0,46
40,60,102,0,0,0,0,102
40,62,27,0,0,0,0,27
40,64,37,0,18,0,0,55
40,67,0,0,28,0,0,28
40,68,0,0,18,0,0,18
40,77,0,0,10,0,0,10
40,79,0,0,18,0,0,18
40,80,0,0,60,0,0,60
40,82,0,0,0,27,0,27
40,84,51,0,0,0,0,51
40,85,24,0,0,0,0,24
40,92,18,0,0,0,0,18
40,93,18,0,18,0,0,36
40,103,35,0,0,0,0,35
40,106,18,0,0,0,0,18
40,236,123,0,0,0,0,123
40,252,0,0,620,0,0,620
40,254,37,0,20,10,0,67
41,1,0,0,657,0,0,657
41,2,1364,26,61,0,0,1451
41,4,121,0,0,0,0,121
41,5,0,0,55,0,0,55
41,6,0,0,404,0,0,404
41,7,11,0,0,0,0,11
41,12,202,0,0,0,0,202
41,13,17,0,18,0,0,35
41,14,180,59,137,0,0,376
41,15,175,1110,263,439,99,2086
41,16,0,0,68,0,98,166
41,17,0,0,151,0,0,151
41,18,121,0,0,0,0,121
41,20,0,0,62,0,0,62
41,23,0,0,43,121,0,164
41,25,121,0,0,0,0,121
41,27,26,0,0,0,0,26
41,29,26,0,373,0,0,399
41,31,1036,0,263,49,0,1348
41,36,9,0,0,0,0,9
41,38,0,29,38,0,0,67
41,39,228,1202,0,364,0,1794
41,40,602,1270,163,350,0,2385
41,41,3202,21652,689,589,0,26132
41,42,156,672,192,0,0,1020
41,43,886,1904,1132,52,0,3974
41,44,684,0,26,0,0,710
41,45,121,0,327,332,0,780
41,48,0,0,41,175,0,216
41,49,0,0,48,0,0,48
41,51,0,0,26,0,0,26
41,58,0,0,63,0,0,63
41,61,0,0,121,0,0,121
41,65,109,0,0,0,0,109
41,68,0,0,140,0,0,140
41,69,0,0,121,0,0,121
41,70,121,0,121,0,0,242
41,76,0,0,26,0,0,26
41,77,0,0,1046,0,0,1046
41,78,121,0,60,0,0,181
41,79,23,0,26,0,0,49
41,82,0,0,494,0,0,494
41,83,234,0,0,0,0,234
41,88,138,0,0,0,0,138
41,91,26,0,0,0,0,26
41,95,0,0,30,0,0,30
41,97,45,0,0,0,0,45
41,98,0,0,53,0,0,53
41,99,0,0,53,0,0,53
41,105,50,0,0,0,0,50
41,107,198,0,0,0,0,198
41,250,156,0,0,0,0,156
41,254,0,0,320,0,0,320
42,2,0,24,443,0,0,467
42,5,0,0,0,360,0,360
42,6,0,0,511,0,0,511
42,7,0,0,81,0,0,81
42,10,0,8,0,5,0,13
42,11,79,11,10,27,0,127
42,12,457,803,0,0,0,1260
42,13,0,168,0,0,0,168
42,14,0,1722,98,37,0,1857
42,15,74,593,0,56,154,877
42,16,0,0,0,68,118,186
42,17,0,48,209,0,107,364
42,18,66,0,20,0,0,86
42,24,244,0,66,0,0,310
42,32,0,0,81,0,0,81
42,38,74,611,102,113,0,900
42,39,112,319,498,0,0,929
42,40,0,0,23,0,0,23
42,41,196,584,120,0,0,900
42,42,143,1353,0,0,0,1496
42,43,198,24,188,0,0,410
42,45,656,0,0,0,0,656
42,51,0,0,81,0,0,81
42,68,0,0,23,0,0,23
42,74,0,0,21,0,0,21
42,75,0,0,0,35,0,35
42,79,24,0,0,0,0,24
42,82,0,0,21,0,0,21
42,85,24,0,0,0,0,24
42,91,0,0,81,0,0,81
42,241,202,0,0,0,0,202
42,254,0,0,57,0,0,57
43,1,160,0,480,0,0,640
43,2,63,0,243,0,0,306
43,3,126,0,238,63,0,427
43,4,0,0,323,0,0,323
43,5,126,0,194,0,0,320
43,6,63,0,1287,69,0,1419
43,7,167,0,500,45,0,712
43,8,0,0,90,0,0,90
43,9,0,71,0,324,0,395
43,10,0,0,63,0,0,63
43,13,0,0,13,0,0,13
43,14,315,0,45,63,0,423
43,15,421,113,247,52,0,833
43,16,403,0,89,0,0,492
43,17,176,0,0,0,0,176
43,18,0,162,370,0,0,532
43,19,0,0,0,70,0,70
43,20,63,0,0,0,0,63
43,21,167,0,0,0,0,167
43,22,96,0,0,0,0,96
43,23,63,0,455,0,0,518
43,26,0,0,63,0,0,63
43,27,0,0,393,0,0,393
43,28,0,0,84,0,0,84
43,29,63,0,169,0,0,232
43,30,0,0,129,0,0,129
43,31,136,0,357,0,0,493
43,32,180,0,84,0,0,264
43,33,0,0,22,0,0,22
43,34,23,0,63,0,0,86
43,35,0,0,581,0,0,581
43,37,0,0,63,0,0,63
43,38,35,0,82,0,0,117
43,39,209,0,209,264,0,682
43,40,559,854,149,315,0,1877
43,41,886,1716,741,52,0,3395
43,42,198,24,188,0,0,410
43,43,1163,10537,727,0,0,12427
43,44,1228,350,681,258,433,2950
43,45,978,2258,1295,344,0,4875
43,47,850,1460,1115,296,141,3862
43,48,768,728,241,96,0,1833
43,49,86,0,0,0,0,86
43,50,74,0,0,0,0,74
43,51,104,0,0,0,0,104
43,52,0,0,63,0,0,63
43,53,0,0,146,0,0,146
43,54,98,0,0,0,0,98
43,55,168,0,217,0,0,385
43,56,83,0,0,0,0,83
43,59,0,0,393,0,0,393
43,60,0,0,345,0,0,345
43,64,0,0,106,0,0,106
43,65,0,0,111,0,0,111
43,67,0,0,0,162,0,162
43,68,121,0,98,98,0,317
43,69,0,0,167,0,0,167
43,70,90,0,0,0,0,90
43,74,132,0,0,0,0,132
43,75,0,0,35,0,0,35
43,77,0,0,98,0,0,98
43,78,126,0,170,98,0,394
43,79,126,0,138,63,0,327
43,80,0,0,45,0,0,45
43,81,0,0,0,102,0,102
43,82,37,0,0,0,0,37
43,83,0,0,247,0,0,247
43,84,0,0,55,0,0,55
43,86,0,0,41,0,0,41
43,87,100,0,0,0,0,100
43,91,0,0,9,0,0,9
43,92,0,0,73,0,0,73
43,93,47,0,78,0,59,184
43,94,0,0,62,0,0,62
43,96,0,0,98,0,0,98
43,97,153,0,40,0,0,193
43,99,0,0,98,0,0,98
43,100,0,0,642,0,0,642
43,102,0,0,114,0,0,114
43,106,0,0,35,0,0,35
43,236,0,0,58,0,0,58
43,240,63,0,68,0,0,131
43,241,0,0,49,0,0,49
43,250,108,0,0,0,0,108
43,254,160,0,1433,0,0,1593
44,1,0,0,244,0,0,244
44,2,455,0,165,0,0,620
44,5,42,0,0,0,0,42
44,7,0,0,534,0,0,534
44,9,56,0,0,0,0,56
44,12,0,0,61,0,0,61
44,14,0,0,0,37,0,37
44,15,68,464,0,86,0,618
44,16,0,250,199,63,0,512
44,17,0,0,330,0,0,330
44,18,0,0,326,743,433,1502
44,23,0,0,127,0,0,127
44,29,0,0,152,0,0,152
44,31,0,0,81,0,0,81
44,32,43,0,127,0,0,170
44,35,0,0,665,0,0,665
44,36,131,0,0,0,0,131
44,38,0,0,0,42,0,42
44,39,301,0,0,0,0,301
44,40,536,0,0,0,0,536
44,41,684,0,0,0,0,684
44,42,56,0,26,37,0,119
44,43,1157,838,403,258,0,2656
44,44,950,6477,330,117,0,7874
44,45,1812,2134,276,1185,0,5407
44,47,880,1367,0,200,0,2447
44,48,56,247,162,0,0,465
44,51,104,0,0,0,0,104
44,54,11,0,152,0,0,163
44,55,56,0,0,72,0,128
44,58,0,0,671,0,0,671
44,60,0,0,102,0,0,102
44,62,0,0,174,0,0,174
44,66,58,0,0,0,0,58
44,68,302,0,0,0,0,302
44,74,0,0,152,0,0,152
44,75,47,0,0,0,0,47
44,85,0,0,11,0,0,11
44,87,0,0,33,0,0,33
44,92,0,0,47,0,0,47
44,99,34,0,0,0,0,34
44,103,16,0,0,0,0,16
44,106,0,0,56,0,0,56
44,236,567,0,0,0,0,567
44,237,26,0,35,47,0,108
44,238,0,0,135,0,0,135
44,239,0,0,67,0,0,67
44,241,48,391,0,0,0,439
44,254,1560,0,138,0,0,1698
45,1,0,0,442,0,0,442
45,2,240,0,1300,0,0,1540
45,3,247,0,0,0,0,247
45,4,0,0,246,0,0,246
45,5,240,0,483,166,0,889
45,9,0,0,754,0,0,754
45,11,46,0,0,0,0,46
45,13,0,0,11,0,0,11
45,14,166,0,0,0,0,166
45,15,240,24,0,0,0,264
45,16,81,126,359,129,0,695
45,17,24,0,553,226,0,803
45,18,379,187,0,80,0,646
45,19,0,0,0,236,0,236
45,20,0,0,180,0,0,180
45,21,0,0,83,321,0,404
45,23,240,0,180,0,0,420
45,24,0,0,222,0,0,222
45,27,449,0,447,0,0,896
45,28,0,0,306,0,0,306
45,29,22,0,240,0,0,262
45,32,166,0,0,0,0,166
45,34,0,0,156,0,0,156
45,36,0,0,121,0,0,121
45,38,0,0,38,0,0,38
45,39,332,0,0,0,0,332
45,40,263,0,70,0,0,333
45,41,121,0,327,332,0,780
45,42,56,0,0,0,0,56
45,43,864,2407,1395,344,0,5010
45,44,2229,2526,931,1185,0,6871
45,45,1340,19463,867,240,0,21910
45,47,279,107,180,134,155,855
45,48,69,0,0,299,155,523
45,49,166,0,0,0,0,166
45,52,115,0,0,0,0,115
45,56,0,0,240,0,0,240
45,57,0,0,156,0,0,156
45,59,0,0,607,0,0,607
45,60,69,0,0,0,0,69
45,62,27,0,0,0,0,27
45,64,120,0,104,120,0,344
45,69,172,0,0,0,0,172
45,76,204,0,0,0,0,204
45,77,0,0,0,140,0,140
45,78,268,0,0,0,0,268
45,80,496,0,0,0,0,496
45,86,0,0,166,0,0,166
45,91,0,0,0,660,0,660
45,108,240,0,0,0,0,240
45,236,0,0,50,0,0,50
45,237,194,0,0,0,0,194
45,239,240,0,0,0,0,240
45,240,206,0,224,0,0,430
45,241,0,92,58,0,77,227
45,250,254,0,0,0,0,254
45,251,0,0,0,1168,0,1168
45,254,1657,293,519,807,0,3276
47,1,0,0,383,0,0,383
47,5,0,0,107,0,0,107
47,6,0,0,107,0,0,107
47,10,21,0,0,0,0,21
47,15,106,0,0,0,0,106
47,18,0,125,0,372,0,497
47,19,0,0,117,0,0,117
47,20,724,0,0,0,0,724
47,22,0,0,107,0,0,107
47,26,0,0,113,0,0,113
47,32,0,0,183,0,0,183
47,39,0,0,112,0,0,112
47,40,107,0,0,0,0,107
47,41,0,0,536,0,0,536
47,43,1515,1076,460,296,141,3488
47,44,817,1367,0,200,0,2384
47,45,279,241,180,0,311,1011
47,47,704,7397,0,0,0,8101
47,48,3185,2765,0,352,0,6302
47,58,97,0,0,0,0,97
47,62,0,0,352,0,0,352
47,63,11,0,0,0,0,11
47,64,107,0,0,0,0,107
47,74,352,0,0,0,0,352
47,77,55,0,0,0,0,55
47,82,0,0,107,0,0,107
47,88,101,0,0,0,0,101
47,91,107,0,134,0,0,241
47,94,0,0,107,0,0,107
47,240,0,0,117,0,0,117
47,254,474,184,776,214,0,1648
48,1,0,0,445,0,0,445
48,2,247,0,269,0,0,516
48,4,247,0,0,0,0,247
48,7,0,0,269,0,0,269
48,11,23,0,0,0,0,23
48,16,247,0,0,0,0,247
48,17,164,0,0,0,0,164
48,18,368,0,254,247,0,869
48,22,0,0,36,0,0,36
48,34,121,0,0,0,0,121
48,39,446,0,0,0,0,446
48,40,37,174,21,77,0,309
48,41,0,0,41,175,0,216
48,43,768,1112,162,96,0,2138
48,44,56,247,162,0,0,465
48,45,69,0,0,299,0,368
48,47,3185,1978,438,352,155,6108
48,48,989,3756,0,1028,0,5773
48,53,0,0,194,0,0,194
48,56,0,0,0,0,359,359
48,57,0,0,157,0,0,157
48,59,607,0,298,0,0,905
48,65,0,0,269,0,0,269
48,68,193,0,0,0,0,193
48,79,0,0,247,0,0,247
48,81,0,0,191,0,0,191
48,91,0,0,186,0,0,186
48,93,0,0,49,0,0,49
48,102,0,0,0,114,0,114
48,241,716,0,0,0,0,716
48,251,316,0,0,0,0,316
48,254,562,0,162,0,0,724
49,1,0,0,156,0,0,156
49,2,0,0,251,0,0,251
49,3,0,0,439,244,0,683
49,5,74,0,570,0,0,644
49,7,0,0,74,0,0,74
49,14,0,0,31,0,0,31
49,15,0,0,24,0,0,24
49,16,0,0,88,0,0,88
49,17,0,0,74,0,0,74
49,18,0,0,325,80,0,405
49,19,274,256,128,0,0,658
49,20,1123,50,785,151,0,2109
49,21,668,376,168,76,0,1288
49,22,0,885,0,0,107,992
49,23,155,1409,449,0,0,2013
49,24,0,0,349,0,0,349
49,25,0,48,74,32,0,154
49,26,0,513,266,0,0,779
49,27,74,214,206,0,0,494
49,28,129,0,265,0,0,394
49,29,0,34,40,0,0,74
49,31,158,0,206,0,0,364
49,32,0,0,48,0,0,48
49,33,0,0,6,0,0,6
49,34,39,0,0,0,0,39
49,35,0,0,514,0,0,514
49,37,0,0,85,0,0,85
49,39,175,0,0,0,0,175
49,40,0,0,18,0,0,18
49,41,0,0,48,0,0,48
49,42,0,0,8,0,0,8
49,43,74,0,86,0,0,160
49,45,166,0,0,0,0,166
49,49,427,5729,0,110,0,6266
49,50,74,0,119,126,0,319
49,51,147,0,0,97,0,244
49,52,0,627,386,181,0,1194
49,53,94,121,200,269,0,684
49,54,565,0,98,26,0,689
49,55,0,279,0,80,0,359
49,56,468,1218,0,99,0,1785
49,57,815,488,0,80,0,1383
49,58,50,0,127,108,0,285
49,59,0,393,1017,0,0,1410
49,60,0,0,164,0,0,164
49,61,26,0,298,0,0,324
49,62,258,53,52,0,0,363
49,63,147,0,54,0,0,201
49,64,194,0,104,0,0,298
49,65,227,0,153,0,0,380
49,66,119,0,0,0,0,119
49,67,83,0,0,0,0,83
49,68,0,0,81,0,0,81
49,69,248,0,0,153,0,401
49,70,0,0,0,35,0,35
49,74,98,388,203,0,0,689
49,75,0,0,56,0,0,56
49,76,0,0,38,0,0,38
49,78,512,0,10,222,104,848
49,79,0,0,256,0,0,256
49,81,219,0,32,0,0,251
49,82,0,0,172,0,0,172
49,83,0,0,74,39,0,113
49,84,93,0,48,0,0,141
49,86,18,0,0,0,0,18
49,87,0,0,127,0,0,127
49,88,0,0,291,0,0,291
49,89,0,0,255,0,0,255
49,90,0,0,72,0,0,72
49,93,0,0,419,0,0,419
49,96,50,0,50,0,0,100
49,97,0,0,50,0,0,50
49,99,38,0,0,0,0,38
49,100,0,0,161,0,0,161
49,101,0,0,328,0,0,328
49,102,0,0,58,0,0,58
49,103,0,0,10,10,0,20
49,104,0,0,36,0,0,36
49,108,74,0,0,0,0,74
49,236,47,0,0,0,0,47
49,237,0,0,171,0,0,171
49,238,0,0,74,147,72,293
49,239,0,0,241,0,0,241
49,240,352,0,224,0,0,576
49,241,0,0,121,0,0,121
50,1,0,0,24,0,0,24
50,2,0,0,98,74,0,172
50,3,0,0,412,0,0,412
50,5,74,0,0,0,0,74
50,6,0,0,74,0,0,74
50,9,32,0,74,0,0,106
50,10,35,0,0,0,0,35
50,11,0,0,62,0,0,62
50,14,0,0,62,0,0,62
50,17,148,0,0,0,0,148
50,18,425,62,38,0,0,525
50,19,697,339,180,0,0,1216
50,20,749,0,0,192,0,941
50,22,0,0,38,0,0,38
50,24,0,0,163,0,0,163
50,26,0,0,38,0,0,38
50,27,0,0,32,0,0,32
50,29,55,0,0,0,0,55
50,32,21,0,0,0,0,21
50,35,0,0,157,0,0,157
50,49,130,0,119,108,0,357
50,50,989,960,0,299,286,2534
50,51,840,870,0,274,0,1984
50,52,115,286,38,0,0,439
50,53,356,125,62,0,0,543
50,54,0,0,0,37,0,37
50,56,221,0,0,99,0,320
50,59,0,0,196,0,0,196
50,61,152,0,0,0,0,152
50,62,74,0,0,74,0,148
50,64,0,0,38,0,0,38
50,66,38,0,0,70,0,108
50,70,35,0,0,156,0,191
50,74,0,0,0,62,0,62
50,76,70,0,0,0,0,70
50,79,0,0,38,0,0,38
50,80,74,0,0,0,0,74
50,82,0,0,74,0,0,74
50,93,0,0,32,0,0,32
50,94,74,0,0,0,0,74
50,95,15,0,74,0,0,89
50,96,76,0,0,0,0,76
50,101,74,0,0,0,0,74
50,108,74,0,0,0,0,74
50,236,41,0,80,94,0,215
50,239,55,110,132,0,0,297
50,240,712,35,106,120,0,973
50,241,136,0,0,0,0,136
50,251,183,0,0,0,0,183
51,1,297,0,327,0,0,624
51,2,104,0,93,0,0,197
51,5,0,0,456,104,0,560
51,6,0,0,104,0,0,104
51,9,0,0,80,0,0,80
51,10,0,0,104,0,0,104
51,16,0,0,104,0,0,104
51,17,0,0,104,0,0,104
51,18,104,0,0,0,0,104
51,19,184,330,0,104,0,618
51,21,0,155,714,0,0,869
51,22,455,0,104,0,0,559
51,24,0,0,274,0,0,274
51,28,0,0,87,0,126,213
51,29,0,0,93,0,0,93
51,30,0,0,94,0,0,94
51,31,197,0,0,0,0,197
51,41,0,0,26,0,0,26
51,42,0,0,81,0,0,81
51,43,104,0,0,0,0,104
51,44,104,0,0,0,0,104
51,49,147,0,0,97,0,244
51,50,675,870,0,274,0,1819
51,51,1217,2785,0,193,0,4195
51,52,475,629,0,0,0,1104
51,53,162,0,344,0,0,506
51,54,245,130,210,0,0,585
51,55,311,262,84,104,0,761
51,56,277,493,0,248,0,1018
51,57,75,0,318,0,0,393
51,58,352,0,201,0,0,553
51,59,482,0,87,0,0,569
51,60,102,0,0,150,0,252
51,62,193,0,0,0,0,193
51,66,58,0,0,0,0,58
51,67,104,0,0,0,0,104
51,68,174,0,0,0,0,174
51,69,197,0,0,0,0,197
51,70,208,0,0,0,0,208
51,74,0,0,104,0,0,104
51,77,104,0,104,0,0,208
51,79,178,0,0,0,0,178
51,80,104,0,0,0,0,104
51,82,87,0,0,0,0,87
51,84,93,0,0,89,0,182
51,85,0,0,24,0,0,24
51,92,0,0,1,0,0,1
51,99,0,0,161,0,0,161
51,236,180,0,0,0,0,180
51,238,239,0,0,0,0,239
51,239,1174,288,366,0,0,1828
51,240,185,0,0,0,0,185
51,241,193,0,0,0,0,193
51,250,0,0,0,248,0,248
51,251,0,0,28,0,0,28
51,254,0,0,448,600,0,1048
52,1,61,0,61,0,0,122
52,3,0,0,124,0,0,124
52,5,0,0,121,0,0,121
52,9,353,0,0,0,0,353
52,18,184,0,0,0,0,184
52,19,507,0,170,0,0,677
52,20,0,0,60,0,0,60
52,21,468,439,0,0,0,907
52,22,61,0,76,0,0,137
52,23,0,0,208,0,0,208
52,24,240,0,92,0,0,332
52,27,162,0,0,152,0,314
52,28,0,0,371,0,0,371
52,29,0,0,325,0,0,325
52,31,0,0,325,0,0,325
52,32,0,0,387,0,0,387
52,34,0,0,42,0,0,42
52,43,0,0,63,0,0,63
52,45,115,0,0,0,0,115
52,49,0,627,361,181,0,1169
52,50,176,286,38,0,0,500
52,51,653,709,0,0,0,1362
52,52,61,2227,0,0,0,2288
52,53,115,1460,105,118,0,1798
52,54,59,0,66,0,0,125
52,55,552,0,0,0,0,552
52,56,635,148,228,0,0,1011
52,57,276,61,569,0,0,906
52,58,0,306,229,0,0,535
52,61,0,0,567,0,0,567
52,62,0,0,27,0,0,27
52,64,0,0,131,0,0,131
52,65,0,0,121,0,0,121
52,68,42,0,0,0,0,42
52,69,185,0,0,0,0,185
52,74,62,0,387,0,0,449
52,75,0,0,112,0,0,112
52,77,220,0,140,0,0,360
52,79,61,0,251,0,0,312
52,80,0,0,0,180,0,180
52,81,98,0,61,0,0,159
52,83,0,0,61,0,0,61
52,87,0,0,160,0,0,160
52,91,0,0,89,0,0,89
52,92,0,0,42,0,0,42
52,94,0,0,62,0,0,62
52,95,0,0,150,75,0,225
52,99,0,0,34,0,0,34
52,107,0,0,313,0,0,313
52,237,0,0,26,0,0,26
52,239,148,0,0,0,0,148
52,240,42,206,0,0,0,248
52,241,185,0,0,0,0,185
53,1,0,0,136,0,0,136
53,2,0,0,58,0,0,58
53,4,0,0,233,0,0,233
53,5,0,0,519,267,0,786
53,6,0,0,58,0,0,58
53,10,0,0,11,0,0,11
53,17,0,0,20,0,0,20
53,19,0,0,170,79,0,249
53,21,0,0,261,0,0,261
53,22,0,0,274,0,0,274
53,23,0,0,56,0,0,56
53,24,0,0,292,0,0,292
53,26,0,0,201,0,0,201
53,27,93,0,259,45,0,397
53,28,429,0,41,0,0,470
53,29,0,0,564,58,0,622
53,31,128,0,88,0,0,216
53,32,339,0,21,0,0,360
53,40,0,0,9,0,0,9
53,43,0,0,146,0,0,146
53,49,121,121,200,269,0,711
53,50,0,17,62,0,0,79
53,51,162,0,344,0,0,506
53,52,115,1145,45,118,0,1423
53,53,931,4073,0,0,0,5004
53,54,566,1742,175,26,0,2509
53,55,1184,1051,72,601,0,2908
53,56,428,594,681,0,0,1703
53,57,45,0,282,0,0,327
53,58,306,1133,205,416,0,2060
53,59,665,0,1385,158,0,2208
53,60,284,0,0,0,0,284
53,61,1167,175,0,277,0,1619
53,62,111,58,0,0,0,169
53,63,263,0,71,74,0,408
53,64,255,0,63,0,0,318
53,65,116,0,0,0,0,116
53,66,451,0,0,0,0,451
53,67,0,0,55,0,0,55
53,68,121,0,519,109,0,749
53,69,0,0,101,0,0,101
53,74,0,0,201,0,168,369
53,75,0,0,118,35,0,153
53,76,93,38,77,0,0,208
53,77,58,0,0,0,0,58
53,78,0,0,72,0,0,72
53,79,41,0,111,0,0,152
53,80,44,0,533,0,0,577
53,82,0,0,58,53,0,111
53,84,0,0,89,0,0,89
53,87,33,0,0,0,0,33
53,88,0,0,254,0,0,254
53,97,0,0,35,0,0,35
53,104,21,0,0,0,0,21
53,106,0,0,219,0,0,219
53,107,0,0,58,0,0,58
53,237,201,0,70,58,0,329
53,239,304,39,406,0,0,749
53,240,159,0,86,0,0,245
53,241,53,0,0,0,0,53
53,250,179,0,975,0,0,1154
53,251,200,0,85,359,0,644
53,254,248,0,107,0,0,355
54,1,0,0,149,52,0,201
54,2,0,0,89,0,0,89
54,3,0,0,37,0,0,37
54,5,0,0,37,0,0,37
54,6,0,0,125,0,0,125
54,9,37,0,0,0,0,37
54,11,0,0,0,11,0,11
54,16,0,0,74,0,0,74
54,17,0,0,0,0,35,35
54,19,37,0,15,0,0,52
54,21,240,0,0,0,0,240
54,22,0,0,36,0,0,36
54,23,0,0,246,56,0,302
54,24,14,0,526,0,0,540
54,25,0,0,14,0,0,14
54,26,37,0,125,0,0,162
54,27,41,0,992,0,0,1033
54,28,26,46,64,0,0,136
54,29,0,0,195,0,0,195
54,30,0,0,44,26,0,70
54,31,0,0,28,0,0,28
54,34,0,0,59,14,0,73
54,35,0,0,723,0,0,723
54,36,262,0,132,0,0,394
54,37,18,0,0,0,0,18
54,38,0,0,38,0,0,38
54,39,0,0,87,0,0,87
54,43,171,0,0,0,0,171
54,44,0,0,152,0,0,152
54,49,267,0,35,124,0,426
54,50,74,0,0,0,0,74
54,51,184,130,210,0,0,524
54,52,61,0,132,0,0,193
54,53,1050,1137,220,201,0,2608
54,54,603,13222,436,74,0,14335
54,55,731,1131,0,37,0,1899
54,56,376,981,469,74,0,1900
54,57,0,0,101,0,0,101
54,58,37,849,524,0,0,1410
54,59,37,37,2334,0,0,2408
54,60,1187,0,284,284,0,1755
54,61,632,1724,69,415,0,2840
54,62,126,196,29,112,0,463
54,63,137,739,83,59,0,1018
54,64,300,0,261,308,0,869
54,65,116,0,374,0,0,490
54,66,52,0,105,0,0,157
54,67,66,0,60,161,0,287
54,68,74,0,276,0,0,350
54,69,110,0,87,211,0,408
54,70,118,0,37,78,0,233
54,74,0,0,85,0,0,85
54,75,0,0,153,0,0,153
54,76,114,0,0,38,0,152
54,77,14,0,177,0,0,191
54,78,88,0,173,0,0,261
54,79,313,0,0,14,0,327
54,80,37,0,0,0,0,37
54,81,56,0,97,56,0,209
54,82,37,0,0,0,0,37
54,83,37,0,117,0,0,154
54,85,0,0,35,0,0,35
54,87,0,0,142,0,0,142
54,88,391,0,0,0,0,391
54,90,14,0,0,0,0,14
54,91,0,0,0,37,0,37
54,92,0,0,18,0,0,18
54,93,40,0,14,0,0,54
54,94,0,0,35,0,0,35
54,95,37,0,75,0,0,112
54,96,0,0,59,66,0,125
54,97,35,0,0,0,0,35
54,100,294,0,37,0,0,331
54,101,37,0,0,0,0,37
54,102,0,0,97,0,0,97
54,103,10,0,18,0,0,28
54,105,50,0,242,0,0,292
54,107,37,0,0,0,0,37
54,236,112,0,122,0,0,234
54,237,51,0,51,0,0,102
54,238,172,0,0,0,0,172
54,239,146,0,157,0,0,303
54,240,37,0,0,0,0,37
54,250,23,0,118,396,0,537
54,251,0,0,618,0,0,618
54,252,11,0,137,0,0,148
54,254,14,0,0,0,0,14
55,3,0,0,168,0,0,168
55,4,0,0,0,72,0,72
55,5,0,0,72,0,0,72
55,6,0,0,168,0,0,168
55,9,0,0,168,0,0,168
55,11,0,0,45,0,0,45
55,19,161,0,0,712,0,873
55,21,690,111,0,949,0,1750
55,24,128,0,0,72,0,200
55,26,0,0,102,0,0,102
55,27,60,0,263,0,256,579
55,28,0,0,201,0,0,201
55,29,0,0,434,0,0,434
55,30,117,0,0,72,0,189
55,31,168,0,396,0,0,564
55,32,261,0,53,0,0,314
55,33,22,0,0,0,0,22
55,35,56,0,0,0,0,56
55,37,0,0,186,0,0,186
55,43,168,0,0,0,0,168
55,44,56,0,217,0,0,273
55,49,0,146,48,212,0,406
55,50,0,0,32,0,0,32
55,51,208,366,84,104,0,762
55,52,552,185,0,0,0,737
55,53,1137,1051,72,0,0,2260
55,54,673,1369,0,37,0,2079
55,55,0,957,0,0,0,957
55,56,1375,1158,239,36,0,2808
55,57,497,297,230,240,0,1264
55,58,336,0,387,0,0,723
55,59,422,0,561,138,0,1121
55,60,936,0,0,190,0,1126
55,61,761,498,0,72,0,1331
55,62,53,307,183,0,0,543
55,63,57,0,0,0,0,57
55,64,0,0,438,120,0,558
55,65,11,0,0,0,0,11
55,66,0,0,80,0,0,80
55,67,251,0,0,0,0,251
55,68,168,0,311,0,0,479
55,69,75,0,214,0,0,289
55,70,211,0,0,0,0,211
55,75,0,0,0,35,0,35
55,77,0,0,238,0,0,238
55,78,480,0,61,0,0,541
55,79,0,0,72,0,0,72
55,80,0,0,541,0,64,605
55,81,0,0,0,46,0,46
55,82,0,0,541,0,0,541
55,83,0,0,196,0,0,196
55,84,98,0,0,0,0,98
55,85,0,0,0,20,0,20
55,86,20,0,0,0,0,20
55,87,0,0,436,0,0,436
55,88,0,0,125,0,0,125
55,91,0,0,192,0,0,192
55,93,0,0,28,0,0,28
55,94,168,0,35,0,0,203
55,95,102,0,0,0,0,102
55,96,66,0,0,0,0,66
55,100,126,0,126,0,0,252
55,102,49,0,128,0,0,177
55,104,21,0,0,0,0,21
55,237,0,0,217,0,0,217
55,239,0,0,514,0,0,514
55,250,87,0,0,0,0,87
55,254,0,0,0,1312,0,1312
56,1,0,0,148,0,0,148
56,2,0,381,0,0,0,381
56,4,0,0,0,453,0,453
56,5,1250,0,148,107,0,1505
56,6,0,0,542,0,0,542
56,7,0,0,440,0,0,440
56,9,92,0,107,0,0,199
56,14,296,0,0,0,0,296
56,17,0,0,107,0,0,107
56,18,169,0,0,167,0,336
56,19,38,226,0,128,0,392
56,20,0,0,154,0,0,154
56,21,420,121,0,0,0,541
56,22,690,402,0,63,0,1155
56,23,63,0,199,0,0,262
56,24,0,0,60,0,0,60
56,26,0,0,161,0,0,161
56,27,254,0,82,676,0,1012
56,28,64,0,293,0,0,357
56,29,83,0,461,0,0,544
56,30,272,0,0,0,0,272
56,31,119,0,572,0,0,691
56,32,76,0,338,0,0,414
56,33,0,0,17,6,0,23
56,34,68,0,57,0,0,125
56,36,0,0,398,0,0,398
56,37,18,0,0,0,0,18
56,43,83,0,0,0,0,83
56,45,148,0,240,0,0,388
56,48,0,0,0,0,359,359
56,49,650,1817,35,99,0,2601
56,50,221,0,0,99,0,320
56,51,277,493,0,248,0,1018
56,52,521,0,228,268,0,1017
56,53,536,594,652,0,0,1782
56,54,89,1049,435,74,0,1647
56,55,689,1319,161,596,0,2765
56,56,1889,8464,0,0,0,10353
56,57,441,2691,212,2358,0,5702
56,58,0,408,454,381,0,1243
56,59,0,0,413,107,0,520
56,60,0,0,338,0,0,338
56,61,528,152,31,0,0,711
56,62,238,674,0,0,0,912
56,63,51,0,6,107,0,164
56,64,268,0,131,0,0,399
56,66,116,0,0,0,0,116
56,68,255,0,90,0,0,345
56,69,0,0,38,0,0,38
56,70,84,0,0,0,0,84
56,74,0,0,496,0,0,496
56,75,56,0,38,276,81,451
56,76,283,104,161,143,0,691
56,77,0,0,38,0,215,253
56,79,0,0,123,0,0,123
56,80,0,0,178,0,0,178
56,82,83,0,89,148,0,320
56,83,0,0,231,0,0,231
56,84,0,0,51,0,0,51
56,86,0,0,45,32,0,77
56,88,0,0,101,0,0,101
56,89,48,0,0,0,0,48
56,91,35,0,173,0,0,208
56,92,0,0,148,0,0,148
56,93,381,0,0,0,0,381
56,94,35,0,0,0,0,35
56,95,0,0,0,75,0,75
56,100,0,0,126,0,0,126
56,102,0,0,83,0,0,83
56,103,10,0,10,0,0,20
56,104,0,0,53,0,0,53
56,107,0,0,99,0,0,99
56,237,111,0,0,0,0,111
56,238,0,0,78,0,0,78
56,239,0,0,536,0,0,536
56,240,761,0,0,0,0,761
56,241,61,0,0,0,0,61
56,251,200,0,200,0,0,400
57,1,0,0,425,0,0,425
57,2,0,0,171,0,0,171
57,3,165,0,199,240,0,604
57,4,0,0,248,447,0,695
57,5,173,0,521,155,0,849
57,7,155,0,0,0,0,155
57,9,0,0,30,0,0,30
57,14,0,0,37,0,0,37
57,16,0,0,126,0,0,126
57,19,0,0,130,0,0,130
57,20,254,0,1037,0,0,1291
57,21,119,0,0,0,0,119
57,22,1018,197,0,0,0,1215
57,23,0,29,0,155,0,184
57,24,183,0,0,88,76,347
57,25,0,481,717,0,0,1198
57,26,493,340,89,0,0,922
57,27,641,3005,0,183,0,3829
57,28,26,1470,210,697,0,2403
57,29,138,0,419,0,0,557
57,30,64,0,119,64,0,247
57,31,594,0,823,0,0,1417
57,32,91,213,98,0,0,402
57,34,0,0,0,39,0,39
57,35,120,0,75,0,0,195
57,36,510,0,619,0,0,1129
57,37,0,0,0,0,225,225
57,38,0,0,62,0,0,62
57,40,0,0,46,0,0,46
57,43,0,0,355,0,0,355
57,44,0,0,0,72,0,72
57,45,75,0,156,0,0,231
57,48,0,0,157,0,0,157
57,49,904,608,0,80,0,1592
57,51,75,0,318,0,0,393
57,52,276,61,435,0,0,772
57,53,45,0,75,0,0,120
57,54,0,0,0,44,0,44
57,55,794,75,183,168,256,1476
57,56,441,2620,212,1977,0,5250
57,57,3830,14799,338,530,0,19497
57,58,0,63,324,0,0,387
57,59,41,0,313,0,0,354
57,60,0,0,102,205,0,307
57,61,0,0,852,309,0,1161
57,62,762,1280,169,0,78,2289
57,63,11,0,0,0,0,11
57,65,347,0,126,282,0,755
57,66,58,0,143,0,0,201
57,68,479,0,63,0,0,542
57,69,348,0,87,0,0,435
57,74,872,1628,215,239,284,3238
57,75,615,952,38,112,0,1717
57,76,410,644,0,0,0,1054
57,77,497,0,0,0,0,497
57,78,50,102,182,248,0,582
57,79,330,387,505,193,0,1415
57,80,0,0,263,0,0,263
57,81,201,0,63,62,0,326
57,82,230,0,218,0,0,448
57,83,0,0,96,0,0,96
57,84,90,0,284,311,74,759
57,85,0,0,17,0,0,17
57,86,0,0,45,0,0,45
57,87,0,0,256,97,0,353
57,88,276,0,0,253,0,529
57,89,96,0,0,0,0,96
57,91,0,0,156,0,0,156
57,93,155,0,0,0,0,155
57,95,102,0,0,0,0,102
57,96,155,0,155,0,0,310
57,99,58,0,96,0,0,154
57,103,10,0,0,0,0,10
57,104,0,0,9,0,0,9
57,107,0,0,293,99,0,392
57,108,0,0,56,0,0,56
57,236,0,0,155,0,0,155
57,237,0,0,51,0,0,51
57,238,0,0,270,213,0,483
57,239,110,0,61,0,0,171
57,240,621,0,131,0,0,752
57,241,53,0,227,0,0,280
57,250,0,0,359,0,0,359
57,251,400,0,0,0,0,400
57,252,62,0,0,0,0,62
57,254,0,0,155,0,0,155
58,1,0,0,500,0,0,500
58,2,100,0,615,0,0,715
58,3,0,0,200,0,0,200
58,4,0,0,455,0,0,455
58,5,0,0,100,0,0,100
58,7,37,0,0,0,0,37
58,9,0,0,92,0,0,92
58,18,100,0,0,0,0,100
58,19,674,0,0,100,0,774
58,21,100,0,0,0,0,100
58,22,77,0,178,0,0,255
58,23,309,0,0,0,0,309
58,24,0,0,97,0,0,97
58,25,0,0,379,0,0,379
58,26,0,0,127,0,0,127
58,27,0,0,46,0,0,46
58,28,22,0,53,0,0,75
58,29,100,0,0,0,0,100
58,30,0,0,100,0,0,100
58,31,0,0,100,0,0,100
58,33,15,0,0,0,0,15
58,36,0,0,100,0,0,100
58,41,0,0,63,0,0,63
58,43,0,0,297,0,0,297
58,44,0,0,671,0,0,671
58,47,97,0,0,0,0,97
58,49,50,0,226,108,0,384
58,51,352,0,201,0,0,553
58,52,0,306,229,0,0,535
58,53,306,1080,205,416,0,2007
58,54,0,945,524,0,0,1469
58,55,336,0,249,0,0,585
58,56,0,556,612,381,0,1549
58,57,127,63,197,0,0,387
58,58,800,5769,0,0,0,6569
58,59,885,1545,1226,0,0,3656
58,60,200,97,701,468,0,1466
58,61,664,1989,1032,590,0,4275
58,62,197,0,29,0,0,226
58,63,0,0,19,0,0,19
58,64,240,0,0,100,0,340
58,65,116,0,0,0,0,116
58,66,100,0,0,0,0,100
58,68,97,0,127,0,0,224
58,70,184,0,0,0,0,184
58,74,100,0,695,0,0,795
58,75,126,0,0,0,0,126
58,77,0,0,331,0,0,331
58,78,10,0,88,0,0,98
58,79,0,0,406,0,0,406
58,80,0,0,100,0,0,100
58,82,127,0,200,0,0,327
58,84,0,0,306,0,0,306
58,86,18,0,0,0,0,18
58,90,0,0,100,0,0,100
58,94,100,0,0,0,0,100
58,96,0,0,284,0,0,284
58,101,508,0,0,0,0,508
58,104,0,0,21,0,0,21
58,106,93,0,0,0,0,93
58,238,100,0,0,0,0,100
58,239,41,0,0,0,0,41
58,240,97,0,0,0,0,97
58,241,0,0,109,0,0,109
58,250,658,783,0,0,145,1586
58,252,247,200,331,0,0,778
59,1,0,0,317,393,0,710
59,2,267,0,1213,0,0,1480
59,3,0,0,789,0,0,789
59,5,0,0,257,0,0,257
59,7,234,0,1158,0,0,1392
59,9,0,0,1213,0,0,1213
59,19,146,0,0,0,0,146
59,20,0,0,0,151,0,151
59,21,551,0,0,0,0,551
59,22,0,0,882,0,0,882
59,23,0,0,1173,0,0,1173
59,24,0,0,523,0,0,523
59,27,165,0,0,46,0,211
59,28,0,0,419,0,0,419
59,29,0,0,660,0,0,660
59,30,0,0,105,0,0,105
59,31,0,0,936,0,0,936
59,32,0,0,647,0,0,647
59,36,0,0,607,0,0,607
59,43,0,0,393,0,0,393
59,45,0,0,607,0,0,607
59,48,0,0,904,0,0,904
59,49,0,0,1361,0,0,1361
59,50,0,0,134,0,0,134
59,51,208,0,0,0,0,208
59,53,58,0,2060,158,0,2276
59,54,37,37,927,0,0,1001
59,55,422,0,729,0,0,1151
59,56,0,0,255,107,0,362
59,57,0,0,313,0,0,313
59,58,885,1241,1265,0,0,3391
59,59,3207,38992,313,2186,0,44698
59,60,4092,2750,969,788,823,9422
59,61,1078,3343,188,544,0,5153
59,63,11,0,0,0,0,11
59,64,402,0,0,0,570,972
59,66,533,0,0,0,0,533
59,68,710,0,0,0,0,710
59,70,0,0,88,0,0,88
59,77,0,0,886,0,0,886
59,78,0,0,710,0,0,710
59,79,41,0,775,0,0,816
59,82,0,0,607,0,0,607
59,83,0,0,1597,0,0,1597
59,84,24,0,0,0,0,24
59,85,0,0,267,0,0,267
59,87,0,0,1606,0,0,1606
59,88,0,0,301,0,0,301
59,89,127,0,0,57,0,184
59,93,0,0,588,0,0,588
59,94,0,0,98,0,0,98
59,97,245,0,0,0,0,245
59,102,0,0,49,0,0,49
59,104,0,0,21,0,0,21
59,105,0,0,440,0,0,440
59,237,306,0,0,0,0,306
59,238,298,0,347,0,0,645
59,239,0,0,245,0,0,245
59,240,0,0,64,0,0,64
59,241,0,0,26,0,0,26
59,250,592,771,0,854,0,2217
59,251,0,0,950,291,0,1241
59,252,237,0,743,0,0,980
59,254,0,0,248,0,0,248
60,1,0,0,977,0,0,977
60,2,0,0,386,0,0,386
60,4,214,0,0,0,0,214
60,5,640,0,0,69,0,709
60,7,0,0,102,0,0,102
60,17,0,0,20,0,0,20
60,20,323,0,0,0,0,323
60,21,0,0,83,0,0,83
60,22,69,0,0,0,0,69
60,24,265,0,379,0,0,644
60,25,0,0,201,370,0,571
60,27,102,0,0,0,0,102
60,28,102,0,26,0,0,128
60,29,240,0,190,0,0,430
60,31,0,0,284,0,0,284
60,32,0,0,21,327,0,348
60,35,0,0,801,0,0,801
60,40,102,0,0,0,0,102
60,43,0,0,696,102,0,798
60,44,0,0,102,0,0,102
60,45,69,0,0,0,0,69
60,49,0,0,173,0,0,173
60,51,252,0,0,0,0,252
60,53,284,0,0,0,0,284
60,54,670,0,592,102,0,1364
60,55,833,0,190,0,0,1023
60,56,381,0,190,0,0,571
60,57,0,0,102,205,0,307
60,58,300,97,565,100,0,1062
60,59,5085,2750,660,788,823,10106
60,60,6928,4421,862,410,0,12621
60,61,1269,933,59,0,0,2261
60,62,194,0,0,0,0,194
60,63,23,0,0,0,0,23
60,64,1116,547,103,0,0,1766
60,65,340,0,0,118,0,458
60,66,788,102,309,0,0,1199
60,67,137,0,0,0,0,137
60,68,0,0,0,75,0,75
60,69,0,0,129,0,0,129
60,70,0,0,91,0,0,91
60,74,0,0,472,0,0,472
60,75,205,0,0,0,0,205
60,78,69,0,0,0,0,69
60,79,41,0,284,0,0,325
60,81,0,0,0,102,148,250
60,82,205,0,0,0,0,205
60,87,67,0,0,0,0,67
60,88,0,0,414,138,0,552
60,94,0,0,0,102,0,102
60,100,0,0,102,0,0,102
60,102,102,0,0,0,0,102
60,105,50,0,0,0,0,50
60,236,102,0,0,0,0,102
60,238,270,0,0,0,0,270
60,239,0,0,67,0,0,67
60,240,0,0,221,0,0,221
60,241,118,0,0,0,0,118
60,250,102,0,0,0,0,102
60,251,316,0,0,0,0,316
61,1,415,0,586,0,0,1001
61,3,724,0,0,0,0,724
61,5,72,0,1429,0,0,1501
61,6,204,0,966,0,0,1170
61,7,0,0,312,0,0,312
61,11,0,0,22,0,0,22
61,19,0,0,552,0,0,552
61,21,165,0,0,321,0,486
61,22,0,67,96,0,0,163
61,24,181,0,827,0,0,1008
61,27,282,0,581,0,0,863
61,29,59,0,412,0,0,471
61,31,0,0,415,0,0,415
61,32,0,0,152,0,0,152
61,33,15,0,0,0,0,15
61,36,804,0,204,0,0,1008
61,41,0,0,121,0,0,121
61,45,0,0,83,0,0,83
61,49,0,0,345,0,0,345
61,50,300,0,0,0,0,300
61,51,274,0,0,0,0,274
61,52,0,0,415,0,0,415
61,53,1194,175,0,277,0,1646
61,54,952,1953,69,415,0,3389
61,55,0,485,138,72,0,695
61,56,1142,152,0,0,0,1294
61,57,0,0,975,309,0,1284
61,58,917,2293,1349,590,0,5149
61,59,1263,3161,188,544,0,5156
61,60,854,933,0,0,0,1787
61,61,0,8196,0,0,0,8196
61,62,217,0,0,0,0,217
61,63,11,0,0,0,0,11
61,64,1141,0,488,120,0,1749
61,65,116,0,121,0,0,237
61,66,619,0,0,0,0,619
61,68,304,0,0,30,0,334
61,74,513,0,562,0,0,1075
61,76,38,0,42,0,0,80
61,77,204,0,0,0,0,204
61,78,0,0,88,0,0,88
61,79,0,0,246,0,298,544
61,80,88,0,0,0,0,88
61,82,1219,0,33,0,0,1252
61,83,69,0,0,0,0,69
61,87,33,0,100,0,0,133
61,88,0,0,0,253,0,253
61,90,123,0,123,0,0,246
61,93,466,0,0,0,0,466
61,97,98,0,0,0,0,98
61,102,56,0,0,0,0,56
61,105,50,0,0,0,0,50
61,237,490,0,51,51,0,592
61,238,898,0,0,0,0,898
61,250,254,0,240,254,0,748
61,254,109,0,0,0,0,109
62,1,49,0,56,0,0,105
62,2,26,0,0,0,0,26
62,3,0,0,27,0,0,27
62,5,81,0,29,0,0,110
62,7,26,0,29,0,0,55
62,17,0,0,26,0,0,26
62,20,0,0,0,254,0,254
62,21,27,0,0,0,0,27
62,24,0,0,241,26,0,267
62,25,0,0,0,26,0,26
62,26,27,0,0,0,0,27
62,27,283,381,169,0,0,833
62,28,0,0,41,0,0,41
62,29,0,0,29,53,0,82
62,30,91,0,27,0,0,118
62,32,112,77,0,26,0,215
62,34,0,0,32,0,56,88
62,35,1623,0,292,0,0,1915
62,36,1054,0,0,0,0,1054
62,37,65,0,0,0,0,65
62,38,18,0,0,0,0,18
62,40,27,0,0,0,0,27
62,44,0,0,174,0,0,174
62,45,27,0,0,0,0,27
62,47,0,0,352,0,0,352
62,49,258,53,0,0,0,311
62,50,74,0,80,0,0,154
62,51,89,0,0,0,0,89
62,52,0,0,27,0,0,27
62,53,111,0,63,0,0,174
62,54,257,0,29,112,0,398
62,55,53,334,366,0,0,753
62,56,107,674,0,0,0,781
62,57,893,1333,0,0,78,2304
62,58,97,0,29,0,0,126
62,60,294,0,0,0,0,294
62,61,217,0,0,0,0,217
62,62,714,2078,0,0,0,2792
62,63,0,11,0,0,0,11
62,64,53,0,0,162,0,215
62,65,0,0,0,109,0,109
62,66,53,0,506,0,0,559
62,67,80,80,0,80,0,240
62,68,0,0,0,197,0,197
62,69,213,80,361,0,39,693
62,70,209,0,0,0,0,209
62,74,223,98,55,26,0,402
62,75,236,328,29,0,164,757
62,76,150,296,29,0,81,556
62,77,27,0,0,27,0,54
62,78,102,75,0,72,0,249
62,79,231,41,0,266,0,538
62,81,27,0,47,0,0,74
62,82,31,0,53,0,0,84
62,83,64,0,56,0,0,120
62,84,77,0,0,0,0,77
62,85,11,0,17,0,0,28
62,87,67,0,24,0,0,91
62,92,527,0,27,27,0,581
62,94,0,0,27,0,0,27
62,97,26,0,0,0,0,26
62,100,11,0,0,0,0,11
62,102,49,0,0,0,0,49
62,103,11,0,0,0,0,11
62,105,0,0,85,0,0,85
62,107,26,0,0,0,0,26
62,236,41,0,0,0,0,41
62,238,151,0,0,0,0,151
62,239,27,0,0,0,0,27
62,241,0,0,58,0,0,58
62,254,0,0,26,27,0,53
63,1,0,0,11,0,0,11
63,5,62,0,176,0,0,238
63,10,0,0,8,0,0,8
63,12,0,0,19,6,0,25
63,23,11,0,0,0,0,11
63,27,40,0,232,6,0,278
63,28,0,0,12,0,0,12
63,29,35,0,13,0,0,48
63,30,483,0,0,0,0,483
63,31,23,0,0,32,0,55
63,32,23,0,43,11,0,77
63,35,0,0,376,0,0,376
63,38,0,0,32,0,0,32
63,44,11,0,0,0,0,11
63,47,11,0,0,0,0,11
63,49,85,0,54,0,0,139
63,53,263,0,113,74,0,450
63,54,131,832,1061,23,0,2047
63,55,57,0,0,0,0,57
63,56,51,0,6,107,0,164
63,57,11,0,0,0,0,11
63,58,0,0,19,0,0,19
63,59,11,0,0,0,0,11
63,60,11,0,0,0,0,11
63,61,11,0,0,59,0,70
63,62,169,11,0,0,0,180
63,63,92,295,0,0,0,387
63,64,669,164,6,234,0,1073
63,65,334,109,0,23,101,567
63,66,102,656,59,11,0,828
63,67,34,216,0,0,0,250
63,68,127,0,132,0,33,292
63,69,187,0,0,24,0,211
63,70,179,0,12,0,0,191
63,75,23,0,0,0,0,23
63,77,26,0,518,0,0,544
63,79,23,0,0,0,0,23
63,80,11,0,196,0,0,207
63,81,50,0,0,0,0,50
63,82,11,0,0,0,0,11
63,83,73,0,0,0,0,73
63,84,0,0,13,12,0,25
63,86,64,0,0,0,0,64
63,87,6,0,0,0,0,6
63,91,0,0,0,10,0,10
63,92,0,0,4,0,0,4
63,93,23,0,0,0,0,23
63,94,73,0,0,0,0,73
63,95,6,0,0,0,0,6
63,96,76,0,73,0,0,149
63,104,21,0,0,0,0,21
63,237,109,0,0,0,0,109
63,238,0,0,12,0,0,12
63,239,11,0,0,0,0,11
63,240,11,0,0,0,0,11
63,251,0,0,0,219,0,219
64,1,0,0,95,0,0,95
64,2,274,0,0,0,0,274
64,3,0,0,189,0,0,189
64,4,0,0,193,0,0,193
64,5,120,0,0,0,0,120
64,6,120,0,0,120,0,240
64,7,0,0,120,0,0,120
64,8,0,0,167,0,0,167
64,12,156,0,0,0,0,156
64,17,95,0,0,0,0,95
64,21,128,0,0,0,0,128
64,23,215,0,344,120,0,679
64,24,369,0,1709,0,0,2078
64,26,309,0,0,0,0,309
64,27,119,0,65,0,0,184
64,28,55,0,41,120,0,216
64,29,297,0,0,0,0,297
64,30,274,0,154,64,0,492
64,31,654,0,599,0,0,1253
64,34,240,0,42,0,0,282
64,37,120,0,0,0,0,120
64,40,37,0,18,0,0,55
64,43,0,0,106,0,0,106
64,45,216,0,0,120,0,336
64,47,107,0,0,0,0,107
64,49,322,0,0,0,0,322
64,50,0,0,38,0,0,38
64,52,0,0,131,0,0,131
64,53,305,0,63,0,0,368
64,54,420,0,751,428,0,1599
64,55,0,0,438,248,0,686
64,56,375,0,131,0,0,506
64,58,240,0,0,0,0,240
64,59,563,0,0,0,570,1133
64,60,1330,547,103,0,0,1980
64,61,1250,0,207,120,0,1577
64,62,177,0,0,0,0,177
64,63,669,164,6,229,0,1068
64,64,2723,19778,0,547,605,23653
64,65,2239,1493,0,950,168,4850
64,66,2496,1681,189,216,0,4582
64,67,874,284,0,48,0,1206
64,68,877,0,0,0,572,1449
64,69,194,0,0,120,321,635
64,70,154,154,0,0,102,410
64,74,120,0,0,0,0,120
64,75,35,0,0,0,0,35
64,76,0,0,0,6,0,6
64,77,149,0,0,0,0,149
64,78,88,0,0,7,0,95
64,79,453,0,0,189,0,642
64,80,0,0,48,0,0,48
64,81,0,0,261,172,174,607
64,82,151,0,0,256,276,683
64,83,0,0,200,0,0,200
64,86,36,0,0,0,0,36
64,89,0,0,0,145,0,145
64,92,0,0,0,120,0,120
64,96,137,0,0,0,0,137
64,99,95,0,0,0,0,95
64,100,120,0,0,0,0,120
64,101,102,0,321,0,0,423
64,104,21,0,21,0,0,42
64,106,240,0,0,0,0,240
64,107,99,0,0,0,0,99
64,238,0,0,0,120,0,120
64,240,59,0,0,0,0,59
64,251,200,0,0,0,0,200
65,1,116,0,244,0,0,360
65,2,0,0,104,0,0,104
65,4,214,0,0,0,0,214
65,8,224,0,0,0,0,224
65,9,0,0,92,0,0,92
65,15,116,0,0,0,0,116
65,21,917,0,0,72,0,989
65,22,116,0,0,0,0,116
65,24,458,0,0,0,0,458
65,25,0,0,176,0,0,176
65,27,386,0,0,0,0,386
65,28,467,0,0,0,0,467
65,29,116,0,0,0,0,116
65,30,0,0,126,0,0,126
65,31,0,0,121,116,0,237
65,32,802,0,0,0,0,802
65,33,37,0,0,0,0,37
65,35,231,0,116,0,0,347
65,39,111,0,135,0,0,246
65,41,109,0,0,0,0,109
65,44,58,0,0,0,0,58
65,48,247,0,0,0,0,247
65,49,116,0,80,0,0,196
65,52,0,0,121,0,0,121
65,53,116,0,0,0,0,116
65,54,229,0,360,0,0,589
65,55,11,0,249,0,0,260
65,57,347,0,247,282,0,876
65,58,116,0,0,0,0,116
65,60,340,0,0,118,0,458
65,61,116,0,121,0,0,237
65,62,0,0,0,109,0,109
65,63,368,109,0,23,101,601
65,64,1500,1493,0,1274,168,4435
65,65,4212,8467,0,439,335,13453
65,66,1391,573,157,1342,0,3463
65,67,0,1329,186,568,0,2083
65,68,1654,316,0,225,0,2195
65,69,902,451,0,80,0,1433
65,70,610,646,0,84,0,1340
65,74,231,0,0,0,0,231
65,76,77,0,31,0,0,108
65,77,116,0,0,0,0,116
65,78,116,0,0,0,0,116
65,79,503,0,317,111,0,931
65,80,116,0,0,0,0,116
65,81,294,0,50,396,0,740
65,83,220,0,75,138,0,433
65,84,227,0,0,116,0,343
65,85,24,0,0,0,0,24
65,87,111,0,0,0,0,111
65,88,139,0,0,0,0,139
65,93,227,0,0,0,0,227
65,97,76,0,0,370,0,446
65,100,0,0,0,229,0,229
65,102,49,0,0,0,0,49
65,108,224,0,0,0,0,224
65,239,231,0,0,0,0,231
66,1,0,0,103,0,0,103
66,2,142,0,0,0,0,142
66,3,0,0,118,0,0,118
66,4,0,0,101,0,0,101
66,5,116,0,0,0,0,116
66,6,58,0,0,0,0,58
66,7,0,0,0,58,0,58
66,17,0,0,0,101,0,101
66,23,58,0,0,0,0,58
66,26,0,0,215,0,0,215
66,27,35,0,63,0,0,98
66,28,0,0,298,0,0,298
66,29,143,0,0,0,0,143
66,30,129,0,0,0,0,129
66,31,48,0,416,0,0,464
66,32,58,0,0,0,0,58
66,34,23,0,0,0,0,23
66,36,262,0,0,0,0,262
66,49,48,0,80,0,0,128
66,50,394,0,0,70,0,464
66,51,58,0,0,0,0,58
66,53,95,0,0,0,0,95
66,54,0,0,105,0,0,105
66,55,21,0,0,0,0,21
66,56,110,0,0,0,0,110
66,57,58,0,0,0,0,58
66,58,100,0,0,0,0,100
66,59,533,0,0,0,0,533
66,60,2485,102,309,0,0,2896
66,61,204,0,0,0,0,204
66,62,53,0,0,0,0,53
66,63,53,12,59,11,0,135
66,64,2395,1216,402,438,0,4451
66,65,1404,682,38,1292,0,3416
66,66,507,2615,0,328,125,3575
66,67,590,0,0,0,0,590
66,68,407,58,65,0,0,530
66,69,58,0,0,58,0,116
66,70,272,445,154,165,0,1036
66,75,35,0,61,35,0,131
66,76,344,0,0,0,0,344
66,77,137,0,0,0,0,137
66,78,135,0,0,98,0,233
66,79,0,0,52,0,0,52
66,80,116,0,0,0,84,200
66,81,372,0,205,164,0,741
66,82,116,0,63,58,0,237
66,83,58,0,0,0,0,58
66,84,0,0,82,0,0,82
66,85,35,0,0,0,0,35
66,88,58,0,0,0,0,58
66,90,166,0,0,0,0,166
66,92,47,0,0,0,0,47
66,95,0,0,465,0,0,465
66,99,96,0,0,0,0,96
66,101,0,0,65,0,0,65
66,103,10,0,0,0,0,10
66,106,101,0,0,0,0,101
66,107,35,0,0,0,0,35
66,236,41,0,0,58,0,99
66,237,51,0,26,0,0,77
66,239,0,0,119,0,0,119
66,241,204,0,0,0,0,204
66,250,216,0,0,0,0,216
66,252,0,0,126,0,0,126
67,1,204,0,60,0,0,264
67,2,0,0,88,0,0,88
67,3,0,0,80,80,0,160
67,4,0,0,583,0,0,583
67,5,0,0,53,88,0,141
67,6,80,0,0,0,0,80
67,7,55,0,0,0,0,55
67,19,0,0,91,0,0,91
67,25,0,0,176,0,0,176
67,27,0,0,88,0,0,88
67,28,80,0,88,0,0,168
67,29,55,0,0,0,0,55
67,31,80,0,140,0,0,220
67,32,0,0,91,0,0,91
67,36,0,0,268,0,0,268
67,37,80,0,0,0,0,80
67,40,0,0,28,0,0,28
67,43,0,0,176,0,0,176
67,47,55,0,0,0,0,55
67,49,83,0,0,0,0,83
67,51,104,0,0,0,0,104
67,53,0,0,55,26,0,81
67,54,190,0,60,0,0,250
67,55,251,0,0,0,0,251
67,59,0,0,88,0,0,88
67,60,137,0,0,0,0,137
67,62,0,80,0,80,0,160
67,63,46,216,0,0,0,262
67,64,874,201,91,48,0,1214
67,65,86,1329,186,402,0,2003
67,66,590,0,0,0,0,590
67,67,745,3171,0,0,0,3916
67,68,650,1082,91,281,0,2104
67,69,460,957,0,0,0,1417
67,70,446,0,156,0,0,602
67,74,98,0,0,0,0,98
67,75,71,56,0,0,0,127
67,76,297,339,60,0,0,696
67,78,80,0,110,55,0,245
67,79,0,0,0,189,0,189
67,81,103,0,0,338,0,441
67,82,0,0,176,0,80,256
67,83,193,0,0,0,0,193
67,84,51,0,0,0,0,51
67,85,0,0,0,17,0,17
67,86,18,0,0,0,0,18
67,87,284,0,0,0,0,284
67,88,0,0,150,0,0,150
67,91,0,0,80,0,0,80
67,93,0,0,88,0,0,88
67,94,80,0,0,0,0,80
67,95,200,0,0,0,0,200
67,98,0,0,8,0,0,8
67,104,42,0,0,0,0,42
67,107,0,0,0,99,0,99
67,236,0,0,122,0,0,122
67,237,33,0,0,0,0,33
68,1,0,0,396,0,0,396
68,2,0,0,332,0,0,332
68,3,0,0,186,0,0,186
68,4,618,0,215,0,0,833
68,5,0,0,97,0,0,97
68,6,0,0,121,0,0,121
68,7,150,0,100,746,0,996
68,10,0,0,12,0,0,12
68,11,0,0,24,0,0,24
68,14,333,0,0,0,0,333
68,18,124,0,0,0,0,124
68,22,134,0,0,0,0,134
68,23,178,0,61,0,0,239
68,24,0,0,150,0,263,413
68,25,0,0,213,208,0,421
68,26,383,0,97,0,0,480
68,27,121,0,506,47,0,674
68,28,76,0,847,182,0,1105
68,29,468,0,518,90,0,1076
68,30,193,0,206,319,0,718
68,31,250,0,1290,150,0,1690
68,32,143,0,253,145,0,541
68,33,14,0,6,0,0,20
68,34,39,0,42,59,0,140
68,35,0,0,33,0,0,33
68,36,121,0,0,131,0,252
68,37,0,0,72,0,0,72
68,38,35,0,0,0,0,35
68,40,0,0,18,0,0,18
68,41,0,0,140,0,0,140
68,42,0,0,23,0,0,23
68,43,121,0,176,98,0,395
68,44,302,0,0,0,0,302
68,48,121,0,0,0,0,121
68,51,174,0,0,0,0,174
68,53,426,0,519,58,0,1003
68,54,74,0,291,0,0,365
68,55,347,0,97,0,0,444
68,56,461,0,90,0,0,551
68,57,443,0,63,21,0,527
68,58,97,0,127,0,0,224
68,60,1031,0,0,75,0,1106
68,62,0,0,168,107,0,275
68,63,127,0,132,0,33,292
68,64,999,0,0,0,572,1571
68,65,1504,316,0,225,0,2045
68,66,349,58,65,58,0,530
68,67,705,1052,0,361,0,2118
68,68,1516,45201,488,2292,0,49497
68,69,1073,2342,0,0,216,3631
68,70,1779,836,858,183,130,3786
68,74,613,0,427,160,142,1342
68,75,310,0,184,188,0,682
68,76,514,443,277,564,0,1798
68,77,300,0,323,1163,0,1786
68,78,586,0,221,0,518,1325
68,79,320,0,157,63,0,540
68,80,137,210,196,545,326,1414
68,81,846,1210,193,802,355,3406
68,82,711,232,76,90,130,1239
68,83,187,0,94,37,276,594
68,84,221,0,198,51,0,470
68,85,47,0,44,24,0,115
68,86,18,0,70,0,0,88
68,87,240,0,230,152,0,622
68,88,496,0,110,138,0,744
68,89,149,0,0,150,0,299
68,90,62,0,287,276,0,625
68,91,9,0,9,0,0,18
68,93,191,0,117,0,0,308
68,94,150,0,524,0,0,674
68,95,75,0,0,102,0,177
68,96,0,0,0,66,0,66
68,97,35,0,0,35,0,70
68,98,7,0,0,7,0,14
68,99,0,184,0,0,0,184
68,100,183,0,145,150,0,478
68,101,0,0,484,0,0,484
68,102,105,0,114,0,0,219
68,103,35,0,0,0,0,35
68,104,42,0,0,159,0,201
68,105,50,0,0,0,0,50
68,106,290,0,0,0,0,290
68,107,342,0,0,0,0,342
68,237,0,0,0,26,0,26
68,251,256,0,279,0,0,535
68,252,62,0,0,0,0,62
68,254,0,0,294,0,0,294
69,2,80,0,0,0,0,80
69,3,0,0,253,80,0,333
69,4,0,0,233,560,0,793
69,5,80,0,248,0,0,328
69,6,0,0,79,0,0,79
69,7,0,0,75,0,0,75
69,17,20,0,0,0,0,20
69,18,0,0,87,0,0,87
69,19,201,0,0,35,0,236
69,20,0,0,319,0,0,319
69,21,0,0,72,0,0,72
69,23,63,0,0,0,0,63
69,24,103,0,163,0,0,266
69,25,0,0,174,0,0,174
69,27,80,0,0,0,0,80
69,28,80,0,24,152,0,256
69,30,64,0,144,0,0,208
69,31,0,0,53,0,186,239
69,32,80,0,334,93,0,507
69,34,39,0,38,0,0,77
69,35,73,0,87,0,0,160
69,36,823,0,0,131,0,954
69,39,73,0,0,0,0,73
69,41,0,0,121,0,0,121
69,43,0,0,167,0,0,167
69,45,172,0,0,0,0,172
69,49,248,0,0,153,0,401
69,51,197,0,0,0,0,197
69,52,227,0,279,0,0,506
69,53,0,0,101,0,0,101
69,54,110,0,87,80,0,277
69,56,0,0,38,0,0,38
69,57,350,0,87,0,0,437
69,60,118,0,129,0,0,247
69,62,177,80,361,0,39,657
69,63,187,0,0,24,0,211
69,64,0,0,0,120,321,441
69,65,1000,531,40,80,0,1651
69,66,0,0,0,116,0,116
69,67,380,877,0,0,0,1257
69,68,1572,1775,0,80,216,3643
69,69,2524,10164,0,0,287,12975
69,70,275,794,0,160,0,1229
69,74,39,0,307,0,0,346
69,75,35,0,174,0,0,209
69,76,80,0,0,73,0,153
69,79,41,0,45,0,0,86
69,80,106,0,79,80,0,265
69,81,623,152,226,336,0,1337
69,82,115,0,0,0,102,217
69,83,187,0,129,0,0,316
69,84,73,0,0,0,0,73
69,85,0,0,19,41,0,60
69,86,18,0,22,0,0,40
69,87,138,0,26,0,0,164
69,88,138,0,0,0,0,138
69,94,0,0,0,127,0,127
69,96,0,0,0,0,95,95
69,97,154,0,0,35,51,240
69,99,131,0,0,0,0,131
69,100,80,0,0,0,0,80
69,101,820,0,0,0,0,820
69,102,56,0,0,0,0,56
69,104,0,0,22,0,0,22
69,105,50,0,0,0,0,50
69,107,118,0,0,0,0,118
69,237,26,0,0,0,0,26
69,239,0,0,0,35,0,35
69,252,85,0,0,0,0,85
70,2,0,0,160,0,0,160
70,6,0,0,91,0,0,91
70,11,11,0,0,0,0,11
70,12,156,0,0,0,0,156
70,19,97,0,0,0,0,97
70,22,0,0,953,0,0,953
70,23,127,0,0,0,0,127
70,24,0,0,0,110,0,110
70,25,84,0,0,0,0,84
70,26,0,0,91,0,0,91
70,27,84,0,0,84,0,168
70,29,0,0,128,63,0,191
70,30,0,0,0,71,0,71
70,31,78,0,0,0,0,78
70,32,84,0,101,0,21,206
70,34,0,0,0,17,0,17
70,37,0,0,55,0,0,55
70,41,121,0,132,0,0,253
70,43,90,0,0,0,0,90
70,49,0,0,81,35,0,116
70,50,35,0,0,156,0,191
70,51,311,0,0,0,0,311
70,54,155,0,0,78,0,233
70,55,211,0,0,0,0,211
70,56,84,0,0,0,0,84
70,58,184,0,0,0,0,184
70,60,0,0,91,0,0,91
70,62,79,0,0,0,0,79
70,63,179,0,12,0,0,191
70,64,154,0,0,0,102,256
70,65,610,568,0,84,0,1262
70,66,593,445,154,165,0,1357
70,67,506,0,178,0,0,684
70,68,1245,760,1072,121,130,3328
70,69,282,760,0,160,0,1202
70,70,0,8035,0,86,0,8121
70,74,98,0,95,82,0,275
70,75,0,0,91,0,0,91
70,76,68,0,0,0,0,68
70,77,0,0,0,60,0,60
70,78,88,0,289,0,0,377
70,79,167,0,400,0,0,567
70,80,71,0,0,0,0,71
70,81,249,0,41,155,0,445
70,82,0,0,185,0,0,185
70,83,35,0,107,0,0,142
70,84,130,0,102,0,0,232
70,87,33,0,0,0,0,33
70,88,0,0,0,141,0,141
70,90,62,0,0,62,0,124
70,92,0,0,110,0,0,110
70,94,0,0,67,0,0,67
70,95,0,0,111,0,0,111
70,97,70,0,0,0,0,70
70,98,7,0,0,0,0,7
70,99,58,0,0,0,0,58
70,102,85,0,53,0,0,138
70,104,21,0,0,0,0,21
70,105,50,0,0,0,0,50
70,236,84,0,0,0,0,84
70,237,65,0,0,0,0,65
70,239,0,0,110,0,0,110
70,252,0,0,0,62,0,62
70,254,218,0,0,0,0,218
74,1,0,0,39,0,0,39
74,2,0,0,303,0,0,303
74,3,0,0,306,0,0,306
74,4,0,0,191,910,0,1101
74,7,882,83,0,0,0,965
74,12,124,0,0,0,0,124
74,13,0,0,42,0,0,42
74,14,196,0,0,0,0,196
74,15,53,0,24,0,0,77
74,20,0,0,322,254,0,576
74,21,0,0,78,83,0,161
74,22,0,0,98,0,0,98
74,23,0,457,154,0,0,611
74,24,77,0,0,36,0,113
74,25,336,0,0,0,0,336
74,26,0,167,0,0,0,167
74,27,353,1414,0,55,0,1822
74,28,111,2572,0,0,0,2683
74,29,350,1308,59,23,0,1740
74,30,0,44,192,0,0,236
74,31,39,55,89,30,0,213
74,32,133,793,156,87,0,1169
74,33,7,0,0,0,0,7
74,34,98,39,0,0,0,137
74,36,229,0,143,0,0,372
74,40,0,0,26,0,0,26
74,42,0,0,21,0,0,21
74,43,132,0,55,0,0,187
74,44,0,0,152,0,0,152
74,47,955,0,0,0,0,955
74,49,98,10,242,55,0,405
74,50,0,0,0,62,0,62
74,51,0,0,104,0,0,104
74,52,62,0,202,0,0,264
74,53,0,0,201,0,168,369
74,54,0,0,85,0,0,85
74,55,0,0,185,0,0,185
74,56,0,381,55,0,0,436
74,57,671,2257,211,239,284,3662
74,58,100,0,389,0,0,489
74,60,0,0,527,0,0,527
74,61,513,0,394,0,0,907
74,62,27,98,59,26,0,210
74,64,120,0,0,0,0,120
74,65,231,0,0,0,0,231
74,66,58,0,0,0,0,58
74,67,98,0,0,0,0,98
74,68,554,0,427,182,142,1305
74,69,80,0,307,24,0,411
74,70,180,0,95,0,0,275
74,74,175,8507,0,0,0,8682
74,75,168,626,0,0,0,794
74,76,358,55,42,0,0,455
74,77,0,0,106,0,0,106
74,78,349,362,0,159,0,870
74,79,486,1184,224,269,59,2222
74,80,44,0,228,267,0,539
74,81,150,0,284,56,0,490
74,82,62,0,441,0,0,503
74,83,0,0,295,0,0,295
74,84,102,0,94,0,0,196
74,85,24,0,0,0,0,24
74,86,18,0,0,32,0,50
74,87,227,0,54,98,0,379
74,88,98,0,488,138,0,724
74,89,201,0,0,0,0,201
74,93,0,0,483,0,0,483
74,94,0,0,176,139,0,315
74,95,0,0,144,0,0,144
74,96,98,0,0,0,0,98
74,97,0,0,70,0,0,70
74,99,0,0,37,0,0,37
74,100,0,0,456,0,0,456
74,101,130,0,261,0,0,391
74,102,0,0,39,0,0,39
74,105,0,0,192,0,0,192
74,106,0,0,54,0,0,54
74,108,0,0,0,23,0,23
74,236,0,0,156,0,0,156
74,237,0,0,222,0,0,222
74,239,0,0,192,110,0,302
74,240,55,0,0,0,0,55
74,241,0,0,174,0,0,174
74,252,0,0,144,0,0,144
74,254,109,0,698,0,0,807
75,1,0,0,261,0,0,261
75,2,46,0,187,0,0,233
75,4,70,0,38,0,0,108
75,5,112,0,538,0,0,650
75,6,0,0,0,56,0,56
75,7,0,0,100,0,0,100
75,16,0,0,56,0,0,56
75,19,0,0,38,0,0,38
75,21,0,0,42,0,0,42
75,22,67,0,0,0,0,67
75,23,56,0,502,0,0,558
75,24,0,0,61,0,0,61
75,25,0,0,76,0,0,76
75,26,126,0,288,0,0,414
75,27,252,592,0,0,0,844
75,28,320,776,0,93,0,1189
75,29,408,124,0,58,0,590
75,30,290,0,0,0,0,290
75,31,71,0,151,155,0,377
75,32,190,0,116,187,0,493
75,34,39,0,0,35,0,74
75,36,0,0,61,0,0,61
75,39,0,0,0,78,0,78
75,42,0,0,0,35,0,35
75,44,47,0,0,0,0,47
75,52,0,0,154,0,0,154
75,53,35,0,0,0,0,35
75,54,0,0,117,0,0,117
75,55,0,0,0,35,0,35
75,56,218,0,38,149,0,405
75,57,696,351,76,112,0,1235
75,58,126,0,0,0,0,126
75,59,0,0,393,0,0,393
75,60,205,0,0,0,0,205
75,61,35,0,0,0,0,35
75,62,263,328,29,0,246,866
75,63,23,0,61,0,0,84
75,64,35,0,0,0,0,35
75,66,35,0,61,35,0,131
75,67,127,56,0,0,0,183
75,68,577,0,122,95,0,794
75,69,35,0,174,0,0,209
75,70,35,0,91,0,0,126
75,74,267,376,59,56,0,758
75,75,1421,6465,0,35,0,7921
75,76,260,703,0,534,0,1497
75,77,161,35,56,56,0,308
75,78,35,466,0,56,0,557
75,79,538,1260,96,259,0,2153
75,80,0,44,35,100,0,179
75,81,35,0,61,163,0,259
75,82,149,0,134,0,0,283
75,83,160,0,0,0,0,160
75,84,102,0,0,238,0,340
75,85,0,0,0,35,0,35
75,88,276,0,0,138,0,414
75,90,0,0,102,0,0,102
75,92,0,0,35,0,0,35
75,93,56,0,209,0,0,265
75,94,56,0,0,0,0,56
75,95,102,0,0,0,0,102
75,96,0,0,61,0,0,61
75,97,35,0,0,0,0,35
75,100,56,0,0,112,0,168
75,101,56,0,0,0,0,56
75,102,56,0,0,0,0,56
75,105,56,0,0,0,0,56
75,236,33,0,0,0,0,33
75,237,0,0,58,0,0,58
75,240,35,0,0,0,0,35
76,1,61,0,189,0,0,250
76,3,0,0,38,0,0,38
76,4,0,0,495,0,0,495
76,5,0,0,69,0,0,69
76,6,0,0,321,0,0,321
76,7,0,0,42,0,0,42
76,10,0,0,11,0,0,11
76,21,165,0,0,0,0,165
76,22,38,0,73,0,0,111
76,23,557,56,0,0,111,724
76,24,77,0,84,0,0,161
76,25,162,0,0,0,0,162
76,26,154,0,0,0,0,154
76,27,204,0,101,0,0,305
76,28,38,0,152,0,0,190
76,29,245,38,34,70,0,387
76,30,361,0,0,0,0,361
76,31,348,0,109,0,0,457
76,32,36,38,91,0,0,165
76,33,38,0,0,0,0,38
76,34,39,0,0,0,0,39
76,35,28,0,0,0,0,28
76,36,466,0,294,0,0,760
76,37,0,0,41,0,0,41
76,41,0,0,26,0,0,26
76,45,204,0,0,0,0,204
76,49,0,0,38,34,0,72
76,50,70,0,0,0,0,70
76,53,93,38,77,0,0,208
76,54,114,0,110,38,0,262
76,56,283,104,322,143,81,933
76,57,626,623,0,66,0,1315
76,59,0,0,173,0,0,173
76,61,38,0,42,0,0,80
76,62,67,296,29,0,0,392
76,63,0,0,0,6,0,6
76,65,77,0,0,28,0,105
76,66,344,0,0,0,0,344
76,67,241,879,60,0,0,1180
76,68,454,443,197,243,0,1337
76,69,80,0,0,73,0,153
76,70,68,0,0,0,0,68
76,74,260,55,42,0,0,357
76,75,329,704,0,534,0,1567
76,76,287,4310,233,57,0,4887
76,77,0,38,41,178,0,257
76,78,472,1078,95,61,0,1706
76,79,233,154,155,128,0,670
76,80,162,98,33,0,0,293
76,81,716,275,0,34,0,1025
76,82,0,0,76,0,0,76
76,83,105,0,0,0,0,105
76,84,51,0,51,201,0,303
76,85,24,0,0,0,0,24
76,86,0,0,0,58,0,58
76,87,94,0,0,0,0,94
76,89,0,0,52,0,0,52
76,91,57,0,0,0,0,57
76,92,0,0,34,0,0,34
76,94,97,0,38,0,0,135
76,95,102,0,0,0,0,102
76,96,102,0,0,0,0,102
76,97,108,0,0,0,0,108
76,99,38,0,0,0,0,38
76,100,127,0,0,0,0,127
76,102,77,0,0,0,0,77
76,104,0,0,51,21,0,72
76,105,50,0,0,0,0,50
76,107,77,0,0,0,0,77
76,236,0,0,34,0,0,34
76,238,338,0,38,0,0,376
76,239,0,0,34,0,0,34
76,241,0,0,100,0,0,100
76,251,428,0,0,0,0,428
76,252,62,0,0,0,0,62
77,1,0,0,595,0,0,595
77,2,0,0,140,0,0,140
77,3,135,0,0,0,0,135
77,4,0,0,241,0,0,241
77,5,0,0,531,0,0,531
77,6,0,0,472,740,0,1212
77,9,0,0,92,0,0,92
77,11,22,0,12,0,0,34
77,12,0,0,68,0,0,68
77,14,0,0,105,0,0,105
77,15,0,0,127,0,0,127
77,21,0,0,0,143,0,143
77,22,0,0,94,0,0,94
77,23,140,0,545,0,0,685
77,24,38,0,38,0,0,76
77,25,0,0,176,38,0,214
77,27,199,0,534,230,0,963
77,28,60,0,250,0,0,310
77,29,0,237,339,0,0,576
77,30,127,0,51,476,0,654
77,31,348,0,167,0,56,571
77,32,76,509,278,0,0,863
77,33,44,15,8,57,0,124
77,34,89,0,39,86,0,214
77,35,0,0,473,0,0,473
77,36,0,0,0,232,0,232
77,37,140,0,0,357,45,542
77,40,0,0,10,0,0,10
77,41,0,0,1046,52,0,1098
77,43,0,0,98,0,0,98
77,45,0,0,140,0,0,140
77,49,0,0,65,0,0,65
77,51,104,0,104,0,0,208
77,52,182,0,140,38,0,360
77,53,58,0,0,0,0,58
77,54,14,0,140,0,0,154
77,55,0,0,238,196,0,434
77,56,0,0,194,0,215,409
77,58,0,0,331,0,0,331
77,59,0,0,886,0,0,886
77,61,353,0,0,0,0,353
77,62,27,0,0,27,0,54
77,63,26,0,518,0,0,544
77,65,116,0,0,0,0,116
77,66,78,0,0,0,0,78
77,68,316,476,323,592,0,1707
77,70,0,0,53,60,0,113
77,74,0,0,373,0,0,373
77,75,91,35,0,56,0,182
77,76,0,38,41,178,0,257
77,77,248,12810,0,6209,0,19267
77,78,438,440,102,349,0,1329
77,79,41,2104,292,142,0,2579
77,80,1207,1516,247,119,0,3089
77,81,387,38,42,43,0,510
77,82,667,442,263,776,0,2148
77,83,562,720,138,0,0,1420
77,84,382,0,0,102,0,484
77,85,43,0,26,0,0,69
77,86,18,64,0,20,0,102
77,87,386,240,297,33,206,1162
77,88,278,138,560,0,0,976
77,89,197,0,52,0,0,249
77,90,123,0,0,0,0,123
77,91,280,0,0,0,0,280
77,93,40,0,152,0,0,192
77,94,51,0,0,109,0,160
77,95,0,0,0,0,148,148
77,96,165,0,0,0,0,165
77,97,89,0,139,0,0,228
77,99,0,0,374,0,0,374
77,101,0,328,142,273,0,743
77,102,36,0,53,0,0,89
77,103,0,0,25,0,0,25
77,104,0,0,0,21,0,21
77,105,50,0,441,0,0,491
77,106,0,0,91,0,0,91
77,237,0,0,72,0,0,72
77,238,0,0,309,0,0,309
77,239,60,0,0,0,0,60
77,254,0,0,13,0,0,13
78,1,407,0,121,0,0,528
78,2,102,0,48,0,89,239
78,3,0,0,0,102,0,102
78,4,88,0,89,0,0,177
78,5,0,0,400,0,0,400
78,6,102,0,0,203,148,453
78,7,173,0,0,0,0,173
78,9,0,0,113,0,0,113
78,17,0,0,102,0,0,102
78,19,230,0,0,0,0,230
78,20,555,0,0,254,0,809
78,21,0,0,0,83,0,83
78,22,0,0,97,0,0,97
78,23,0,0,203,0,0,203
78,24,0,0,122,0,0,122
78,25,0,97,807,72,0,976
78,26,0,0,366,0,0,366
78,27,393,78,293,102,256,1122
78,28,315,61,72,140,0,588
78,29,324,203,0,309,0,836
78,30,904,0,95,102,0,1101
78,31,137,183,0,102,0,422
78,32,334,685,391,160,0,1570
78,34,314,0,61,0,0,375
78,36,102,0,160,88,0,350
78,37,0,0,111,0,0,111
78,41,121,0,33,0,0,154
78,43,126,0,170,98,0,394
78,45,268,0,0,0,0,268
78,49,151,0,10,222,104,487
78,53,0,0,72,0,0,72
78,54,88,0,173,88,0,349
78,55,480,0,164,0,0,644
78,57,0,102,204,160,0,466
78,58,10,0,88,0,0,98
78,59,0,0,710,0,0,710
78,60,69,0,0,0,0,69
78,61,0,0,135,0,0,135
78,62,102,75,0,72,0,249
78,63,11,0,0,0,0,11
78,64,88,0,0,7,0,95
78,65,116,0,0,0,0,116
78,66,135,0,0,98,0,233
78,67,80,0,10,55,0,145
78,68,485,0,271,102,104,962
78,70,88,0,179,0,0,267
78,74,277,133,143,231,0,784
78,75,0,556,0,56,0,612
78,76,431,1078,147,90,0,1746
78,77,249,541,102,349,0,1241
78,78,187,7852,0,369,0,8408
78,79,992,1886,102,225,0,3205
78,80,0,44,99,72,0,215
78,81,506,0,14,229,0,749
78,82,759,0,63,307,0,1129
78,83,187,0,344,0,0,531
78,84,138,0,51,96,0,285
78,85,178,0,26,0,0,204
78,86,64,0,0,36,0,100
78,87,203,0,0,0,0,203
78,88,162,0,248,101,0,511
78,89,0,0,95,96,0,191
78,90,189,0,62,0,0,251
78,91,0,0,0,62,0,62
78,92,0,0,72,0,0,72
78,93,0,0,10,102,0,112
78,94,0,0,78,62,0,140
78,95,204,0,0,0,0,204
78,96,163,0,0,0,0,163
78,97,23,0,0,0,0,23
78,101,203,0,0,0,0,203
78,102,0,0,61,10,0,71
78,104,0,0,45,0,0,45
78,105,9,0,0,0,0,9
78,107,0,0,0,118,0,118
78,238,0,0,135,0,0,135
78,251,200,0,0,0,0,200
79,1,0,0,116,41,0,157
79,2,105,0,715,42,0,862
79,3,41,0,85,74,0,200
79,4,198,122,962,0,0,1282
79,5,0,0,212,138,0,350
79,6,25,0,108,0,0,133
79,7,84,0,42,0,0,126
79,8,82,0,111,0,0,193
79,11,0,0,19,0,0,19
79,14,0,0,47,0,0,47
79,16,0,0,171,0,0,171
79,17,0,0,44,49,0,93
79,18,2215,0,289,0,0,2504
79,19,63,0,0,178,0,241
79,21,41,0,0,0,0,41
79,23,0,0,104,0,0,104
79,24,0,0,576,0,0,576
79,25,1043,358,0,0,0,1401
79,26,41,88,419,0,0,548
79,27,0,123,380,265,0,768
79,28,123,1169,91,42,33,1458
79,29,391,2436,72,591,75,3565
79,30,80,0,434,0,0,514
79,31,195,368,564,142,0,1269
79,32,307,7571,145,0,0,8023
79,33,61,202,8,16,0,287
79,34,39,0,0,17,0,56
79,35,41,0,325,23,0,389
79,36,0,0,172,64,0,236
79,37,0,0,82,0,0,82
79,38,0,0,0,53,0,53
79,40,0,0,120,0,0,120
79,41,23,0,26,0,0,49
79,42,24,0,0,0,0,24
79,43,126,0,484,63,0,673
79,48,0,0,247,0,0,247
79,49,114,0,245,0,0,359
79,50,0,0,38,0,0,38
79,51,0,0,191,0,0,191
79,52,178,0,276,185,0,639
79,53,41,0,162,0,0,203
79,54,276,0,37,14,0,327
79,55,38,0,72,0,0,110
79,56,0,0,123,0,0,123
79,57,204,0,407,193,0,804
79,58,0,0,690,0,0,690
79,59,0,0,884,0,0,884
79,60,41,0,0,0,0,41
79,61,0,0,246,0,0,246
79,62,231,41,0,154,0,426
79,63,23,0,0,11,0,34
79,64,453,0,0,189,0,642
79,65,619,0,244,111,0,974
79,66,36,0,52,0,0,88
79,67,0,0,60,134,0,194
79,68,151,0,181,41,0,373
79,69,237,0,71,0,0,308
79,70,167,0,571,0,0,738
79,74,247,1059,382,269,59,2016
79,75,355,1447,153,206,0,2161
79,76,274,122,155,128,0,679
79,77,41,1980,389,142,0,2552
79,78,1064,1916,212,225,0,3417
79,79,897,8703,0,163,37,9800
79,80,41,0,25,0,0,66
79,81,491,0,324,41,0,856
79,82,23,0,248,101,0,372
79,83,138,0,195,41,0,374
79,84,234,0,23,138,0,395
79,85,96,0,52,0,0,148
79,86,106,0,0,18,0,124
79,87,0,67,600,0,0,667
79,88,41,0,300,41,33,415
79,89,48,0,168,0,0,216
79,90,103,0,333,0,0,436
79,91,41,0,0,0,0,41
79,92,41,0,41,23,0,105
79,93,63,40,73,0,0,176
79,94,82,0,98,62,0,242
79,96,108,0,214,0,0,322
79,97,219,0,268,21,0,508
79,99,58,0,0,0,0,58
79,100,41,0,141,0,0,182
79,101,90,0,142,0,0,232
79,102,114,0,61,85,0,260
79,104,0,0,44,21,0,65
79,105,50,0,44,0,0,94
79,106,0,0,41,0,0,41
79,107,254,0,0,99,0,353
79,108,0,0,35,51,0,86
79,236,41,0,112,0,0,153
79,237,0,0,26,0,0,26
79,238,0,0,151,0,0,151
79,239,110,0,42,0,0,152
79,240,0,0,0,0,298,298
79,241,0,0,69,0,0,69
79,250,0,0,108,0,0,108
79,252,0,0,393,0,0,393
79,254,129,0,248,0,0,377
80,1,0,0,623,0,0,623
80,2,26,0,88,0,64,178
80,4,0,0,44,214,0,258
80,5,44,0,457,161,0,662
80,6,0,0,44,0,0,44
80,9,0,0,40,0,0,40
80,11,22,0,0,0,0,22
80,13,0,0,44,0,0,44
80,14,180,0,0,0,0,180
80,16,44,0,88,0,0,132
80,18,0,0,135,0,0,135
80,19,0,0,140,49,0,189
80,23,98,0,29,0,0,127
80,24,0,0,0,44,0,44
80,25,162,0,162,0,0,324
80,27,0,0,273,104,0,377
80,28,88,0,214,0,0,302
80,29,405,0,0,0,0,405
80,30,109,0,58,0,0,167
80,31,0,0,414,49,0,463
80,32,180,0,1215,0,0,1395
80,33,15,6,48,15,0,84
80,34,100,0,178,0,0,278
80,35,0,0,553,0,0,553
80,36,492,0,342,0,0,834
80,37,150,0,0,18,0,168
80,43,0,0,151,0,0,151
80,45,496,0,0,0,0,496
80,50,74,0,0,0,0,74
80,51,104,0,0,0,0,104
80,52,42,0,0,180,0,222
80,53,44,0,81,0,0,125
80,55,0,0,0,168,64,232
80,56,0,0,309,107,0,416
80,57,0,0,276,0,0,276
80,58,0,0,100,0,0,100
80,61,125,0,0,0,0,125
80,62,0,0,29,0,0,29
80,63,0,0,180,0,0,180
80,64,0,0,48,0,0,48
80,65,116,0,0,0,0,116
80,66,58,0,0,0,84,142
80,68,137,210,244,545,326,1462
80,69,178,0,0,80,0,258
80,70,71,0,0,0,0,71
80,74,102,0,228,0,0,330
80,75,107,0,140,44,0,291
80,76,62,98,33,0,0,193
80,77,1029,1947,295,93,0,3364
80,78,89,44,99,72,0,304
80,79,41,0,0,0,0,41
80,80,2783,16389,0,230,128,19530
80,81,392,630,113,187,0,1322
80,82,1138,1656,1079,106,0,3979
80,83,195,1541,465,510,200,2911
80,84,193,0,0,51,0,244
80,85,11,0,39,24,0,74
80,86,0,0,48,20,0,68
80,87,67,33,33,67,146,346
80,88,171,0,0,0,0,171
80,89,216,0,0,168,69,453
80,90,0,0,33,0,0,33
80,93,0,0,60,0,0,60
80,94,0,0,0,44,0,44
80,95,792,0,49,0,0,841
80,96,276,67,205,112,38,698
80,97,158,35,209,35,0,437
80,99,96,0,0,0,0,96
80,100,450,0,200,267,0,917
80,101,286,0,53,44,0,383
80,102,136,0,0,0,0,136
80,104,21,0,0,0,0,21
80,108,39,0,0,0,0,39
80,239,26,0,0,0,0,26
80,240,59,0,0,0,0,59
80,252,0,0,0,44,0,44
80,254,0,0,294,0,0,294
81,1,0,0,40,0,0,40
81,2,0,0,92,0,0,92
81,3,111,0,61,0,0,172
81,4,468,0,0,0,0,468
81,5,684,0,56,0,0,740
81,7,98,0,0,78,0,176
81,8,43,0,155,0,0,198
81,11,0,0,63,0,0,63
81,14,111,0,0,0,0,111
81,17,13,0,0,0,0,13
81,20,43,0,0,0,0,43
81,22,29,0,0,0,0,29
81,23,0,0,56,0,0,56
81,24,46,0,0,0,0,46
81,27,0,0,176,0,0,176
81,28,0,0,283,66,0,349
81,29,198,0,194,72,0,464
81,30,159,0,0,0,0,159
81,31,0,0,342,214,0,556
81,32,218,0,334,0,0,552
81,33,31,0,0,0,0,31
81,34,146,0,390,47,0,583
81,35,0,0,0,291,0,291
81,36,131,0,0,0,0,131
81,38,0,0,35,0,0,35
81,41,0,0,56,0,0,56
81,43,0,0,0,102,0,102
81,48,0,0,191,0,0,191
81,49,0,0,32,0,0,32
81,50,0,0,30,0,0,30
81,52,98,0,61,0,0,159
81,53,182,0,0,0,0,182
81,54,56,0,97,56,0,209
81,55,139,0,0,0,0,139
81,56,0,0,0,0,256,256
81,57,345,0,63,0,0,408
81,60,0,0,0,102,148,250
81,61,204,0,0,0,0,204
81,62,53,0,54,0,0,107
81,63,23,0,0,0,0,23
81,64,0,0,261,172,174,607
81,65,405,0,50,446,0,901
81,66,372,0,38,164,0,574
81,67,198,0,0,419,0,617
81,68,808,1210,132,802,355,3307
81,69,470,152,226,336,0,1184
81,70,139,0,0,155,0,294
81,74,248,0,231,56,142,677
81,75,91,0,61,163,0,315
81,76,757,275,0,34,0,1066
81,77,248,82,0,0,0,330
81,78,545,0,14,229,0,788
81,79,308,0,324,41,0,673
81,80,552,824,0,49,0,1425
81,81,1331,13170,0,358,646,15505
81,82,671,2014,558,213,89,3545
81,83,447,38,75,61,81,702
81,84,51,0,102,0,0,153
81,85,126,0,0,24,0,150
81,86,27,0,0,0,0,27
81,87,340,0,0,100,0,440
81,88,138,0,0,0,0,138
81,89,0,0,114,0,0,114
81,90,0,0,206,0,0,206
81,93,87,0,345,0,0,432
81,94,0,0,0,56,0,56
81,95,241,0,0,0,0,241
81,96,807,0,73,61,0,941
81,97,110,0,61,0,51,222
81,100,404,0,163,0,0,567
81,101,226,0,321,0,0,547
81,102,250,0,0,0,0,250
81,103,10,0,0,0,0,10
81,104,73,0,23,0,0,96
81,105,286,0,0,0,0,286
81,107,99,0,0,99,0,198
81,238,0,0,438,0,0,438
81,240,0,0,355,0,0,355
81,251,56,0,0,0,0,56
82,1,31,0,40,0,0,71
82,2,0,0,260,0,0,260
82,3,0,0,473,0,0,473
82,4,30,0,0,0,0,30
82,5,0,0,97,162,0,259
82,6,0,0,257,0,0,257
82,7,0,0,0,18,0,18
82,9,26,0,0,0,0,26
82,12,182,0,0,0,0,182
82,14,0,0,61,0,0,61
82,15,0,0,70,0,0,70
82,16,0,0,302,0,0,302
82,18,0,0,366,0,0,366
82,19,0,0,0,156,0,156
82,20,0,0,306,0,0,306
82,22,0,0,36,0,0,36
82,23,0,0,317,0,0,317
82,24,181,0,22,0,0,203
82,27,177,0,495,31,0,703
82,28,0,0,79,0,0,79
82,29,0,0,56,0,0,56
82,30,402,0,234,0,0,636
82,31,0,0,491,64,0,555
82,32,21,0,122,21,0,164
82,33,15,0,15,6,0,36
82,34,47,0,70,53,0,170
82,35,0,0,128,51,0,179
82,36,131,0,1066,0,0,1197
82,37,0,0,31,0,0,31
82,40,0,0,0,27,0,27
82,41,0,0,494,26,0,520
82,42,0,0,21,0,0,21
82,43,0,0,97,0,0,97
82,47,0,0,107,0,0,107
82,49,0,0,146,0,0,146
82,50,0,0,74,0,0,74
82,51,87,0,0,0,0,87
82,52,0,0,42,0,0,42
82,53,0,0,178,53,0,231
82,54,35,0,0,0,0,35
82,55,0,0,541,0,0,541
82,56,83,0,89,148,0,320
82,57,230,0,99,0,0,329
82,58,0,0,200,0,0,200
82,59,0,0,607,0,0,607
82,60,205,0,0,0,0,205
82,61,1015,0,238,0,0,1253
82,62,31,0,229,0,0,260
82,63,11,0,0,0,0,11
82,64,171,0,0,95,276,542
82,66,174,0,0,0,84,258
82,67,0,0,176,0,80,256
82,68,527,215,76,90,130,1038
82,69,115,0,0,7,102,224
82,70,0,0,943,0,0,943
82,74,62,0,470,21,0,553
82,75,56,0,99,0,0,155
82,76,0,0,76,0,0,76
82,77,598,442,263,667,0,1970
82,78,759,0,109,307,89,1264
82,79,182,0,686,101,0,969
82,80,1294,1653,554,335,0,3836
82,81,600,2006,356,416,142,3520
82,82,1198,24423,153,0,744,26518
82,83,854,1132,269,228,145,2628
82,84,51,0,74,102,0,227
82,85,35,0,44,0,0,79
82,87,176,0,54,266,49,545
82,88,675,0,150,719,0,1544
82,89,168,0,0,0,0,168
82,90,0,0,0,501,0,501
82,91,0,0,30,33,0,63
82,93,0,0,0,70,0,70
82,94,0,0,67,0,0,67
82,95,400,129,952,0,147,1628
82,96,419,428,238,62,190,1337
82,97,671,0,44,186,0,901
82,99,58,0,0,33,0,91
82,100,132,0,0,0,0,132
82,101,130,0,200,130,0,460
82,102,114,0,201,100,45,460
82,103,21,0,46,14,0,81
82,104,110,0,0,0,0,110
82,105,609,0,0,113,0,722
82,107,1241,0,0,0,0,1241
82,108,0,0,86,0,0,86
82,237,111,0,31,0,0,142
82,240,0,0,76,0,0,76
82,250,254,0,108,0,0,362
82,252,126,0,126,0,0,252
83,1,69,0,247,84,0,400
83,2,0,0,69,0,0,69
83,3,36,0,406,0,0,442
83,5,0,0,236,0,0,236
83,6,0,0,349,0,0,349
83,7,0,0,234,69,0,303
83,20,0,0,254,0,0,254
83,21,0,0,321,0,0,321
83,22,0,0,165,0,0,165
83,24,0,0,146,0,0,146
83,26,33,0,0,0,0,33
83,27,0,0,658,0,0,658
83,28,0,0,744,527,0,1271
83,29,147,0,273,0,0,420
83,30,240,0,129,233,0,602
83,31,559,0,193,138,0,890
83,32,108,0,1470,0,0,1578
83,33,62,0,0,15,0,77
83,34,301,0,39,77,0,417
83,35,55,0,53,0,0,108
83,36,299,0,1104,0,0,1403
83,37,0,0,0,37,0,37
83,41,197,0,0,0,0,197
83,43,0,0,177,0,0,177
83,49,0,0,74,0,0,74
83,52,0,0,189,0,0,189
83,54,37,0,117,0,0,154
83,55,0,0,196,0,0,196
83,56,0,0,231,0,0,231
83,57,0,0,103,0,0,103
83,59,0,0,259,0,0,259
83,60,102,0,0,0,0,102
83,61,69,0,0,0,0,69
83,62,0,0,56,0,0,56
83,63,11,0,0,0,0,11
83,64,0,0,200,0,0,200
83,65,220,0,0,207,0,427
83,66,58,0,0,0,0,58
83,67,193,0,0,0,0,193
83,68,205,0,94,0,276,575
83,69,168,0,182,0,0,350
83,70,69,0,53,0,0,122
83,74,0,0,197,137,0,334
83,75,160,0,0,0,0,160
83,76,128,0,173,0,0,301
83,77,674,720,276,0,0,1670
83,78,0,0,344,0,0,344
83,79,138,0,268,41,0,447
83,80,274,1805,233,78,200,2590
83,81,392,0,281,61,81,815
83,82,824,1607,694,228,145,3498
83,83,1772,12631,150,175,0,14728
83,84,360,51,297,0,0,708
83,85,47,0,12,69,0,128
83,86,268,30,0,0,0,298
83,87,892,979,186,57,100,2214
83,88,1539,21,225,210,0,1995
83,89,470,607,235,0,400,1712
83,90,193,189,206,0,0,588
83,91,88,0,0,0,0,88
83,92,4,0,0,0,0,4
83,93,131,0,64,466,0,661
83,94,0,0,29,62,0,91
83,95,1265,2230,104,0,0,3599
83,96,988,67,0,0,95,1150
83,97,608,0,78,248,0,934
83,98,19,0,25,0,0,44
83,99,0,0,0,41,0,41
83,100,1160,0,0,215,0,1375
83,101,692,0,75,438,400,1605
83,102,49,0,0,350,0,399
83,103,21,0,45,0,0,66
83,104,64,0,23,0,0,87
83,105,195,0,1854,0,0,2049
83,107,2347,0,118,0,0,2465
83,108,37,0,0,0,0,37
83,237,206,0,51,0,0,257
83,238,0,0,444,0,0,444
83,254,0,0,129,0,0,129
84,1,51,0,43,19,0,113
84,2,100,0,320,0,0,420
84,3,51,0,47,45,0,143
84,4,0,0,55,51,0,106
84,5,111,0,844,0,0,955
84,6,0,0,659,45,0,704
84,7,244,0,0,45,0,289
84,8,0,0,120,0,0,120
84,9,0,0,45,0,0,45
84,21,0,0,111,0,0,111
84,22,0,0,0,67,0,67
84,23,0,0,51,0,0,51
84,24,51,0,0,0,0,51
84,27,0,0,51,0,0,51
84,28,147,0,276,102,0,525
84,29,248,0,103,51,0,402
84,30,0,0,55,0,0,55
84,31,0,0,51,51,0,102
84,32,445,0,116,96,0,657
84,33,51,51,72,23,0,197
84,34,726,0,0,57,0,783
84,35,466,0,292,0,0,758
84,36,152,530,1032,121,0,1835
84,37,69,0,0,0,0,69
84,39,0,0,152,0,0,152
84,40,51,0,0,0,0,51
84,43,0,0,55,0,0,55
84,49,51,0,0,0,0,51
84,51,93,0,0,89,0,182
84,53,0,0,39,0,0,39
84,54,61,0,0,0,0,61
84,55,98,0,0,0,0,98
84,56,83,0,51,0,0,134
84,57,210,0,177,311,74,772
84,58,0,0,306,0,0,306
84,59,0,0,0,607,0,607
84,62,168,0,0,0,0,168
84,63,0,0,25,0,0,25
84,65,227,0,126,0,0,353
84,66,0,0,38,43,0,81
84,67,51,0,0,0,0,51
84,68,102,0,278,0,0,380
84,69,73,0,0,0,0,73
84,70,130,0,102,0,0,232
84,74,102,0,93,0,0,195
84,75,86,0,0,203,0,289
84,76,72,0,51,201,0,324
84,77,366,0,0,118,0,484
84,78,88,0,104,0,0,192
84,79,183,0,106,160,0,449
84,80,102,0,0,51,0,153
84,81,51,0,102,0,0,153
84,82,114,0,55,203,0,372
84,83,309,0,282,96,0,687
84,84,2556,6632,55,135,0,9378
84,85,1197,2148,0,46,0,3391
84,86,65,231,10,58,26,390
84,87,1648,51,109,276,0,2084
84,88,1186,1348,110,471,0,3115
84,89,325,0,0,0,0,325
84,90,544,265,0,67,0,876
84,91,91,0,55,8,0,154
84,92,9,6,0,0,0,15
84,93,390,1731,149,236,59,2565
84,94,914,371,102,0,0,1387
84,95,204,0,111,0,0,315
84,97,152,0,35,0,0,187
84,99,250,0,0,0,0,250
84,100,201,0,253,0,0,454
84,101,0,0,0,104,0,104
84,102,346,0,0,0,0,346
84,104,42,0,22,0,0,64
84,105,50,0,0,0,0,50
84,106,51,0,0,0,0,51
84,107,99,0,63,0,0,162
84,237,0,0,0,47,0,47
84,251,0,0,389,0,0,389
85,1,33,0,12,0,0,45
85,2,0,0,11,0,0,11
85,3,0,0,26,47,0,73
85,5,0,0,82,0,0,82
85,7,11,0,0,144,0,155
85,8,24,0,12,0,0,36
85,10,0,0,0,24,0,24
85,19,24,0,0,0,0,24
85,23,0,0,35,0,0,35
85,25,97,0,0,0,0,97
85,27,11,0,19,91,0,121
85,29,24,63,24,11,0,122
85,30,162,0,0,0,0,162
85,31,35,0,1541,24,0,1600
85,32,143,21,38,156,0,358
85,33,59,112,0,0,0,171
85,34,390,73,0,88,0,551
85,35,0,0,618,0,0,618
85,36,82,476,24,11,0,593
85,37,11,0,0,24,0,35
85,40,0,0,24,0,0,24
85,42,24,0,0,0,0,24
85,44,0,0,11,0,0,11
85,51,0,0,24,0,0,24
85,54,0,0,35,0,0,35
85,55,0,0,0,20,0,20
85,57,0,0,30,0,0,30
85,59,24,0,267,0,0,291
85,62,11,0,17,0,0,28
85,66,35,0,0,0,0,35
85,67,0,0,0,17,0,17
85,68,131,0,44,47,0,222
85,69,24,0,37,0,0,61
85,74,0,0,0,24,0,24
85,75,0,0,0,35,0,35
85,77,34,0,26,0,0,60
85,78,225,0,26,0,0,251
85,79,96,0,52,0,0,148
85,80,59,0,39,0,0,98
85,81,98,0,0,24,0,122
85,82,35,0,19,24,0,78
85,83,71,0,12,69,0,152
85,84,1048,2108,0,24,0,3180
85,85,206,593,0,0,69,868
85,86,145,95,10,0,0,250
85,87,103,0,26,89,0,218
85,88,1141,63,31,35,0,1270
85,90,0,0,26,0,0,26
85,91,65,0,0,0,0,65
85,92,73,0,0,24,0,97
85,93,136,456,0,11,0,603
85,94,0,0,61,41,0,102
85,95,35,0,0,0,0,35
85,99,345,0,167,0,0,512
85,100,943,0,187,41,0,1171
85,101,0,0,0,361,0,361
85,103,36,0,0,0,0,36
85,105,0,0,29,0,0,29
85,106,35,0,0,0,0,35
85,241,0,0,0,11,0,11
86,2,0,0,82,0,0,82
86,3,0,0,32,0,0,32
86,4,0,0,18,20,0,38
86,5,0,0,47,0,0,47
86,6,9,0,0,0,0,9
86,7,18,0,0,0,0,18
86,9,0,0,20,0,0,20
86,19,0,0,74,0,0,74
86,21,0,0,70,0,0,70
86,24,0,0,46,0,0,46
86,27,9,0,41,0,0,50
86,28,0,0,45,0,0,45
86,29,9,0,9,0,0,18
86,30,9,0,89,20,0,118
86,31,0,0,0,66,0,66
86,32,163,0,74,0,0,237
86,33,0,47,44,0,0,91
86,34,85,0,0,0,0,85
86,36,116,0,0,0,0,116
86,43,0,0,41,0,0,41
86,45,0,0,166,0,0,166
86,49,0,0,0,18,0,18
86,55,20,0,0,0,0,20
86,56,0,0,45,0,0,45
86,57,18,0,45,24,0,87
86,58,18,0,0,0,0,18
86,61,33,0,0,0,0,33
86,63,64,0,0,0,0,64
86,64,36,0,0,0,0,36
86,65,18,0,0,0,0,18
86,68,0,0,70,0,0,70
86,69,0,0,22,0,0,22
86,74,18,0,0,32,0,50
86,76,0,0,0,40,0,40
86,77,38,64,0,20,0,122
86,78,36,0,0,18,0,54
86,79,171,0,0,18,0,189
86,80,0,0,48,0,0,48
86,81,27,0,19,9,0,55
86,82,0,0,89,0,0,89
86,83,205,30,0,138,0,373
86,84,110,248,10,76,26,470
86,85,106,95,10,0,0,211
86,86,61,711,0,18,0,790
86,87,176,9,27,9,0,221
86,88,269,467,0,263,0,999
86,89,0,0,226,0,147,373
86,90,18,0,372,96,0,486
86,91,9,0,0,0,0,9
86,93,127,18,44,0,0,189
86,94,58,0,10,63,0,131
86,95,0,0,102,0,0,102
86,96,18,0,0,40,0,58
86,97,0,0,0,45,0,45
86,98,12,0,0,0,0,12
86,100,0,0,19,0,0,19
86,102,123,0,0,0,0,123
87,1,0,0,33,33,0,66
87,3,33,0,176,0,0,209
87,4,214,0,36,0,0,250
87,5,0,0,91,0,0,91
87,6,0,0,36,0,0,36
87,7,0,0,27,0,0,27
87,8,98,0,0,0,0,98
87,13,0,0,33,0,0,33
87,16,0,0,142,0,0,142
87,19,0,0,26,0,0,26
87,23,0,0,33,0,0,33
87,24,0,0,53,0,0,53
87,26,0,0,30,0,0,30
87,27,0,0,271,0,0,271
87,28,0,0,127,0,0,127
87,29,0,0,57,0,0,57
87,30,98,0,155,33,0,286
87,31,160,0,0,33,0,193
87,32,67,0,236,0,49,352
87,34,145,0,92,0,0,237
87,35,81,0,142,0,0,223
87,36,150,0,26,0,49,225
87,43,100,0,0,0,0,100
87,44,0,0,33,0,0,33
87,49,50,0,100,0,0,150
87,52,0,0,193,0,0,193
87,53,33,0,33,0,0,66
87,54,142,0,142,0,0,284
87,55,0,0,412,0,0,412
87,57,30,0,222,97,0,349
87,59,0,0,1606,0,0,1606
87,60,67,0,0,0,0,67
87,61,0,0,100,0,0,100
87,62,67,0,24,0,0,91
87,63,6,0,0,0,0,6
87,65,111,0,0,0,0,111
87,67,284,0,0,0,0,284
87,68,358,0,121,152,0,631
87,69,138,0,26,0,0,164
87,70,33,0,0,24,0,57
87,74,173,0,109,98,0,380
87,76,94,0,0,0,0,94
87,77,151,240,249,0,206,846
87,78,203,0,0,0,0,203
87,79,51,33,699,0,0,783
87,80,209,33,100,78,146,566
87,81,340,0,0,100,0,440
87,82,199,0,56,243,49,547
87,83,658,1001,262,0,100,2021
87,84,1284,244,0,134,0,1662
87,85,170,33,26,0,0,229
87,86,149,0,46,9,0,204
87,87,853,2824,219,156,97,4149
87,88,2949,2698,36,722,0,6405
87,89,1034,136,52,0,0,1222
87,90,356,201,276,0,0,833
87,91,27,0,0,0,0,27
87,92,64,0,0,0,0,64
87,93,240,0,128,0,0,368
87,94,33,0,65,33,0,131
87,95,371,33,36,96,0,536
87,96,1139,0,36,33,0,1208
87,97,0,0,392,86,0,478
87,99,96,0,0,0,0,96
87,100,708,61,912,0,0,1681
87,101,153,0,322,56,0,531
87,102,0,0,0,47,0,47
87,104,0,0,140,89,0,229
87,105,423,0,328,0,0,751
87,106,0,0,26,33,0,59
87,107,0,0,0,27,0,27
87,238,168,0,0,0,0,168
88,1,0,0,438,404,0,842
88,2,0,0,138,0,0,138
88,3,0,0,0,138,0,138
88,4,0,101,0,0,0,101
88,5,634,0,964,415,200,2213
88,6,0,0,0,440,0,440
88,7,200,0,0,0,0,200
88,8,24,0,71,0,0,95
88,9,0,0,138,0,0,138
88,16,266,0,0,0,0,266
88,17,0,0,0,220,0,220
88,19,138,0,0,0,0,138
88,20,138,0,0,0,0,138
88,21,138,0,0,0,0,138
88,22,0,0,150,0,0,150
88,23,377,0,138,0,0,515
88,24,138,0,0,0,0,138
88,25,138,0,201,0,0,339
88,27,46,0,260,0,0,306
88,29,0,0,260,440,0,700
88,30,420,0,389,487,0,1296
88,31,515,0,0,0,0,515
88,32,878,0,322,0,0,1200
88,33,62,0,0,0,0,62
88,34,317,0,0,0,0,317
88,35,47,0,0,0,0,47
88,36,537,0,150,131,0,818
88,37,138,0,150,67,0,355
88,38,35,0,0,0,0,35
88,41,138,0,0,0,0,138
88,45,0,0,118,138,0,256
88,47,101,0,0,0,0,101
88,49,0,0,141,0,0,141
88,54,391,0,0,0,0,391
88,55,0,0,0,138,0,138
88,56,0,0,101,0,0,101
88,57,276,0,0,253,0,529
88,59,0,0,101,0,0,101
88,60,0,0,414,138,0,552
88,61,0,0,101,253,0,354
88,63,62,0,0,0,0,62
88,64,0,0,0,145,0,145
88,66,58,0,0,0,0,58
88,67,0,0,150,0,0,150
88,68,619,0,110,138,0,867
88,69,138,0,0,0,0,138
88,70,0,0,110,141,0,251
88,74,98,138,526,138,0,900
88,75,276,0,0,0,0,276
88,77,173,0,560,138,0,871
88,78,138,0,460,0,0,598
88,79,179,0,150,41,33,403
88,80,438,0,22,831,0,1291
88,81,138,0,0,0,0,138
88,82,812,0,150,719,0,1681
88,83,815,301,228,49,0,1393
88,84,1630,1077,110,152,0,2969
88,85,1082,63,12,52,0,1209
88,86,354,467,0,186,0,1007
88,87,2741,2463,0,788,0,5992
88,88,2912,22379,0,599,0,25890
88,89,624,440,0,166,0,1230
88,90,1807,1884,0,123,105,3919
88,91,158,28,0,537,0,723
88,92,277,0,5,0,0,282
88,93,1451,186,0,297,0,1934
88,94,1970,993,153,788,0,3904
88,95,355,0,275,0,0,630
88,96,689,0,0,0,0,689
88,97,455,0,202,0,0,657
88,98,276,0,0,0,0,276
88,99,138,0,107,0,0,245
88,100,747,0,570,536,0,1853
88,101,883,261,865,361,0,2370
88,102,934,0,0,0,0,934
88,103,0,0,0,72,0,72
88,104,171,0,0,0,0,171
88,105,294,0,0,0,0,294
88,106,69,0,0,0,0,69
88,107,850,0,153,435,0,1438
88,239,391,0,0,0,0,391
88,241,0,0,116,0,0,116
89,1,0,0,72,0,0,72
89,4,0,0,0,168,0,168
89,5,0,0,52,0,0,52
89,6,0,0,231,0,0,231
89,7,0,0,392,0,0,392
89,9,62,0,0,0,0,62
89,12,118,0,0,0,0,118
89,24,0,0,168,0,0,168
89,27,0,0,405,0,0,405
89,28,0,0,145,0,0,145
89,29,0,0,48,0,0,48
89,30,0,0,119,0,0,119
89,31,0,0,119,0,0,119
89,32,0,0,48,0,0,48
89,34,48,0,79,0,0,127
89,35,0,0,101,0,0,101
89,36,48,0,31,48,0,127
89,49,0,0,31,0,0,31
89,56,48,0,224,0,0,272
89,57,296,0,0,0,0,296
89,59,0,0,0,57,0,57
89,68,48,0,0,150,0,198
89,69,0,0,183,0,0,183
89,77,149,0,52,0,0,201
89,78,0,0,143,96,0,239
89,79,0,0,168,0,0,168
89,80,216,0,0,0,69,285
89,81,0,0,57,0,0,57
89,83,477,0,287,0,799,1563
89,84,325,0,0,124,0,449
89,86,0,0,226,0,147,373
89,87,738,184,0,0,0,922
89,88,499,440,0,166,0,1105
89,89,152,1287,0,0,0,1439
89,90,947,0,0,134,0,1081
89,91,0,0,9,0,0,9
89,93,40,0,0,0,0,40
89,94,269,0,0,0,0,269
89,95,0,81,0,0,0,81
89,96,505,168,119,0,0,792
89,97,35,0,0,0,0,35
89,99,224,0,0,0,0,224
89,100,0,418,183,237,0,838
89,101,230,0,158,0,0,388
89,102,114,0,0,0,0,114
89,104,0,0,127,0,0,127
89,105,0,0,0,28,0,28
89,240,0,0,210,0,0,210
90,1,0,0,134,0,0,134
90,3,0,0,123,0,0,123
90,5,123,0,326,0,0,449
90,6,62,0,76,0,0,138
90,7,0,0,67,0,0,67
90,10,0,0,0,189,0,189
90,19,123,0,0,0,0,123
90,24,214,0,718,0,0,932
90,25,0,0,0,62,0,62
90,27,93,0,124,378,0,595
90,28,189,0,62,0,0,251
90,29,0,0,62,0,0,62
90,30,199,0,0,0,0,199
90,31,0,0,581,0,0,581
90,32,0,0,79,0,0,79
90,34,129,0,0,0,0,129
90,36,62,0,67,448,0,577
90,37,91,0,83,0,0,174
90,49,0,0,72,0,0,72
90,54,14,0,0,0,0,14
90,58,0,0,109,0,0,109
90,61,0,0,123,0,0,123
90,66,166,0,0,0,0,166
90,68,62,0,0,337,0,399
90,70,62,0,0,0,0,62
90,74,0,0,209,0,0,209
90,75,0,0,35,0,0,35
90,77,62,0,0,0,0,62
90,78,189,0,67,0,0,256
90,79,83,0,189,76,0,348
90,82,0,0,233,214,89,536
90,83,371,189,206,69,0,835
90,84,526,51,118,281,0,976
90,85,11,0,26,0,0,37
90,86,18,0,482,0,0,500
90,87,768,262,243,0,0,1273
90,88,1591,2044,0,335,105,4075
90,89,659,168,0,294,0,1121
90,90,1981,5473,254,859,549,9116
90,91,132,0,0,31,0,163
90,93,89,0,79,0,0,168
90,94,201,536,0,0,0,737
90,95,164,0,0,0,0,164
90,96,959,0,0,0,0,959
90,97,162,0,38,35,0,235
90,98,281,0,25,0,0,306
90,99,51,0,0,0,0,51
90,100,790,432,418,178,274,2092
90,101,1861,129,0,328,0,2318
90,103,11,0,6,35,0,52
90,104,63,0,0,0,0,63
90,105,269,0,0,371,0,640
90,108,123,0,0,0,0,123
90,240,0,0,0,0,274,274
91,8,0,228,80,0,0,308
91,19,0,0,884,0,0,884
91,21,110,0,83,0,0,193
91,26,0,0,156,0,0,156
91,27,31,0,0,0,0,31
91,28,60,0,28,0,0,88
91,30,95,0,0,0,0,95
91,31,0,0,0,30,0,30
91,32,10,0,0,0,0,10
91,33,0,0,24,0,0,24
91,34,37,0,0,0,0,37
91,35,0,0,182,0,0,182
91,36,95,0,0,0,0,95
91,37,44,0,62,0,0,106
91,39,0,0,736,0,0,736
91,41,26,0,429,0,0,455
91,42,0,0,81,0,0,81
91,43,0,0,9,0,0,9
91,45,0,0,0,660,0,660
91,47,107,0,134,0,0,241
91,48,0,0,186,0,0,186
91,52,0,0,89,0,0,89
91,55,0,0,192,0,0,192
91,56,0,0,17,0,0,17
91,58,31,0,0,0,0,31
91,63,0,0,0,10,0,10
91,67,0,0,80,0,0,80
91,68,9,0,9,0,0,18
91,75,35,0,0,0,0,35
91,76,57,0,0,0,0,57
91,77,280,0,0,0,0,280
91,79,41,0,0,0,0,41
91,82,0,0,30,33,0,63
91,83,58,0,0,0,0,58
91,84,121,0,55,8,0,184
91,85,65,0,0,0,0,65
91,86,9,0,80,0,0,89
91,87,0,0,0,27,0,27
91,88,182,28,0,537,0,747
91,89,0,0,9,0,0,9
91,90,199,0,0,31,0,230
91,91,37,2802,0,37,0,2876
91,92,0,0,57,0,0,57
91,93,31,0,1033,0,41,1105
91,94,20,0,48,0,0,68
91,98,8,0,0,23,0,31
91,99,338,73,0,23,0,434
91,100,202,10,692,25,0,929
91,101,0,0,180,0,0,180
91,102,9,0,0,0,0,9
91,103,10,0,0,0,0,10
91,104,9,0,0,0,0,9
91,105,10,0,0,0,0,10
91,107,0,0,31,0,0,31
91,236,41,0,0,0,0,41
91,251,0,0,200,0,0,200
92,1,0,0,4,0,0,4
92,3,0,0,138,0,0,138
92,4,0,0,6,0,0,6
92,5,114,0,5,0,0,119
92,6,3,0,1,0,0,4
92,7,0,0,0,189,0,189
92,16,0,0,4,0,0,4
92,17,0,0,21,0,0,21
92,23,0,0,0,100,0,100
92,26,0,0,144,0,0,144
92,27,0,0,4,0,0,4
92,29,0,0,63,0,0,63
92,30,15,0,0,5,0,20
92,32,93,0,0,0,0,93
92,35,532,493,0,0,0,1025
92,36,41,95,412,0,0,548
92,37,52,460,0,0,0,512
92,40,18,0,0,0,0,18
92,43,0,0,120,1,0,121
92,51,0,0,1,0,0,1
92,52,0,0,42,0,0,42
92,54,0,0,6,0,0,6
92,56,0,0,148,0,0,148
92,62,0,0,27,27,0,54
92,63,0,0,4,0,0,4
92,64,0,0,0,120,0,120
92,66,47,0,0,0,0,47
92,75,0,0,35,0,0,35
92,76,436,0,0,0,0,436
92,78,0,0,72,0,0,72
92,79,41,0,41,23,0,105
92,83,4,0,285,0,0,289
92,84,4,6,0,0,0,10
92,85,120,0,0,0,0,120
92,87,64,0,0,0,0,64
92,88,253,0,115,0,0,368
92,91,0,0,57,0,0,57
92,92,15,5866,0,20,0,5901
92,93,40,742,0,0,6,788
92,94,62,35,0,4,0,101
92,95,102,0,5,0,0,107
92,96,0,0,4,0,0,4
92,97,1034,0,0,0,0,1034
92,99,4,0,0,0,0,4
92,100,10,0,8,0,0,18
92,105,50,0,0,0,0,50
92,237,0,0,111,0,0,111
93,1,0,0,83,0,0,83
93,2,0,0,44,0,0,44
93,3,0,0,312,0,0,312
93,4,0,0,561,0,0,561
93,5,0,447,134,0,0,581
93,6,40,0,739,0,0,779
93,7,260,0,0,0,0,260
93,8,0,0,339,0,0,339
93,12,0,0,268,0,0,268
93,15,0,0,53,0,0,53
93,16,0,0,40,0,0,40
93,17,0,0,59,0,0,59
93,19,0,0,156,0,0,156
93,20,0,0,0,254,0,254
93,21,83,0,120,0,0,203
93,23,40,0,29,0,0,69
93,24,0,0,1075,0,0,1075
93,25,0,0,160,0,0,160
93,26,168,0,0,0,0,168
93,27,246,0,243,0,0,489
93,29,48,40,0,0,0,88
93,30,135,0,40,0,0,175
93,31,4,0,400,301,0,705
93,32,0,0,60,27,0,87
93,33,51,0,31,0,0,82
93,34,30,23,0,39,0,92
93,35,24,0,335,0,0,359
93,36,1916,1236,54,1309,0,4515
93,37,92,378,0,0,0,470
93,39,40,0,78,0,0,118
93,40,18,0,18,0,0,36
93,43,0,0,0,0,59,59
93,49,0,0,201,0,0,201
93,54,40,0,14,0,0,54
93,55,0,0,28,0,0,28
93,56,381,0,0,0,0,381
93,57,155,0,65,0,0,220
93,58,0,0,92,0,0,92
93,59,0,0,393,0,0,393
93,63,23,0,0,0,0,23
93,65,227,0,0,0,0,227
93,67,0,0,88,0,0,88
93,68,191,0,117,0,0,308
93,74,0,0,397,0,0,397
93,75,56,0,209,0,0,265
93,77,40,0,0,0,0,40
93,78,0,0,10,102,0,112
93,79,63,0,23,40,0,126
93,80,0,0,567,0,0,567
93,81,87,0,0,0,0,87
93,82,0,0,0,70,0,70
93,83,0,0,53,0,0,53
93,84,497,1382,100,249,262,2490
93,85,158,456,0,11,0,625
93,86,127,0,63,0,0,190
93,87,240,113,0,0,0,353
93,88,1473,186,0,0,0,1659
93,89,40,0,0,168,0,208
93,90,89,0,79,0,0,168
93,91,37,0,0,0,41,78
93,92,438,200,873,0,6,1517
93,93,233,6731,237,0,0,7201
93,94,543,2150,204,128,0,3025
93,95,40,0,574,0,0,614
93,96,27,0,88,0,0,115
93,97,0,0,0,45,0,45
93,98,15,0,0,0,0,15
93,99,249,0,472,0,0,721
93,100,229,0,237,0,0,466
93,101,0,0,207,0,0,207
93,102,177,0,53,0,0,230
93,103,70,0,26,0,0,96
93,104,42,0,0,0,0,42
93,105,128,0,54,0,0,182
93,107,322,0,108,0,0,430
93,108,0,0,25,0,0,25
93,239,0,0,240,61,0,301
93,241,0,0,120,0,0,120
94,4,35,35,0,0,0,70
94,5,0,0,77,0,0,77
94,6,0,0,38,0,0,38
94,7,0,0,83,0,0,83
94,8,0,0,38,0,0,38
94,9,62,0,92,0,0,154
94,17,13,0,0,0,0,13
94,20,254,0,0,0,0,254
94,25,0,0,523,0,0,523
94,26,0,0,295,127,0,422
94,27,0,0,192,0,0,192
94,28,167,0,0,0,0,167
94,29,0,0,75,0,0,75
94,30,13,0,106,0,0,119
94,31,200,0,159,0,0,359
94,32,131,0,223,0,0,354
94,33,7,0,0,0,0,7
94,35,0,0,29,0,0,29
94,36,498,445,361,0,0,1304
94,37,91,83,0,0,0,174
94,43,0,0,62,0,0,62
94,45,166,0,131,0,0,297
94,47,0,0,107,0,0,107
94,49,62,0,0,0,0,62
94,50,74,0,0,0,0,74
94,52,0,0,62,0,0,62
94,54,0,0,35,0,0,35
94,55,168,0,35,0,0,203
94,56,35,0,0,0,0,35
94,58,100,0,0,0,0,100
94,60,0,0,0,102,0,102
94,61,0,0,62,0,0,62
94,62,0,0,27,0,0,27
94,63,11,0,0,0,0,11
94,65,224,0,0,0,0,224
94,67,80,0,0,0,0,80
94,68,150,0,26,0,0,176
94,69,0,0,0,127,0,127
94,70,0,0,67,0,0,67
94,74,0,0,176,139,0,315
94,75,91,0,582,0,0,673
94,76,97,0,38,0,0,135
94,77,0,0,0,109,0,109
94,78,0,0,0,62,0,62
94,79,82,0,132,62,0,276
94,80,0,0,0,44,0,44
94,81,0,0,0,56,0,56
94,82,0,0,67,0,0,67
94,83,0,189,96,0,0,285
94,84,748,407,55,0,0,1210
94,85,24,0,19,64,0,107
94,86,109,0,10,63,0,182
94,87,255,0,29,67,0,351
94,88,1654,1666,153,446,0,3919
94,89,269,0,0,0,0,269
94,90,263,293,67,47,0,670
94,91,20,0,52,0,0,72
94,92,62,35,0,4,0,101
94,93,457,1572,90,128,0,2247
94,94,681,7846,0,158,0,8685
94,95,254,0,0,110,0,364
94,98,12,0,25,0,0,37
94,99,0,62,122,0,0,184
94,100,158,232,347,638,0,1375
94,101,360,0,0,328,0,688
94,102,0,0,53,0,213,266
94,103,90,0,0,0,0,90
94,104,0,0,23,0,0,23
94,105,204,0,380,271,0,855
94,107,198,0,0,0,0,198
94,108,218,0,0,0,0,218
94,236,0,0,122,0,0,122
94,252,0,0,745,0,0,745
94,254,31,0,0,0,0,31
95,1,0,0,343,0,0,343
95,2,0,0,75,0,0,75
95,7,75,0,204,0,0,279
95,8,0,0,111,0,0,111
95,22,39,0,0,0,0,39
95,27,75,0,102,75,0,252
95,28,60,0,140,0,0,200
95,29,0,0,216,35,0,251
95,30,0,0,64,0,0,64
95,31,102,0,302,0,0,404
95,32,0,0,204,0,0,204
95,33,47,0,0,0,0,47
95,34,53,0,0,102,0,155
95,35,102,0,0,0,0,102
95,36,95,0,0,0,0,95
95,37,0,0,81,0,0,81
95,41,0,0,30,0,0,30
95,50,0,0,74,0,0,74
95,52,0,0,150,75,0,225
95,54,37,0,75,0,0,112
95,55,102,0,0,0,0,102
95,56,0,0,0,75,0,75
95,57,102,0,0,0,0,102
95,63,6,0,0,0,0,6
95,64,75,0,0,0,0,75
95,66,0,0,0,465,0,465
95,67,200,0,0,0,0,200
95,68,75,0,0,102,0,177
95,74,0,0,141,0,0,141
95,75,102,0,0,0,0,102
95,76,102,0,0,0,0,102
95,77,0,0,0,0,148,148
95,78,294,0,0,0,0,294
95,80,815,0,49,0,0,864
95,81,241,0,57,0,0,298
95,82,376,129,961,0,147,1613
95,83,1298,1786,215,39,0,3338
95,84,204,0,0,0,0,204
95,85,82,0,0,0,0,82
95,86,0,0,102,0,0,102
95,87,247,33,36,182,0,498
95,88,331,0,275,0,0,606
95,89,0,24,0,0,0,24
95,90,164,0,0,0,0,164
95,92,102,0,5,0,0,107
95,93,40,0,574,0,0,614
95,94,146,0,0,26,0,172
95,95,3524,5453,111,204,0,9292
95,96,749,605,727,395,0,2476
95,97,493,0,38,299,0,830
95,100,802,0,111,437,0,1350
95,101,1870,639,111,328,0,2948
95,102,214,0,0,0,0,214
95,103,37,0,0,0,0,37
95,104,227,0,0,25,0,252
95,105,559,0,616,0,0,1175
95,107,0,0,0,150,0,150
95,108,102,0,0,0,0,102
95,237,0,0,72,0,0,72
95,238,0,0,287,0,0,287
96,1,0,0,67,67,0,134
96,2,66,0,0,0,0,66
96,3,0,0,27,0,0,27
96,4,0,0,255,0,0,255
96,23,49,0,56,0,0,105
96,25,0,0,379,0,0,379
96,27,23,0,0,0,0,23
96,29,67,0,27,0,0,94
96,30,58,0,55,0,0,113
96,31,91,0,0,0,0,91
96,32,0,0,89,0,0,89
96,33,37,0,0,0,0,37
96,34,133,0,0,0,0,133
96,35,0,0,89,0,0,89
96,43,0,0,98,0,0,98
96,49,0,0,50,0,0,50
96,50,76,0,0,0,0,76
96,54,0,0,27,66,0,93
96,55,66,0,0,0,0,66
96,57,155,0,155,0,0,310
96,58,0,0,284,0,0,284
96,63,76,0,73,0,0,149
96,64,64,0,0,0,0,64
96,65,76,0,0,0,0,76
96,68,158,0,0,66,0,224
96,69,0,0,0,0,95,95
96,75,0,0,61,0,0,61
96,76,65,0,0,0,0,65
96,77,134,0,0,0,0,134
96,78,0,0,67,0,0,67
96,79,108,0,214,0,0,322
96,80,368,67,118,67,38,658
96,81,898,0,73,61,0,1032
96,82,1149,428,238,62,190,2067
96,83,1101,67,132,0,95,1395
96,86,40,0,0,18,0,58
96,87,1139,0,36,33,0,1208
96,88,295,0,153,0,0,448
96,89,168,0,119,0,0,287
96,90,959,0,0,0,0,959
96,92,0,0,4,0,0,4
96,93,27,0,88,0,0,115
96,95,784,605,727,395,0,2511
96,96,1040,2197,0,325,0,3562
96,97,800,249,38,600,0,1687
96,100,297,0,0,0,0,297
96,101,512,62,0,0,0,574
96,102,512,0,53,38,0,603
96,103,6,0,0,0,0,6
96,104,243,0,0,0,0,243
96,105,377,0,0,80,0,457
96,106,35,0,0,0,87,122
96,107,198,0,108,0,0,306
96,108,64,0,0,0,0,64
96,236,25,0,0,0,0,25
97,1,0,0,139,0,0,139
97,2,70,0,0,0,0,70
97,4,44,0,0,0,0,44
97,7,51,0,0,0,0,51
97,19,40,0,0,0,0,40
97,21,0,0,349,0,0,349
97,23,0,0,56,0,0,56
97,24,0,0,96,23,0,119
97,27,140,0,65,0,0,205
97,28,38,0,69,0,0,107
97,29,58,0,0,0,0,58
97,30,64,0,111,0,0,175
97,31,35,0,0,0,0,35
97,32,304,0,35,0,0,339
97,34,98,0,0,35,0,133
97,35,35,0,0,0,0,35
97,36,131,0,0,0,0,131
97,41,45,0,0,0,0,45
97,43,56,0,40,0,0,96
97,44,98,0,0,0,0,98
97,49,0,0,50,0,0,50
97,53,0,0,35,0,0,35
97,54,35,0,0,0,0,35
97,60,205,0,0,0,0,205
97,64,193,0,0,0,0,193
97,65,0,0,0,370,0,370
97,68,35,0,0,35,0,70
97,69,154,0,0,35,51,240
97,70,70,0,38,0,0,108
97,74,0,0,70,0,0,70
97,75,70,0,0,0,0,70
97,76,108,0,0,0,0,108
97,77,45,0,142,0,0,187
97,78,23,0,0,0,0,23
97,79,184,0,780,0,0,964
97,80,193,0,246,0,0,439
97,81,104,0,61,0,51,216
97,82,706,0,370,40,0,1116
97,83,565,0,78,551,0,1194
97,84,77,0,35,0,0,112
97,87,35,0,392,86,0,513
97,88,455,0,202,0,0,657
97,90,162,0,38,35,0,235
97,92,1034,0,0,0,0,1034
97,93,168,0,0,45,0,213
97,95,348,0,149,150,0,647
97,96,845,249,38,45,0,1177
97,97,1486,5474,0,799,0,7759
97,99,35,0,0,0,0,35
97,100,575,0,252,0,0,827
97,101,314,23,0,746,0,1083
97,102,819,646,25,115,0,1605
97,103,19,0,15,555,0,589
97,104,189,21,70,52,0,332
97,105,1212,0,184,0,0,1396
97,106,24,0,0,35,0,59
97,107,1138,81,0,40,0,1259
97,108,93,0,0,0,0,93
97,239,0,0,40,0,0,40
97,241,0,0,24,0,0,24
98,16,0,0,23,0,0,23
98,23,0,0,7,0,0,7
98,24,0,0,8,0,0,8
98,27,0,0,58,0,0,58
98,28,0,0,0,7,0,7
98,29,0,0,7,0,0,7
98,31,0,0,113,0,0,113
98,36,0,0,252,0,0,252
98,41,0,0,53,0,0,53
98,67,0,0,8,0,0,8
98,68,7,0,0,7,0,14
98,70,7,0,0,0,0,7
98,79,0,0,69,0,0,69
98,83,19,0,25,69,0,113
98,86,12,0,0,0,0,12
98,88,276,0,0,0,0,276
98,90,106,0,148,0,0,254
98,91,8,0,0,23,0,31
98,92,4,0,0,0,0,4
98,93,15,0,0,0,0,15
98,94,19,0,25,0,0,44
98,98,0,997,0,69,0,1066
98,99,121,0,74,0,0,195
98,100,720,113,247,108,77,1265
98,101,7,0,0,9,0,16
98,102,28,0,0,0,0,28
98,103,58,22,0,11,0,91
98,105,216,0,58,0,0,274
98,107,0,0,8,0,0,8
99,2,0,0,96,0,0,96
99,4,58,0,0,0,0,58
99,5,0,0,151,0,0,151
99,9,0,0,58,0,0,58
99,18,0,0,0,96,0,96
99,21,0,0,429,0,0,429
99,22,0,0,67,0,0,67
99,26,214,0,0,0,0,214
99,28,119,0,41,0,0,160
99,29,58,0,0,0,0,58
99,34,58,0,0,0,0,58
99,35,0,0,58,0,0,58
99,36,262,0,0,0,0,262
99,37,0,0,70,0,0,70
99,39,78,0,0,0,0,78
99,41,0,0,53,0,0,53
99,43,0,0,98,0,0,98
99,44,34,0,0,0,0,34
99,50,38,0,0,0,0,38
99,51,0,0,161,0,0,161
99,52,0,0,37,0,0,37
99,57,58,0,96,0,0,154
99,64,95,0,0,0,0,95
99,66,96,0,0,0,0,96
99,70,58,0,0,0,0,58
99,76,38,0,0,0,0,38
99,77,0,0,374,0,0,374
99,79,58,0,0,0,0,58
99,80,96,0,0,214,0,310
99,82,58,0,0,0,0,58
99,83,0,0,0,41,0,41
99,84,204,0,0,0,0,204
99,85,345,0,165,0,0,510
99,87,96,0,0,33,0,129
99,88,276,0,107,0,0,383
99,89,224,0,0,0,0,224
99,90,51,0,0,0,0,51
99,91,338,73,0,23,0,434
99,93,205,0,428,0,0,633
99,94,53,62,61,0,0,176
99,97,35,0,0,0,0,35
99,98,68,0,132,0,0,200
99,99,531,3274,0,274,0,4079
99,100,387,456,281,246,333,1703
99,101,375,0,0,0,0,375
99,102,94,0,137,374,0,605
99,103,31,0,0,0,0,31
99,104,85,0,0,0,0,85
99,105,94,0,159,0,0,253
99,106,151,0,0,0,0,151
99,108,51,0,63,0,0,114
100,1,150,0,287,0,0,437
100,2,0,0,150,0,0,150
100,3,0,0,229,0,0,229
100,4,455,0,482,0,0,937
100,5,7,0,856,0,0,863
100,6,0,0,249,0,0,249
100,7,0,0,554,0,0,554
100,11,0,0,14,0,0,14
100,17,58,0,26,0,0,84
100,18,0,0,229,0,0,229
100,23,0,0,29,0,0,29
100,28,0,0,28,0,0,28
100,29,150,0,163,0,0,313
100,30,35,0,70,0,0,105
100,31,126,0,276,229,0,631
100,33,0,0,8,0,0,8
100,34,39,0,25,0,56,120
100,37,1837,0,166,0,0,2003
100,39,150,0,0,0,0,150
100,43,0,0,642,0,0,642
100,49,0,0,161,0,0,161
100,54,294,0,37,0,0,331
100,55,0,0,126,0,0,126
100,56,0,0,126,0,0,126
100,57,0,0,9,0,0,9
100,60,0,0,102,0,0,102
100,62,11,0,0,0,0,11
100,64,120,0,0,0,0,120
100,65,0,0,0,229,0,229
100,68,221,0,145,150,0,516
100,69,80,0,0,0,0,80
100,74,0,0,229,0,0,229
100,75,56,0,0,112,0,168
100,76,38,0,0,0,0,38
100,77,178,0,163,0,0,341
100,79,41,0,0,0,0,41
100,80,300,0,200,0,0,500
100,81,432,0,163,0,0,595
100,82,132,0,0,0,0,132
100,83,1693,0,23,215,0,1931
100,84,488,0,277,0,0,765
100,85,374,0,26,0,0,400
100,87,335,61,420,0,0,816
100,88,920,0,894,398,0,2212
100,89,216,418,183,512,0,1329
100,90,775,150,510,874,274,2583
100,91,31,19,68,17,0,135
100,92,10,0,8,0,0,18
100,93,229,0,625,0,0,854
100,94,378,190,347,638,0,1553
100,95,875,0,111,335,0,1321
100,96,177,0,0,0,0,177
100,97,373,0,252,0,0,625
100,98,706,113,142,175,77,1213
100,99,654,398,344,150,333,1879
100,100,2941,17185,610,0,0,20736
100,101,788,611,297,398,0,2094
100,102,1583,852,608,36,0,3079
100,103,203,155,98,16,0,472
100,104,489,0,104,49,333,975
100,105,648,0,140,0,0,788
100,106,182,0,75,109,0,366
100,107,257,0,643,286,0,1186
100,108,1016,0,216,96,0,1328
100,236,0,0,224,0,0,224
100,237,0,0,166,0,0,166
100,251,200,0,0,0,0,200
101,1,0,0,321,0,0,321
101,2,0,0,166,0,0,166
101,4,690,0,0,0,0,690
101,5,0,0,670,0,0,670
101,17,0,0,328,0,0,328
101,24,0,0,130,0,0,130
101,26,0,0,455,0,0,455
101,27,95,0,142,0,0,237
101,28,0,0,117,130,0,247
101,29,0,0,321,0,0,321
101,30,0,0,357,328,0,685
101,32,273,0,142,0,0,415
101,35,0,0,203,0,0,203
101,49,0,0,328,0,0,328
101,50,74,0,0,0,0,74
101,54,37,0,0,0,0,37
101,58,508,0,0,0,0,508
101,64,0,0,321,0,0,321
101,66,0,0,65,0,0,65
101,68,368,0,484,0,0,852
101,69,130,0,0,0,0,130
101,74,130,0,261,0,0,391
101,75,56,0,0,0,0,56
101,77,0,0,357,0,0,357
101,78,102,0,111,0,0,213
101,80,0,0,480,44,0,524
101,81,226,0,321,0,0,547
101,82,416,0,200,130,53,799
101,83,657,0,129,130,0,916
101,84,51,0,0,104,0,155
101,85,0,0,0,361,0,361
101,87,153,0,450,56,0,659
101,88,1901,261,611,0,0,2773
101,89,168,0,158,0,0,326
101,90,1984,234,0,328,0,2546
101,91,67,0,180,0,0,247
101,93,0,0,221,0,0,221
101,94,377,46,0,328,0,751
101,95,1575,897,111,430,0,3013
101,96,328,62,0,0,0,390
101,97,502,23,0,746,0,1271
101,98,7,0,0,9,0,16
101,99,191,0,0,0,0,191
101,100,832,434,739,296,0,2301
101,101,985,4905,0,0,0,5890
101,102,180,290,58,38,0,566
101,103,0,0,24,11,0,35
101,104,299,0,0,0,0,299
101,105,854,0,0,0,0,854
101,106,261,0,13,14,0,288
101,107,0,0,142,286,0,428
101,252,0,0,0,62,0,62
101,254,0,0,220,0,0,220
102,1,0,0,109,0,0,109
102,5,0,0,251,49,0,300
102,8,49,0,0,0,0,49
102,14,36,0,0,0,0,36
102,27,36,0,236,0,0,272
102,28,179,0,0,0,0,179
102,29,21,0,0,0,0,21
102,30,0,0,61,0,0,61
102,31,146,0,220,49,0,415
102,33,0,128,0,0,0,128
102,34,0,0,42,0,0,42
102,35,0,0,69,0,0,69
102,37,114,0,0,0,0,114
102,43,0,0,114,0,0,114
102,48,0,0,0,114,0,114
102,49,0,0,54,0,0,54
102,54,0,0,97,0,0,97
102,55,0,0,128,0,0,128
102,56,0,0,83,0,0,83
102,59,0,0,49,0,0,49
102,60,49,0,0,0,0,49
102,61,56,0,0,0,0,56
102,62,49,0,0,0,0,49
102,65,0,49,0,0,0,49
102,68,239,0,60,0,0,299
102,69,56,0,0,0,0,56
102,70,85,0,0,0,0,85
102,75,56,0,0,0,0,56
102,76,115,0,0,0,0,115
102,77,0,0,53,0,0,53
102,78,0,0,72,0,0,72
102,79,114,0,84,85,0,283
102,80,136,0,0,0,0,136
102,81,285,0,0,0,0,285
102,82,114,0,201,49,0,364
102,83,49,0,0,302,0,351
102,84,349,0,0,51,0,400
102,86,123,0,0,0,0,123
102,87,33,0,0,47,0,80
102,88,847,0,42,0,0,889
102,89,114,0,0,48,0,162
102,91,106,0,0,0,0,106
102,93,177,0,53,0,0,230
102,94,0,0,213,0,0,213
102,95,172,0,0,0,0,172
102,96,502,0,53,87,0,642
102,97,795,611,25,111,0,1542
102,98,28,0,0,0,0,28
102,99,94,0,137,0,0,231
102,100,1530,885,444,154,0,3013
102,101,310,290,0,92,0,692
102,102,1794,1778,139,101,0,3812
102,103,331,81,1071,65,0,1548
102,104,137,40,0,92,0,269
102,105,753,312,54,291,0,1410
102,106,92,0,13,117,0,222
102,107,195,0,1235,99,0,1529
102,108,78,0,0,101,0,179
102,239,0,0,170,0,0,170
103,1,0,0,11,0,0,11
103,2,0,0,19,0,0,19
103,3,0,0,32,0,0,32
103,5,0,0,97,0,0,97
103,26,18,0,0,0,0,18
103,28,35,0,11,0,0,46
103,30,6,0,0,0,0,6
103,33,35,0,0,0,0,35
103,34,0,0,11,0,0,11
103,35,10,0,0,0,0,10
103,37,0,0,11,0,0,11
103,40,35,0,0,0,0,35
103,44,16,0,0,0,0,16
103,49,0,0,10,0,0,10
103,54,10,0,0,0,0,10
103,56,10,0,10,0,0,20
103,57,10,0,0,0,0,10
103,62,11,0,0,0,0,11
103,63,0,0,18,0,0,18
103,66,10,0,0,0,0,10
103,68,35,0,0,0,0,35
103,74,0,0,10,0,0,10
103,77,0,0,25,0,0,25
103,81,10,0,0,0,0,10
103,82,53,0,57,14,0,124
103,83,21,0,0,0,0,21
103,85,36,0,0,0,0,36
103,88,0,0,0,72,0,72
103,90,25,0,6,35,0,66
103,91,10,0,0,0,0,10
103,93,70,0,15,0,0,85
103,94,37,0,0,0,0,37
103,95,37,0,0,0,0,37
103,96,0,0,0,555,0,555
103,97,25,0,15,0,0,40
103,98,111,22,0,11,0,144
103,99,31,0,0,0,0,31
103,100,344,242,104,21,0,711
103,101,0,0,24,11,0,35
103,102,296,43,0,11,0,350
103,103,336,356,0,0,0,692
103,104,104,170,0,0,0,274
103,105,170,0,123,0,0,293
103,106,10,0,11,0,0,21
103,107,118,0,108,143,0,369
103,108,24,0,0,0,0,24
103,238,0,0,10,0,0,10
104,1,21,0,9,0,0,30
104,5,0,0,44,0,0,44
104,6,21,0,33,0,0,54
104,7,9,0,0,0,0,9
104,17,21,0,0,0,0,21
104,18,21,0,0,0,0,21
104,19,0,0,146,0,0,146
104,26,0,0,377,0,0,377
104,27,43,0,9,0,0,52
104,29,21,0,73,0,0,94
104,31,21,0,100,0,0,121
104,32,21,0,0,0,0,21
104,34,21,0,0,0,0,21
104,35,0,0,27,0,0,27
104,36,9,0,0,0,0,9
104,37,0,0,117,0,0,117
104,41,9,0,0,0,0,9
104,49,0,0,27,0,0,27
104,53,21,0,0,0,0,21
104,55,21,0,0,0,0,21
104,56,27,0,47,0,0,74
104,58,0,0,21,0,0,21
104,59,0,0,21,0,0,21
104,63,21,0,0,0,0,21
104,64,0,0,23,0,0,23
104,66,21,0,0,0,0,21
104,67,21,0,0,0,0,21
104,68,42,0,0,138,0,180
104,69,0,0,22,0,0,22
104,70,21,0,0,0,0,21
104,76,237,0,51,0,0,288
104,77,0,0,9,21,0,30
104,78,0,0,45,0,0,45
104,79,21,0,22,43,0,86
104,80,21,0,0,0,0,21
104,81,43,0,23,0,0,66
104,82,130,0,0,0,0,130
104,83,43,0,0,0,0,43
104,84,42,0,22,0,0,64
104,87,0,0,123,56,0,179
104,88,205,0,0,0,0,205
104,89,0,0,104,0,0,104
104,90,43,0,0,30,0,73
104,91,39,0,0,0,0,39
104,93,21,0,0,0,0,21
104,94,9,0,23,0,0,32
104,95,231,0,0,0,0,231
104,96,286,0,0,0,0,286
104,97,237,21,60,0,0,318
104,99,85,0,0,0,0,85
104,100,121,0,0,49,333,503
104,101,369,0,13,25,0,407
104,102,171,40,0,92,0,303
104,103,214,198,0,68,0,480
104,104,1077,915,0,0,0,1992
104,105,466,27,87,0,0,580
104,106,39,98,65,68,62,332
104,107,1250,673,0,118,77,2118
104,108,126,161,0,21,0,308
105,1,150,0,184,0,0,334
105,2,0,0,320,0,0,320
105,5,128,0,0,0,0,128
105,6,222,0,0,0,0,222
105,7,0,0,129,0,0,129
105,24,0,0,107,50,0,157
105,27,50,0,0,0,0,50
105,29,50,0,0,0,0,50
105,30,0,0,70,0,0,70
105,34,39,0,0,0,0,39
105,35,0,0,242,0,0,242
105,36,0,0,0,50,0,50
105,41,50,0,0,0,0,50
105,54,50,0,0,0,0,50
105,59,0,0,440,0,0,440
105,60,50,0,0,0,0,50
105,61,50,0,0,0,0,50
105,62,0,0,85,0,0,85
105,68,50,0,0,0,0,50
105,69,50,0,0,0,0,50
105,70,50,0,0,0,0,50
105,74,0,0,192,0,0,192
105,75,56,0,0,0,0,56
105,76,140,0,0,0,0,140
105,77,50,0,109,0,0,159
105,79,50,0,44,0,0,94
105,81,249,0,0,0,0,249
105,82,609,0,0,50,0,659
105,83,195,0,373,0,0,568
105,84,50,0,109,0,0,159
105,85,0,0,378,0,0,378
105,87,365,0,245,33,0,643
105,88,294,0,0,0,0,294
105,89,276,0,23,28,0,327
105,90,100,0,0,411,0,511
105,91,10,0,0,0,0,10
105,92,50,0,0,0,0,50
105,93,128,0,54,0,0,182
105,94,204,0,380,271,0,855
105,95,581,0,616,0,0,1197
105,96,412,0,0,80,0,492
105,97,1203,0,184,0,0,1387
105,98,216,0,58,0,0,274
105,99,94,0,0,0,0,94
105,100,706,0,140,0,0,846
105,101,854,0,0,0,0,854
105,102,704,312,54,241,0,1311
105,103,148,0,123,0,0,271
105,104,457,91,87,0,0,635
105,105,906,3396,367,1640,0,6309
105,106,99,1060,0,33,0,1192
105,107,3351,2408,64,160,0,5983
105,108,96,62,0,0,0,158
106,1,0,0,0,60,0,60
106,2,0,0,60,0,0,60
106,7,0,0,0,16,0,16
106,22,0,0,88,0,0,88
106,24,288,0,166,0,0,454
106,30,47,0,0,0,0,47
106,31,349,0,28,0,0,377
106,32,43,0,56,0,0,99
106,34,0,0,18,0,0,18
106,35,0,0,65,0,0,65
106,36,131,0,51,0,0,182
106,37,0,0,0,0,50,50
106,43,0,0,35,0,0,35
106,44,0,0,56,0,0,56
106,53,0,0,219,0,0,219
106,61,93,0,0,0,0,93
106,64,240,0,0,0,0,240
106,66,101,0,0,0,0,101
106,68,243,0,0,0,0,243
106,74,0,0,54,0,0,54
106,75,61,0,0,0,0,61
106,77,0,0,91,0,0,91
106,79,0,0,41,0,0,41
106,83,80,0,0,0,0,80
106,84,51,0,0,0,0,51
106,85,24,0,0,0,0,24
106,87,0,0,59,0,0,59
106,96,71,0,0,0,87,158
106,97,42,0,0,35,0,77
106,99,151,0,0,0,0,151
106,100,133,0,75,0,0,208
106,101,261,0,0,0,0,261
106,102,141,0,13,117,0,271
106,103,0,0,11,0,0,11
106,104,18,98,79,68,62,325
106,105,99,1060,0,33,0,1192
106,106,422,2253,0,169,524,3368
106,107,0,121,38,25,0,184
106,108,0,138,0,53,0,191
106,237,0,0,26,0,0,26
106,239,110,0,0,0,0,110
106,241,120,0,0,0,0,120
107,1,0,0,216,0,0,216
107,2,0,0,99,0,0,99
107,5,0,0,128,0,0,128
107,7,99,0,0,0,0,99
107,8,0,0,102,0,0,102
107,16,0,0,129,0,0,129
107,27,99,0,0,0,0,99
107,29,198,0,0,0,0,198
107,30,198,0,0,0,0,198
107,31,302,0,0,0,0,302
107,32,99,0,108,0,0,207
107,34,118,0,128,0,0,246
107,41,198,0,0,0,0,198
107,52,0,0,330,0,0,330
107,53,0,0,58,0,0,58
107,56,0,0,99,0,0,99
107,57,158,0,392,0,0,550
107,62,26,0,0,0,0,26
107,64,99,0,0,0,0,99
107,66,35,0,0,0,0,35
107,67,0,0,0,99,0,99
107,68,342,0,0,0,0,342
107,69,118,0,0,0,0,118
107,76,77,0,0,0,0,77
107,77,60,0,0,0,0,60
107,78,0,0,0,118,0,118
107,79,254,0,0,99,0,353
107,81,99,0,0,99,0,198
107,82,1241,0,0,0,0,1241
107,83,0,0,118,0,0,118
107,84,99,0,63,0,0,162
107,88,872,0,153,435,0,1460
107,91,0,0,31,0,0,31
107,93,302,0,108,0,0,410
107,94,198,0,0,0,0,198
107,95,108,0,0,150,0,258
107,96,280,0,108,0,0,388
107,97,537,81,0,40,0,658
107,98,0,0,8,0,0,8
107,100,353,0,747,286,0,1386
107,101,0,0,142,286,0,428
107,102,195,0,172,0,0,367
107,103,118,0,108,143,0,369
107,104,1112,556,0,118,77,1863
107,105,2557,2400,64,160,0,5181
107,106,0,121,38,25,0,184
107,107,58,2526,216,906,0,3706
107,108,133,384,163,0,0,680
107,240,401,0,0,0,0,401
107,254,0,0,0,248,0,248
108,1,0,0,14,0,0,14
108,4,0,0,129,0,0,129
108,8,21,0,0,0,0,21
108,11,22,0,0,0,0,22
108,21,0,0,83,0,0,83
108,22,0,0,0,300,0,300
108,28,0,0,23,0,0,23
108,29,237,0,0,0,0,237
108,32,0,0,25,0,0,25
108,37,53,0,0,0,0,53
108,45,240,0,0,0,0,240
108,49,74,0,0,0,0,74
108,50,74,0,0,0,0,74
108,57,0,0,56,0,0,56
108,61,190,0,0,0,0,190
108,65,224,0,0,0,0,224
108,66,145,0,0,0,0,145
108,74,0,0,0,23,0,23
108,78,102,0,0,0,0,102
108,79,0,0,35,51,0,86
108,80,39,0,0,0,0,39
108,82,62,0,86,0,0,148
108,83,37,0,0,0,0,37
108,90,123,0,0,0,0,123
108,91,322,0,0,0,0,322
108,93,0,0,25,0,0,25
108,94,218,0,0,0,0,218
108,95,102,0,0,0,0,102
108,96,99,0,0,0,0,99
108,97,58,0,0,0,0,58
108,99,155,0,63,96,0,314
108,100,0,0,224,0,0,224
108,101,0,0,0,14,0,14
108,102,78,0,0,101,0,179
108,103,24,0,0,0,0,24
108,104,82,183,0,0,0,265
108,105,96,62,56,0,0,214
108,106,0,138,0,39,0,177
108,107,184,384,108,0,0,676
108,108,102,1070,69,187,71,1499
108,238,135,0,0,0,0,135
108,240,0,0,51,0,0,51
236,1,33,0,448,0,59,540
236,5,0,0,51,0,0,51
236,15,0,0,263,0,0,263
236,18,0,0,246,96,0,342
236,21,178,0,0,0,0,178
236,23,0,0,122,0,0,122
236,24,0,0,311,0,0,311
236,27,41,0,0,0,0,41
236,28,82,0,0,0,0,82
236,29,0,0,633,0,0,633
236,31,41,0,0,0,0,41
236,32,129,0,207,0,0,336
236,36,0,0,51,0,0,51
236,39,359,0,0,0,0,359
236,40,123,0,0,0,0,123
236,43,0,0,58,0,0,58
236,44,567,0,0,0,0,567
236,45,0,0,50,0,0,50
236,49,47,0,0,0,0,47
236,50,41,0,80,94,0,215
236,51,180,0,0,0,0,180
236,54,225,0,0,0,0,225
236,57,0,0,155,0,0,155
236,60,205,0,0,0,0,205
236,62,41,0,0,112,0,153
236,66,41,0,0,58,0,99
236,67,0,0,122,0,0,122
236,70,84,0,0,0,0,84
236,74,0,0,109,47,0,156
236,75,0,0,36,0,0,36
236,79,41,0,0,0,0,41
236,94,0,0,122,0,0,122
236,96,25,0,0,0,0,25
236,100,0,0,224,0,0,224
236,236,1059,6380,0,599,0,8038
236,237,344,3760,0,91,0,4195
236,238,557,482,147,0,0,1186
236,239,1240,1034,0,465,0,2739
236,240,444,1442,795,0,0,2681
236,241,144,250,109,0,0,503
236,250,135,0,0,0,0,135
236,251,487,0,0,0,0,487
236,252,0,0,105,0,0,105
236,254,0,0,248,0,0,248
237,1,0,0,70,0,0,70
237,2,26,0,0,0,0,26
237,3,0,0,26,0,0,26
237,4,0,0,26,0,0,26
237,5,0,0,72,0,0,72
237,6,0,0,0,26,0,26
237,7,26,0,0,0,0,26
237,11,22,0,0,0,0,22
237,14,0,0,28,0,0,28
237,18,466,0,325,0,0,791
237,19,136,0,0,0,0,136
237,20,0,0,509,0,0,509
237,21,206,0,90,0,0,296
237,23,26,0,47,0,0,73
237,24,0,0,290,0,0,290
237,27,47,0,157,0,0,204
237,28,0,0,207,0,0,207
237,29,0,0,72,0,0,72
237,32,47,0,62,0,0,109
237,44,26,0,35,47,0,108
237,45,194,0,0,0,0,194
237,49,0,0,171,0,0,171
237,52,0,0,26,0,0,26
237,53,201,0,128,58,0,387
237,54,51,0,53,0,0,104
237,55,0,0,217,0,0,217
237,56,111,0,0,0,0,111
237,57,0,0,51,0,0,51
237,59,0,0,26,0,0,26
237,61,490,0,51,51,0,592
237,63,51,0,0,0,0,51
237,66,51,0,26,0,0,77
237,67,33,0,0,0,0,33
237,68,0,0,0,26,0,26
237,69,26,0,0,0,0,26
237,70,65,0,111,0,0,176
237,74,0,0,111,0,0,111
237,77,0,0,72,0,0,72
237,79,0,0,26,0,0,26
237,82,111,0,31,0,0,142
237,83,0,0,51,0,0,51
237,84,0,0,0,47,0,47
237,88,150,0,0,0,0,150
237,92,0,0,111,0,0,111
237,95,0,0,72,0,0,72
237,100,0,0,16,0,0,16
237,106,0,0,72,0,0,72
237,236,344,3175,0,91,0,3610
237,237,1105,2028,16,97,0,3246
237,238,842,2095,336,0,0,3273
237,239,185,428,152,61,0,826
237,240,300,47,153,15,0,515
237,241,195,232,145,46,77,695
237,250,58,0,0,0,0,58
237,252,15,0,657,0,0,672
237,254,0,0,311,107,0,418
238,1,0,0,309,0,0,309
238,2,0,0,151,0,0,151
238,4,0,0,178,0,0,178
238,5,135,0,0,0,0,135
238,6,0,0,294,0,0,294
238,15,0,0,135,0,0,135
238,19,178,0,0,0,0,178
238,21,41,0,336,151,0,528
238,22,135,0,0,0,0,135
238,25,104,0,0,0,0,104
238,26,227,0,0,0,0,227
238,27,0,0,151,0,0,151
238,28,0,0,151,0,0,151
238,29,80,0,0,0,0,80
238,31,78,0,293,0,0,371
238,32,0,0,251,0,0,251
238,38,112,0,0,0,0,112
238,49,0,0,74,74,72,220
238,51,135,0,26,0,0,161
238,53,0,0,85,0,0,85
238,54,172,0,0,0,0,172
238,55,0,0,0,74,0,74
238,56,0,0,78,0,0,78
238,57,0,0,270,213,0,483
238,58,100,0,0,0,0,100
238,59,178,0,0,0,0,178
238,60,135,0,135,0,0,270
238,61,898,0,0,0,0,898
238,62,151,0,0,0,0,151
238,63,102,0,0,0,0,102
238,64,120,0,0,120,0,240
238,76,28,0,38,0,0,66
238,77,0,0,309,0,0,309
238,78,0,0,135,0,0,135
238,79,0,0,163,0,0,163
238,81,0,0,151,0,0,151
238,83,0,0,444,0,0,444
238,95,0,0,151,0,0,151
238,97,168,0,0,0,0,168
238,108,135,0,0,0,0,135
238,236,444,135,0,0,0,579
238,237,867,3351,336,0,0,4554
238,238,2873,2423,0,718,0,6014
238,239,1364,875,119,135,0,2493
238,240,213,0,147,693,0,1053
238,241,135,0,126,0,0,261
238,250,412,135,0,0,0,547
238,251,829,256,0,314,0,1399
238,252,252,703,0,0,0,955
238,254,0,0,472,135,0,607
239,1,0,0,345,0,0,345
239,2,107,0,116,0,0,223
239,3,0,0,610,0,0,610
239,18,0,0,136,125,0,261
239,19,1662,0,67,198,0,1927
239,20,254,0,0,0,0,254
239,21,493,0,466,0,0,959
239,22,838,0,0,0,0,838
239,23,0,0,219,0,0,219
239,24,0,0,359,0,0,359
239,26,0,0,206,0,0,206
239,27,60,0,0,0,0,60
239,29,0,0,301,0,0,301
239,30,47,0,0,0,0,47
239,32,0,0,374,0,0,374
239,41,242,0,0,0,0,242
239,44,0,0,67,0,0,67
239,45,240,0,0,0,0,240
239,49,0,0,314,0,0,314
239,50,55,110,132,0,0,297
239,51,1614,288,0,0,0,1902
239,53,0,39,406,0,0,445
239,54,0,0,160,0,0,160
239,55,0,0,315,0,0,315
239,56,148,0,396,0,0,544
239,57,110,0,61,0,0,171
239,58,41,0,0,0,0,41
239,59,0,0,245,0,0,245
239,60,0,0,67,0,0,67
239,61,304,0,0,0,0,304
239,62,27,0,0,0,0,27
239,63,69,0,0,0,0,69
239,64,120,0,0,0,0,120
239,65,231,0,0,0,0,231
239,66,0,0,119,0,0,119
239,69,0,0,0,35,0,35
239,70,0,0,110,0,0,110
239,74,0,0,192,110,0,302
239,76,0,0,34,0,0,34
239,77,0,0,140,0,0,140
239,79,110,0,282,0,0,392
239,80,26,0,0,0,0,26
239,83,69,0,0,0,0,69
239,93,0,0,0,301,0,301
239,97,0,0,40,0,0,40
239,102,0,0,170,0,0,170
239,106,110,0,0,0,0,110
239,236,1240,1002,0,465,0,2707
239,237,102,501,136,61,0,800
239,238,1213,719,288,135,0,2355
239,239,2064,9013,679,424,0,12180
239,240,326,881,423,0,855,2485
239,241,357,169,180,58,77,841
239,250,258,0,276,0,0,534
239,251,1393,0,67,337,0,1797
239,252,745,0,0,0,0,745
239,254,1407,0,67,0,0,1474
240,1,0,0,449,206,0,655
240,3,0,0,109,0,0,109
240,5,100,0,0,512,0,612
240,6,308,0,0,0,0,308
240,10,204,0,0,0,0,204
240,14,0,0,228,0,0,228
240,17,0,0,0,24,0,24
240,18,798,0,295,0,0,1093
240,19,2878,326,506,0,0,3710
240,20,0,0,240,0,0,240
240,21,926,0,224,106,0,1256
240,23,204,0,102,0,0,306
240,24,286,0,317,0,0,603
240,26,127,0,0,0,0,127
240,27,60,0,59,102,0,221
240,28,0,0,228,0,0,228
240,29,0,0,100,0,0,100
240,30,0,0,55,0,0,55
240,31,0,0,100,0,0,100
240,32,0,93,0,0,0,93
240,35,206,0,0,0,0,206
240,36,0,0,196,0,0,196
240,43,63,0,68,0,0,131
240,45,206,0,224,0,0,430
240,47,0,0,117,0,0,117
240,49,402,0,224,0,0,626
240,50,815,53,38,0,0,906
240,51,185,0,0,0,0,185
240,52,0,206,226,0,0,432
240,53,0,0,86,0,0,86
240,54,37,0,0,0,0,37
240,55,761,0,0,0,0,761
240,57,621,0,131,0,0,752
240,58,97,0,0,0,0,97
240,59,0,0,64,0,0,64
240,60,0,0,221,0,0,221
240,61,0,0,0,0,298,298
240,63,11,0,0,0,0,11
240,64,59,0,0,0,0,59
240,74,55,0,0,0,0,55
240,75,35,0,0,0,0,35
240,80,101,0,0,0,0,101
240,81,0,0,355,0,0,355
240,82,0,0,76,0,0,76
240,83,206,0,0,0,0,206
240,89,0,0,228,0,0,228
240,90,0,0,0,0,274,274
240,95,0,0,102,0,0,102
240,107,401,0,0,0,0,401
240,108,0,0,51,0,0,51
240,236,444,1577,795,0,0,2816
240,237,300,47,153,15,0,515
240,238,348,0,0,693,0,1041
240,239,436,662,423,0,855,2376
240,240,626,8528,800,1776,596,12326
240,241,581,1743,0,111,0,2435
240,250,0,0,224,0,0,224
241,1,53,0,0,0,0,53
241,2,0,0,126,0,0,126
241,3,0,0,26,0,0,26
241,6,0,0,100,0,0,100
241,10,0,0,58,0,0,58
241,12,53,0,0,0,0,53
241,15,53,0,0,0,0,53
241,16,53,0,131,0,0,184
241,18,202,0,417,92,77,788
241,19,256,0,58,0,0,314
241,24,0,0,110,0,0,110
241,27,0,0,189,0,0,189
241,42,202,0,0,0,0,202
241,43,0,0,49,0,0,49
241,44,48,391,0,0,0,439
241,45,0,92,58,0,77,227
241,48,716,0,0,0,0,716
241,49,0,0,58,0,0,58
241,50,0,0,0,74,0,74
241,51,193,0,0,0,0,193
241,52,246,0,0,0,0,246
241,53,53,0,116,0,0,169
241,54,26,0,0,0,0,26
241,57,53,0,227,0,0,280
241,58,0,0,109,0,0,109
241,61,0,0,26,0,0,26
241,62,0,0,58,0,0,58
241,66,58,0,0,0,0,58
241,69,118,0,0,0,0,118
241,74,0,0,174,0,0,174
241,76,0,0,100,0,0,100
241,79,0,0,53,0,0,53
241,83,0,0,15,0,0,15
241,85,0,0,0,11,0,11
241,93,0,0,120,0,0,120
241,97,0,0,24,0,0,24
241,106,120,0,0,0,0,120
241,108,0,0,100,0,0,100
241,236,144,276,167,0,0,587
241,237,195,232,16,46,77,566
241,238,135,0,126,0,0,261
241,239,333,193,243,58,161,988
241,240,475,1705,0,270,0,2450
241,241,0,3037,0,0,0,3037
241,252,0,0,100,0,0,100
241,254,0,116,0,0,0,116
250,1,0,0,123,0,0,123
250,2,254,0,0,108,0,362
250,3,0,0,118,0,0,118
250,5,0,0,108,0,0,108
250,6,23,0,0,0,0,23
250,12,0,0,108,0,0,108
250,16,254,0,0,0,0,254
250,17,0,0,35,0,0,35
250,21,0,0,108,0,0,108
250,23,56,0,315,0,0,371
250,24,234,0,330,0,0,564
250,28,0,0,325,0,0,325
250,31,288,0,0,0,0,288
250,32,0,0,123,0,0,123
250,36,0,0,102,0,0,102
250,38,0,0,0,18,0,18
250,40,649,0,0,0,0,649
250,41,156,0,0,0,0,156
250,43,108,0,0,0,0,108
250,45,254,0,0,0,0,254
250,50,0,0,108,0,0,108
250,51,0,0,0,248,0,248
250,53,179,0,867,0,0,1046
250,54,87,0,0,396,0,483
250,57,0,0,359,0,0,359
250,58,658,783,0,0,145,1586
250,59,694,771,0,150,0,1615
250,61,507,0,240,0,0,747
250,63,11,0,0,0,0,11
250,66,216,0,298,0,0,514
250,79,0,0,108,0,0,108
250,82,254,0,108,0,0,362
250,236,135,0,0,0,0,135
250,237,83,0,0,0,0,83
250,238,412,135,0,0,0,547
250,239,258,0,276,0,0,534
250,240,0,0,224,0,0,224
250,250,216,5228,0,0,0,5444
250,251,0,1166,0,200,0,1366
250,252,802,1786,114,789,0,3491
250,254,0,0,294,0,0,294
251,1,0,0,200,0,0,200
251,3,0,0,645,0,0,645
251,5,0,0,200,0,0,200
251,7,200,0,0,0,0,200
251,15,281,0,0,0,0,281
251,21,151,0,217,0,0,368
251,22,0,0,279,0,0,279
251,24,0,0,0,66,0,66
251,26,113,0,0,0,0,113
251,31,200,0,0,0,0,200
251,34,39,0,39,0,0,78
251,36,466,0,0,0,0,466
251,43,74,0,0,0,0,74
251,45,0,0,0,1168,0,1168
251,48,0,0,344,0,0,344
251,50,109,0,0,0,0,109
251,53,0,200,0,359,0,559
251,54,0,0,618,0,0,618
251,56,200,0,200,0,0,400
251,57,200,0,0,0,0,200
251,59,0,0,950,291,0,1241
251,60,316,0,0,0,0,316
251,63,0,0,0,219,0,219
251,64,200,0,0,0,0,200
251,68,256,0,279,0,0,535
251,75,200,0,0,0,0,200
251,76,428,0,0,0,0,428
251,81,56,0,0,0,0,56
251,84,0,0,389,0,0,389
251,91,0,0,200,0,0,200
251,100,200,0,0,0,0,200
251,237,0,0,78,0,0,78
251,238,783,256,85,314,0,1438
251,239,1242,0,67,337,0,1646
251,250,200,1166,0,200,0,1566
251,251,1266,4461,0,513,0,6240
251,252,450,254,393,1178,0,2275
252,1,0,0,380,0,0,380
252,4,0,0,51,0,0,51
252,5,0,0,126,0,0,126
252,17,0,0,58,0,0,58
252,19,315,0,0,0,0,315
252,24,0,0,254,0,0,254
252,40,0,0,620,0,0,620
252,54,0,0,137,0,0,137
252,58,247,200,331,0,0,778
252,59,0,0,743,0,0,743
252,63,11,0,0,0,0,11
252,66,0,0,126,0,0,126
252,68,62,0,0,0,0,62
252,69,85,0,0,62,0,147
252,76,62,0,0,0,0,62
252,79,0,0,393,0,0,393
252,80,0,0,0,44,0,44
252,82,126,0,126,0,0,252
252,94,0,0,745,0,0,745
252,101,0,0,0,62,0,62
252,236,0,0,105,0,0,105
252,237,15,0,657,0,0,672
252,238,252,559,0,0,0,811
252,239,745,0,0,0,0,745
252,241,0,0,100,0,0,100
252,250,1492,1786,114,789,0,4181
252,251,450,254,393,1178,0,2275
252,252,1716,12712,1620,0,0,16048
252,254,0,0,378,0,0,378
254,1,0,0,195,0,0,195
254,3,0,0,351,0,0,351
254,6,0,0,280,0,0,280
254,7,144,0,0,0,0,144
254,11,208,0,0,0,0,208
254,13,0,0,0,33,0,33
254,14,0,0,41,0,0,41
254,15,0,0,853,0,0,853
254,18,0,0,102,0,0,102
254,21,83,0,0,0,0,83
254,22,0,0,640,0,0,640
254,23,0,0,478,0,0,478
254,24,0,0,245,0,0,245
254,27,0,0,600,0,0,600
254,28,0,0,496,0,0,496
254,30,109,0,0,0,0,109
254,31,0,0,518,0,0,518
254,32,0,0,582,0,0,582
254,35,0,0,18,0,0,18
254,36,0,0,248,0,0,248
254,37,600,0,0,61,0,661
254,40,18,0,516,10,0,544
254,41,0,0,320,0,0,320
254,42,0,0,57,0,0,57
254,43,160,0,1403,0,0,1563
254,44,1069,0,537,0,0,1606
254,45,2100,293,519,807,0,3719
254,47,657,0,776,214,0,1647
254,48,562,0,324,0,0,886
254,51,0,0,448,600,0,1048
254,53,248,0,107,0,0,355
254,54,14,0,0,0,0,14
254,55,0,0,0,1312,0,1312
254,57,0,0,867,0,0,867
254,59,0,0,248,0,0,248
254,62,0,0,26,27,0,53
254,68,0,0,294,0,0,294
254,70,218,0,0,0,0,218
254,74,109,0,698,0,0,807
254,80,0,0,294,0,0,294
254,83,0,0,129,0,0,129
254,94,31,0,0,0,0,31
254,101,0,0,220,0,0,220
254,107,0,0,0,248,0,248
254,236,0,0,248,0,0,248
254,237,0,0,311,107,0,418
254,238,0,0,0,135,0,135
254,239,1407,0,67,0,0,1474
254,241,0,116,0,0,0,116
254,250,0,0,294,0,0,294
254,252,0,0,378,0,0,378
254,254,5555,12974,386,2256,0,21171
